Scenario,Decision Rule,Time of starting social distancing,Duration of Social Distancing,WTP,R_t Switch threshold if social distancing is off,R_t Switch threshold if social distancing is on,% I Switch threshold if social distancing is off,% I Switch threshold if social distancing is on,Objective Function,RNG Seed,DALY,Total Cost,Annual Cost,Number of Switches,Total New: I,Total New: H,Total New: ICU,Total New: ICU-Queue,Total New: COVID Death | Waiting for ICU,Total New: COVID Death | Not Waiting for ICU,Total: Incident,Total: COVID Death | Waiting for ICU,Total: COVID-Death,Average Size: H,Average Size: ICU,Average Size: ICU-Queue,Averge size: S,Averge size: I,Averge size: Waiting for or in ICU,Averge size: Population size,Average ratio: % Susceptible,Average ratio: % Infectious,Average ratio: % Waiting for or in ICU,Average ratio: % Death While Waiting for ICU,Average ratio: Case-fatality,Utilization (unit of time): Default,Utilization (unit of time): Social Distancing
Base,0,10,0,0,0,0,0,0,-617314354,1178568022,10828.61095,75883806.41,7588380.641,0,81991,3539,950,1799,849,950,81991,849,1799,137.2579618,2.917197452,5.582802548,56509.78344,1341.041401,8.589171975,99121.03503,0.567165912,0.013485093,8.80556E-05,0.471928849,0.021941433,44,0
Base,0,10,0,0,0,0,0,0,-695200574.1,2029998696,12005.65528,94917810.29,9491781.029,0,98264,4412,479,1994,1515,479,98264,1515,1994,295.9731183,2.505376344,10.60215054,28035.65054,1785.774194,13.1827957,98650.67742,0.281958529,0.017921992,0.000133548,0.759779338,0.020292274,27,0
Base,0,10,0,0,0,0,0,0,-754810398.7,776062361,13301.19084,89750856.92,8975085.692,0,98223,4202,637,2210,1573,637,98223,1573,2210,243.5545024,2.928909953,10.32701422,35472.82938,2888.336493,13.3507109,98690.75355,0.355913367,0.029048319,0.00013578,0.711764706,0.022499822,30,0
Base,0,10,0,0,0,0,0,0,-632979343.9,1813046880,11099.57292,78000698.05,7800069.805,0,83445,3511,981,1844,863,981,83445,863,1844,152.962069,3.25862069,6.175862069,56734.86207,1826.32069,9.572413793,99123.13793,0.569341545,0.018370334,9.79801E-05,0.468004338,0.022098388,42,0
Base,0,10,0,0,0,0,0,0,-612070786,2032407216,10555.00822,84320374.91,8432037.491,0,87730,3910,680,1753,1073,680,87730,1073,1753,253.34375,3.458333333,8.984375,48446.20313,1597.057292,12.52083333,99059.93229,0.486388281,0.01602248,0.000127166,0.612093554,0.019981762,28,0
Base,0,10,0,0,0,0,0,0,-561498180.2,1507873352,9930.362108,64980074.8,6498007.48,0,71651,2930,1164,1650,486,1164,71651,486,1650,82.4479638,2.497737557,3.570135747,67341.47059,1174.719457,6.212669683,99302.78281,0.675720983,0.011816048,6.40466E-05,0.294545455,0.02302829,63,0
Base,0,10,0,0,0,0,0,0,-545732523.1,1855899401,9511.581761,70153435.09,7015343.509,0,74059,3232,943,1580,637,943,74059,637,1580,119.1283582,2.710447761,4.570149254,55469.80597,829.9820896,7.376119403,99103.17612,0.5576231,0.008340362,7.56842E-05,0.403164557,0.021334342,48,0
Base,0,10,0,0,0,0,0,0,-698116260.2,1819459251,12248.90771,85670874.69,8567087.469,0,94027,4049,596,2035,1439,596,94027,1439,2035,282.4885057,3.327586207,11.54022989,41151.57471,1939.591954,14.95977011,98846.42529,0.413198444,0.01946725,0.000151861,0.707125307,0.02164272,25,0
Base,0,10,0,0,0,0,0,0,-555831137.5,909791748,9638.903499,73885962.58,7388596.258,0,75990,3337,883,1601,718,883,75990,718,1601,144.6883562,2.938356164,5.352739726,55376.63356,845.0273973,8.380136986,99120.30137,0.556453283,0.008486946,8.54538E-05,0.448469706,0.021068562,42,0
Base,0,10,0,0,0,0,0,0,-705277199.6,1339092841,12511.2541,79714494.6,7971449.46,0,88559,3668,650,2079,1429,650,88559,1429,2079,242.8342246,3.374331551,10.96256684,46415.67914,1700.374332,14.43315508,98842.6738,0.46640418,0.017082808,0.000146656,0.687349687,0.023475875,27,0
Base,0,10,0,0,0,0,0,0,-727335922.2,1365866345,12642.327,95219572.09,9521957.209,0,98911,4412,491,2100,1609,491,98911,1609,2100,346.4528302,2.993710692,13.05031447,30563.20755,1945.421384,16.14465409,98662.91824,0.307192879,0.019521242,0.000163629,0.766190476,0.021231208,23,0
Base,0,10,0,0,0,0,0,0,-666696783.1,825453433,11441.15592,94638986.97,9463898.697,0,93935,4242,655,1900,1245,655,93935,1245,1900,270.3596059,3.118226601,9.187192118,42220.30049,2354.507389,12.4137931,98948.53202,0.423656396,0.023636044,0.00012643,0.655263158,0.020226753,29,0
Base,0,10,0,0,0,0,0,0,-728451839.3,939711378,12695.84445,93659616.78,9365961.678,0,98897,4387,449,2109,1660,449,98897,1660,2109,336.2795031,2.714285714,12.95652174,30668.30435,2413.645963,15.74534161,98655.29814,0.308199101,0.024218371,0.00015955,0.787102892,0.021325217,23,0
Base,0,10,0,0,0,0,0,0,-663599370.3,638950699,11475.6419,89817275.17,8981727.517,0,92702,4181,793,1906,1113,793,92702,1113,1906,227.7444934,3.370044053,8.202643172,44253.14537,2570.008811,11.71365639,98970.36564,0.444060988,0.025822641,0.000119507,0.583945435,0.020560506,33,0
Base,0,10,0,0,0,0,0,0,-621494453.1,938699148,10747.1414,84137382.84,8413738.284,0,86981,3864,724,1785,1061,724,86981,1061,1785,218.2837838,3.162162162,7.891891892,47924.77928,1318.441441,11.15315315,99014.17568,0.481288743,0.013239532,0.000113513,0.594397759,0.020521723,32,0
Base,0,10,0,0,0,0,0,0,-568529313,121790188,9778.923271,79583149.44,7958314.944,0,80993,3572,1010,1624,614,1010,80993,614,1624,128.4591549,2.74084507,4.43943662,58222.61127,1649.453521,7.256338028,99226.88169,0.584111724,0.016580231,7.45874E-05,0.378078818,0.020051116,50,0
Base,0,10,0,0,0,0,0,0,-719006687.6,1331335240,12521.54221,92929577.28,9292957.728,0,98109,4303,642,2080,1438,642,98109,1438,2080,257.3173077,3.028846154,9.879807692,33538.11538,3101.783654,12.9375,98729.125,0.336659633,0.031169551,0.000131599,0.691346154,0.021200909,30,0
Base,0,10,0,0,0,0,0,0,-758771517.8,470935411,13326.06748,92468143.6,9246814.36,0,98975,4158,470,2214,1744,470,98975,1744,2214,343.8774194,2.948387097,14.16774194,26911.39355,1652.574194,17.16774194,98501.38065,0.270936276,0.016588043,0.000173941,0.787714544,0.022369285,23,0
Base,0,10,0,0,0,0,0,0,-716564045.7,823434397,12668.54484,83136803.63,8313680.363,0,91798,3750,709,2105,1396,709,91798,1396,2105,220.6186047,3.227906977,9.651162791,46808.49767,2193.618605,12.93953488,98895.94884,0.469692775,0.022052463,0.000131646,0.663182898,0.022930783,31,0
Base,0,10,0,0,0,0,0,0,-562850724.8,493045351,9723.849831,76658233.25,7665823.325,0,78717,3460,819,1615,796,819,78717,796,1615,164.25,2.944029851,5.884328358,53998.20149,745.6492537,8.951492537,99118.69776,0.542467537,0.007488666,9.12173E-05,0.492879257,0.020516534,39,0
Base,0,10,0,0,0,0,0,0,-605772953.6,1700216563,10334.36868,89054519.44,8905451.944,0,88673,4155,758,1716,958,758,88673,958,1716,201.9960784,2.898039216,6.6,48117.67843,1878.6,9.568627451,99071.76078,0.482862414,0.018870697,9.74648E-05,0.558275058,0.019352001,37,0
Base,0,10,0,0,0,0,0,0,-564749685.8,1744119059,9677.077485,80895811.55,8089581.155,0,86383,3836,640,1607,967,640,86383,967,1607,210.6396396,2.792792793,7.099099099,41744.62613,1075.806306,9.990990991,98983.54955,0.419794633,0.010792738,0.000101565,0.601742377,0.018603197,32,0
Base,0,10,0,0,0,0,0,0,-626532959.2,2036906360,10902.51794,81407062.38,8140706.238,0,84696,3657,1015,1811,796,1015,84696,796,1811,128.7036011,2.709141274,4.87534626,49912.87812,1636.398892,7.667590028,99005.52078,0.501253436,0.016462144,7.87683E-05,0.439536168,0.021382356,51,0
Base,0,10,0,0,0,0,0,0,-627914997.2,809704121,10766.91401,89569296.58,8956929.658,0,91325,4175,744,1788,1044,744,91325,1044,1788,232.0672646,3.228699552,7.865470852,48939.19283,2120.986547,11.21076233,99099.21076,0.490754319,0.02129521,0.000114045,0.583892617,0.019578643,31,0
Base,0,10,0,0,0,0,0,0,-689876992.3,1219866412,11874.03504,96175240.13,9617524.013,0,98384,4371,666,1972,1306,666,98384,1306,1972,262.6792453,3.04245283,9.150943396,31383.17453,3812.504717,12.30660377,98763.44811,0.315146158,0.038296738,0.000125074,0.662271805,0.02004391,31,0
Base,0,10,0,0,0,0,0,0,-566746625.8,843498920,9866.95088,73399081.83,7339908.183,0,77365,3362,927,1639,712,927,77365,712,1639,138.0924092,2.95709571,5.254125413,55798.29043,1227.316832,8.320132013,99125.09241,0.560535675,0.012331531,8.50998E-05,0.434411226,0.021185291,44,0
Base,0,10,0,0,0,0,0,0,-760215563.1,107351963,13509.84965,84723080.42,8472308.042,0,93459,3855,828,2245,1417,828,93459,1417,2245,209.9039301,3.532751092,9.655021834,44171.47598,2845.336245,13.26200873,98796.39301,0.443306638,0.028636599,0.000135118,0.631180401,0.024021229,33,0
Base,0,10,0,0,0,0,0,0,-662511521.7,773789021,11439.85065,90518989.38,9051898.938,0,92985,4130,770,1900,1130,770,92985,1130,1900,225.9090909,3.225108225,8.073593074,44802.22511,2728.424242,11.42424242,98984.51515,0.449447407,0.027413046,0.000116181,0.594736842,0.020433403,33,0
Base,0,10,0,0,0,0,0,0,-735732877.5,850936611,13041.05973,83679891.14,8367989.114,0,91161,3774,747,2167,1420,747,91161,1420,2167,206.3160173,3.121212121,9.207792208,42829.02597,2070.874459,12.47619048,98747.96104,0.430287487,0.020835212,0.000126969,0.655283802,0.02377113,33,0
Base,0,10,0,0,0,0,0,0,-692568809,1701318364,12111.26951,87005333.61,8700533.361,0,92608,4009,676,2012,1336,676,92608,1336,2012,257.4896907,3.386597938,10.22164948,39622.04124,2028.979381,13.71649485,98806.29381,0.398177485,0.020376164,0.000139228,0.664015905,0.021725985,28,0
Base,0,10,0,0,0,0,0,0,-589506263.2,778708269,10270.23691,75994417.89,7599441.789,0,77483,3411,1125,1706,581,1125,77483,581,1706,113.8865435,2.854881266,4.340369393,61381.23747,1569.174142,7.306068602,99215.38522,0.616024109,0.015784522,7.51394E-05,0.34056272,0.022017733,55,0
Base,0,10,0,0,0,0,0,0,-667335589.2,1391938506,11813.69249,76650964.47,7665096.447,0,83791,3454,768,1963,1195,768,83791,1195,1963,208.5933014,3.545454545,9.19138756,49894.73684,1431.320574,12.8708134,98915.23445,0.501575178,0.014382938,0.000131325,0.608762099,0.023427337,30,0
Base,0,10,0,0,0,0,0,0,-518340134.3,43418681,9030.118199,66834224.31,6683422.431,0,68458,3066,1060,1500,440,1060,68458,440,1500,102.3351351,2.748648649,3.889189189,61848.52432,1030.340541,6.754054054,99220.35405,0.621433735,0.010350307,6.95197E-05,0.293333333,0.021911245,53,0
Base,0,10,0,0,0,0,0,0,-749550521.1,817384966,13187.18309,90191366.49,9019136.649,0,98186,4148,465,2191,1726,465,98186,1726,2191,256.950495,2.242574257,10.74257426,21868.36634,1323.138614,13.03960396,98357.62871,0.220545355,0.013294958,0.00013225,0.787768142,0.02231479,29,0
Base,0,10,0,0,0,0,0,0,-720616972.6,762053968,12522.00461,94516742,9451674.2,0,97860,4382,507,2080,1573,507,97860,1573,2080,327.2215569,2.988023952,12.34730539,29888.65269,1831.257485,15.38323353,98640.66467,0.300627422,0.018376546,0.000155577,0.75625,0.021254854,24,0
Base,0,10,0,0,0,0,0,0,-664653268.8,1692506311,11487.82279,90262129.47,9026212.947,0,91311,4147,818,1908,1090,818,91311,1090,1908,187.5451264,2.866425993,6.747292419,43602.94946,2187.859206,9.711191336,98915.8556,0.437708372,0.022004105,9.89969E-05,0.571278826,0.02089562,39,0
Base,0,10,0,0,0,0,0,0,-532247164.8,1037620300,9300.43547,67225391.33,6722539.133,0,71917,3080,928,1545,617,928,71917,617,1545,129.0371622,2.993243243,5.033783784,63790.89527,1026.192568,8.175675676,99273.12162,0.6403694,0.01030799,8.39115E-05,0.399352751,0.021483099,43,0
Base,0,10,0,0,0,0,0,0,-634659062.3,301400999,11052.78363,82019880.55,8201988.055,0,84013,3657,821,1836,1015,821,84013,1015,1836,191.9510204,3.240816327,7.318367347,49291.91837,1418.718367,10.67346939,98973.35102,0.495349725,0.014257306,0.000108998,0.552832244,0.021853761,35,0
Base,0,10,0,0,0,0,0,0,-718769186,1868336855,12509.64306,93287033.1,9328703.31,0,97065,4219,596,2078,1482,596,97065,1482,2078,244.7818182,2.622727273,9.309090909,31378.4,1717.85,12.03181818,98641.36818,0.315295723,0.01726577,0.000122245,0.713185756,0.021408335,32,0
Base,0,10,0,0,0,0,0,0,-732907138.9,1868498144,12845.08639,90652819.26,9065281.926,0,96366,4215,639,2134,1495,639,96366,1495,2134,265.5612245,3.178571429,10.75510204,35889.26531,2046.505102,14,98711.09694,0.360445977,0.020562939,0.00014226,0.700562324,0.02214474,28,0
Base,0,10,0,0,0,0,0,0,-575823523.6,2101566889,9976.219416,77012552.79,7701255.279,0,79895,3525,949,1657,708,949,79895,708,1657,147.2809365,3.036789298,5.347826087,53873.28428,1511.956522,8.56187291,99108.48161,0.54116444,0.015195255,8.75897E-05,0.427278214,0.02074024,43,0
Base,0,10,0,0,0,0,0,0,-741864385.9,1665097450,13007.42655,91493058.35,9149305.835,0,98719,4249,439,2161,1722,439,98719,1722,2161,329.7375,2.68125,13.38125,27909.3375,2114.775,16.1375,98544.8625,0.280851358,0.021227854,0.000163217,0.796853309,0.021890416,23,0
Base,0,10,0,0,0,0,0,0,-662826836.7,1716179948,11345.28405,95562634.37,9556263.437,0,99095,4423,486,1884,1398,486,99095,1398,1884,334.8915663,2.873493976,11.22891566,28923.22892,2058.084337,14.15060241,98773.43976,0.290764589,0.020632686,0.000143238,0.742038217,0.019012059,24,0
Base,0,10,0,0,0,0,0,0,-634158888.6,1560278715,11294.9511,69411333.74,6941133.374,0,75833,3087,910,1877,967,910,75833,967,1877,160.9176955,3.62962963,7.567901235,61382.72016,1061.55144,11.30864198,99119.16872,0.616514747,0.010671048,0.000115289,0.515183804,0.024752084,34,0
Base,0,10,0,0,0,0,0,0,-747816425.2,991019385,13133.49717,91141566.96,9114156.696,0,98318,4162,583,2182,1599,583,98318,1599,2182,283.1027027,3.075675676,11.67567568,34587.07568,3157.908108,14.82702703,98695.38919,0.347170772,0.031726455,0.000150272,0.732813932,0.022193291,27,0
Base,0,10,0,0,0,0,0,0,-736947521.3,118052103,12946.83231,89605905.81,8960590.581,0,96633,4227,656,2151,1495,656,96633,1495,2151,255.4228856,3.184079602,10.56716418,41567.88557,2422.174129,13.83084577,98835.62687,0.416832852,0.024345991,0.000140456,0.69502557,0.022259477,29,0
Base,0,10,0,0,0,0,0,0,-761282297.9,1209758844,13504.17446,86073574.87,8607357.487,0,95860,3925,560,2244,1684,560,95860,1684,2244,303.7407407,3.358024691,13.69753086,36303.97531,1733.549383,17.14197531,98635.08642,0.364886585,0.017415983,0.000173952,0.750445633,0.023409138,24,0
Base,0,10,0,0,0,0,0,0,-603237954.8,70671723,10534.61071,76507419.43,7650741.943,0,79500,3436,1022,1750,728,1022,79500,728,1750,128.339233,2.926253687,5.03539823,52399.29794,1438.873156,8.044247788,99022.61357,0.526653316,0.014469659,8.2242E-05,0.416,0.022012579,49,0
Base,0,10,0,0,0,0,0,0,-540962547.2,1722612191,9315.090036,75208045.35,7520804.535,0,75249,3375,1019,1547,528,1019,75249,528,1547,119.4916667,2.711111111,4.155555556,62483.125,1153.508333,6.994444444,99289.01111,0.626964079,0.011590223,7.1633E-05,0.341305753,0.020558686,51,0
Base,0,10,0,0,0,0,0,0,-505605872.8,1968291596,8624.167481,74397498.72,7439749.872,0,72131,3360,929,1432,503,929,72131,503,1432,109.9691517,2.28277635,3.542416452,56048.71722,741.5475578,5.94344473,99168.98972,0.563316224,0.007450029,6.09729E-05,0.351256983,0.019852768,56,0
Base,0,10,0,0,0,0,0,0,-772151892.3,1877569084,13602.18262,92042761.34,9204276.134,0,98978,4152,490,2260,1770,490,98978,1770,2260,297.4382022,2.691011236,12.59550562,25539.60112,1775.426966,15.34269663,98431.34831,0.257095747,0.017838756,0.000155355,0.783185841,0.022833357,26,0
Base,0,10,0,0,0,0,0,0,-764972838.5,1726322189,13517.13775,89115951.13,8911595.113,0,98174,4184,534,2246,1712,534,98174,1712,2246,295.1271676,3.005780347,12.83815029,29061.50289,1929.427746,15.94219653,98516.90751,0.292345127,0.019382542,0.000161555,0.762243989,0.022877748,25,0
Base,0,10,0,0,0,0,0,0,-717132070.7,307848836,12491.35485,92564327.97,9256432.797,0,97357,4267,534,2075,1541,534,97357,1541,2075,290.4565217,2.820652174,11.14673913,31311.40761,1866.521739,14.05978261,98654.40761,0.314746647,0.018741872,0.000142482,0.742650602,0.021313311,27,0
Base,0,10,0,0,0,0,0,0,-694525647.2,1154000220,11975.86493,95732400.98,9573240.098,0,99096,4501,433,1989,1556,433,99096,1556,1989,279.3467337,2.115577889,9.899497487,19816.96985,1299.366834,12.08040201,98487.13568,0.19993622,0.013043102,0.000122288,0.782302665,0.020071446,29,0
Base,0,10,0,0,0,0,0,0,-547749686.8,2028661055,9506.31472,72433950.83,7243395.083,0,76239,3296,920,1579,659,920,76239,659,1579,131.7038217,2.821656051,4.869426752,55277.23248,1272.031847,7.808917197,99128.59236,0.555444398,0.012779928,7.99557E-05,0.417352755,0.020711185,45,0
Base,0,10,0,0,0,0,0,0,-689686172.2,1629114640,11903.54156,94509094.32,9450909.432,0,95836,4325,727,1977,1250,727,95836,1250,1977,227.3708333,2.95,8.104166667,36434.00417,2492.175,11.14166667,98809.53333,0.365746896,0.02504853,0.000113312,0.632271118,0.020628991,35,0
Base,0,10,0,0,0,0,0,0,-750778153.5,1439048174,13181.69957,91693175.13,9169317.513,0,98793,4165,519,2190,1671,519,98793,1671,2190,329.88125,3.175,13.56875,30819.54375,2627.975,16.8125,98612.6375,0.309780631,0.026386221,0.000170097,0.763013699,0.022167562,23,0
Base,0,10,0,0,0,0,0,0,-761713588,865227006,13439.25341,89750917.52,8975091.752,0,99233,4139,438,2233,1795,438,99233,1795,2233,344,2.84,14.76666667,24644.89333,1777.693333,17.7,98444.21333,0.248399924,0.017835693,0.000178847,0.803851321,0.022502595,22,0
Base,0,10,0,0,0,0,0,0,-711807955.5,890479738,12341.98599,94708656.16,9470865.616,0,97864,4288,672,2050,1378,672,97864,1378,2050,251.9354839,3.01843318,9.30875576,34474.97235,3230.56682,12.40552995,98759.06452,0.346010264,0.032472051,0.000126141,0.672195122,0.020947437,31,0
Base,0,10,0,0,0,0,0,0,-609307656.5,1017049163,10554.14155,81600579.04,8160057.904,0,83746,3728,717,1753,1036,717,83746,1036,1753,213.5136364,3.140909091,7.777272727,51424.03636,1362.140909,11.04090909,99057.67273,0.516459805,0.013676023,0.000112735,0.59098688,0.020932343,32,0
Base,0,10,0,0,0,0,0,0,-530456542.1,1707305064,9063.517842,77280649.97,7728064.997,0,76051,3475,958,1505,547,958,76051,547,1505,134.5545455,2.806060606,4.421212121,58729.73333,1206.193939,7.318181818,99240.75152,0.589573523,0.01211463,7.49681E-05,0.36345515,0.019789352,48,0
Base,0,10,0,0,0,0,0,0,-763226687,400145663,13410.17616,92717879,9271787.9,0,99088,4284,408,2228,1820,408,99088,1820,2228,293.7417582,2.181318681,12.15384615,20558.84615,1460.549451,14.41208791,98322.45604,0.207477744,0.01467035,0.000145634,0.816876122,0.022485064,26,0
Base,0,10,0,0,0,0,0,0,-627991242,1662654181,10891.06185,83438149.64,8343814.964,0,86021,3770,744,1809,1065,744,86021,1065,1809,197.5349794,2.962962963,7.296296296,51404.48971,1448.872428,10.34979424,99062.19753,0.515931599,0.014553019,0.00010558,0.588723051,0.021029749,35,0
Base,0,10,0,0,0,0,0,0,-723120148.6,182136456,12564.16388,94911954.51,9491195.451,0,98897,4399,492,2087,1595,492,98897,1595,2087,301.6428571,2.653846154,11.36813187,24809.94505,1883.093407,14.06043956,98533.93956,0.249806983,0.018904701,0.00014239,0.764254911,0.021102763,26,0
Base,0,10,0,0,0,0,0,0,-510805827.8,979575387,8749.985431,73306556.27,7330655.627,0,73446,3306,1071,1453,382,1071,73446,382,1453,114.510929,2.81420765,3.816939891,60939.7541,1352.377049,6.759562842,99283.5929,0.611757537,0.013584382,6.92741E-05,0.262904336,0.019783242,53,0
Base,0,10,0,0,0,0,0,0,-752865721.7,2142525414,13253.29308,90201067.86,9020106.786,0,97981,4132,577,2202,1625,577,97981,1625,2202,304.5411765,3.311764706,12.81176471,37058.72941,2259.817647,16.2,98731.66471,0.371897656,0.022698971,0.000164296,0.737965486,0.022473745,25,0
Base,0,10,0,0,0,0,0,0,-669374779.2,1464057597,11595.62435,89593561.73,8959356.173,0,94756,4165,637,1926,1289,637,94756,1289,1926,252.1707317,3.024390244,9.248780488,41995.52683,1727.434146,12.37560976,98927.07805,0.421312851,0.017348916,0.000125611,0.669262721,0.02032589,30,0
Base,0,10,0,0,0,0,0,0,-717781660.4,364562610,12574.29869,89066726.1,8906672.61,0,96029,4108,544,2089,1545,544,96029,1545,2089,305.1309524,3.148809524,12.28571429,35301.55357,1931.017857,15.53571429,98718.52976,0.354767598,0.019381356,0.000157415,0.73958832,0.021753845,24,0
Base,0,10,0,0,0,0,0,0,-739123549.4,40350784,12994.79264,89383917.23,8938391.723,0,96707,4119,577,2159,1582,577,96707,1582,2159,293.2571429,3.205714286,12.21142857,37783.58857,2141.005714,15.50857143,98742.28,0.379308437,0.021504096,0.000157128,0.732746642,0.022325168,25,0
Base,0,10,0,0,0,0,0,0,-630320686.5,804064356,10690.75706,95782833.57,9578283.357,0,96699,4465,469,1775,1306,469,96699,1306,1775,315.7514124,2.587570621,9.920903955,32584.49153,1581.214689,12.55367232,98856.37853,0.327467534,0.015851822,0.000127174,0.735774648,0.018355929,26,0
Base,0,10,0,0,0,0,0,0,-685991650.3,2125493986,12055.98206,83192547.17,8319254.717,0,89136,3772,638,2003,1365,638,89136,1365,2003,266.4134078,3.463687151,11.03351955,44495.07263,1574.268156,14.58659218,98853.69274,0.447203762,0.015805759,0.000148186,0.681477783,0.02247128,26,0
Base,0,10,0,0,0,0,0,0,-593797431.9,23154253,10046.8236,91456251.81,9145625.181,0,92235,4223,568,1668,1100,568,92235,1100,1668,313.4647059,3.229411765,9.664705882,41380.3,1443.670588,13.02941176,99035.56471,0.415550581,0.014463954,0.000131843,0.659472422,0.018084241,25,0
Base,0,10,0,0,0,0,0,0,-558924058.9,1391367689,9752.159013,71316108.24,7131610.824,0,75735,3244,877,1620,743,877,75735,743,1620,154.5703422,3.216730038,5.996197719,55303.64259,972.9391635,9.338403042,99103.77947,0.555887137,0.009771367,9.53439E-05,0.458641975,0.021390374,38,0
Base,0,10,0,0,0,0,0,0,-645565870.7,574142276,11186.19609,86256066.06,8625606.606,0,91196,3996,678,1858,1180,678,91196,1180,1858,233.3192488,3.093896714,8.577464789,44200.78873,1965.924883,11.77464789,98959.32394,0.443715522,0.019740069,0.000119607,0.635091496,0.020373701,31,0
Base,0,10,0,0,0,0,0,0,-555434148.1,898736779,9709.763895,69945953.4,6994595.34,0,74196,3227,1138,1613,475,1138,74196,475,1613,102.1162791,2.821705426,4.023255814,61634.25323,1423.284238,6.971576227,99221.41602,0.61881962,0.014310927,7.14708E-05,0.294482331,0.021739716,56,0
Base,0,10,0,0,0,0,0,0,-616130920,346473503,10355.32283,98364778.3,9836477.83,0,97542,4624,578,1719,1141,578,97542,1141,1719,300.6701571,2.916230366,8.853403141,39478.46597,2894.570681,11.90052356,99047.81152,0.395819988,0.029026163,0.000120658,0.663757999,0.017623178,28,0
Base,0,10,0,0,0,0,0,0,-695358939.5,445552282,12106.23608,90047135.26,9004713.526,0,94991,4212,677,2011,1334,677,94991,1334,2011,274.1005291,3.465608466,10.47619048,46304.55026,2868.232804,14.05820106,98991.91005,0.464212257,0.028806681,0.000142894,0.663351566,0.021170427,26,0
Base,0,10,0,0,0,0,0,0,-693418273.8,911758476,11892.8024,98778153.77,9877815.377,0,99257,4509,432,1975,1543,432,99257,1543,1975,359.61875,2.6125,12.2125,24559.5875,1736.79375,14.93125,98616.59375,0.247418936,0.017413658,0.000150958,0.781265823,0.019897841,23,0
Base,0,10,0,0,0,0,0,0,-682420205.5,1464197940,11641.14532,100362939.5,10036293.95,0,98729,4592,565,1933,1368,565,98729,1368,1933,319.1639344,3.016393443,10.44808743,29949.21858,3144.420765,13.53005464,98755.02186,0.300938917,0.031555308,0.000137068,0.707708226,0.019578847,27,0
Base,0,10,0,0,0,0,0,0,-672442760.2,500405854,11856.65665,79609927.7,7960992.77,0,88003,3750,755,1970,1215,755,88003,1215,1970,219.0772947,3.536231884,9.342995169,47447.14976,1727.101449,12.98067633,98923.6715,0.476609454,0.017354382,0.000132303,0.616751269,0.0223856,30,0
Base,0,10,0,0,0,0,0,0,-717230902.9,772037341,12621.36541,86162632.14,8616263.214,0,96894,4044,487,2097,1610,487,96894,1610,2097,311.3081761,2.987421384,13.06289308,34017.59119,1997.371069,16.11949686,98692.80503,0.341901555,0.020039729,0.000163166,0.767763472,0.021642207,23,0
Base,0,10,0,0,0,0,0,0,-505771492.3,1543158763,8795.603304,65991327.09,6599132.709,0,69390,3038,992,1461,469,992,69390,469,1461,112.8975904,2.846385542,4.21686747,62257.57831,1012.490964,7.219879518,99251.10241,0.625358985,0.010168947,7.41951E-05,0.321013005,0.02105521,48,0
Base,0,10,0,0,0,0,0,0,-778892987.2,1604932531,13763.8525,90700362.31,9070036.231,0,98943,4191,439,2287,1848,439,98943,1848,2287,377.5217391,3.115942029,16.46376812,30493.11594,2115.115942,19.62318841,98544.52899,0.306701045,0.021215747,0.000198321,0.808045474,0.023114318,20,0
Base,0,10,0,0,0,0,0,0,-734323694.5,539051477,12762.81044,96183172.55,9618317.255,0,98459,4348,601,2120,1519,601,98459,1519,2120,272.4019608,2.862745098,10.23529412,32016.20098,2768.79902,13.17156863,98672.72549,0.321484261,0.027831208,0.000134137,0.716509434,0.021531805,30,0
Base,0,10,0,0,0,0,0,0,-548227284.1,1743124675,9470.998305,74677368.9,7467736.89,0,76233,3354,850,1573,723,850,76233,723,1573,152.405694,2.928825623,5.455516014,56833.71174,918.6619217,8.459074733,99160.48399,0.570895005,0.009226293,8.65954E-05,0.459631278,0.020634109,41,0
Base,0,10,0,0,0,0,0,0,-674434843.3,1965983789,11833.71598,82749044.39,8274904.439,0,89740,3776,856,1966,1110,856,89740,1110,1966,189.6305221,3.333333333,7.730923695,48045.12851,2100.37751,11.17269076,98971.45382,0.482185986,0.0211164,0.000113996,0.564598169,0.021907733,36,0
Base,0,10,0,0,0,0,0,0,-646551797.6,516774280,11204.33785,86334905.15,8633490.515,0,87385,3866,861,1861,1000,861,87385,1000,1861,177.0785714,2.992857143,6.521428571,45975.06071,2008.121429,9.589285714,98935.58214,0.461852872,0.020191309,9.77697E-05,0.537345513,0.021296561,39,0
Base,0,10,0,0,0,0,0,0,-713550984.2,86603142,12383.81147,94360410.94,9436041.094,0,98898,4265,403,2057,1654,403,98898,1654,2057,405.5185185,2.925925926,15.13333333,27696.96296,1901.059259,18.11111111,98622.25185,0.278952662,0.019046616,0.000182696,0.804083617,0.020799207,20,0
Base,0,10,0,0,0,0,0,0,-573761478.6,1431870609,9886.929183,79415019.48,7941501.948,0,82998,3636,946,1642,696,946,82998,696,1642,130.7758621,2.637931034,4.58908046,50437.72414,1655.818966,7.295977011,99087.63218,0.506501078,0.016641673,7.4763E-05,0.423873325,0.019783609,50,0
Base,0,10,0,0,0,0,0,0,-648270298.7,1592383984,11240.22261,86259168.06,8625916.806,0,91945,3987,618,1867,1249,618,91945,1249,1867,227.2191781,2.735159817,8.388127854,39334.63927,1227.438356,11.21004566,98852.12329,0.395220387,0.012328099,0.000114003,0.668987681,0.020305617,32,0
Base,0,10,0,0,0,0,0,0,-649246888.5,1440183867,11240.57629,87218073.97,8721807.397,0,90401,4012,712,1867,1155,712,90401,1155,1867,241.5673077,3.336538462,8.822115385,46862.13942,2099.067308,12.22596154,99007.34135,0.470314749,0.021075583,0.000124547,0.618639529,0.020652426,30,0
Base,0,10,0,0,0,0,0,0,-676799220.2,1696510588,11822.59613,85669413.63,8566941.363,0,91617,3904,699,1964,1265,699,91617,1265,1964,226.6774194,3.138248848,8.903225806,48506.90783,1989.760369,12.11520737,99005.70046,0.486481376,0.019985704,0.000123356,0.644093686,0.02143707,31,0
Base,0,10,0,0,0,0,0,0,-734758884,895039877,12827.95857,93360955.29,9336095.529,0,98327,4226,601,2131,1530,601,98327,1530,2131,314.6315789,3.450292398,12.31578947,34618.76608,3014.690058,15.81871345,98745.46199,0.347554789,0.03026429,0.000160528,0.717972783,0.021672582,25,0
Base,0,10,0,0,0,0,0,0,-712524408.7,129565953,12495.93698,87727559.62,8772755.962,0,91996,3956,864,2076,1212,864,91996,1212,2076,200.52,3.36,8.156,44259.412,2601.612,11.596,98860.564,0.444315446,0.026174086,0.000118352,0.583815029,0.022566199,35,0
Base,0,10,0,0,0,0,0,0,-617331711.1,1902565669,10651.24023,84769699.35,8476969.935,0,88098,3916,684,1769,1085,684,88098,1085,1769,218.3348214,2.959821429,7.754464286,48843.17857,1504.4375,10.80803571,99055.32143,0.49019222,0.015103927,0.000109978,0.613340871,0.020079911,32,0
Base,0,10,0,0,0,0,0,0,-673541249.6,1984179288,11809.87474,83047512.77,8304751.277,0,85286,3698,1024,1962,938,1024,85286,938,1962,157.5133333,3.306666667,6.383333333,49598.64667,2143.453333,9.786666667,98940.39667,0.49827358,0.021565166,0.000100176,0.478083588,0.023004948,43,0
Base,0,10,0,0,0,0,0,0,-747857677.9,677377223,13115.84607,92065374.24,9206537.424,0,96280,4223,770,2179,1409,770,96280,1409,2179,221.5756303,3.147058824,9.012605042,39363.58403,3290.365546,12.24789916,98768.97479,0.394909604,0.033104249,0.000124738,0.646626893,0.022631907,33,0
Base,0,10,0,0,0,0,0,0,-675178391.6,973583301,11526.63031,98846876.14,9884687.614,0,95958,4478,760,1914,1154,760,95958,1154,1914,259.3257919,3.334841629,8.497737557,43850.80995,3535.565611,11.92307692,99005.99548,0.439586763,0.035519439,0.000121604,0.60292581,0.019946226,32,0
Base,0,10,0,0,0,0,0,0,-568218003.9,781062938,9524.574277,91989290.07,9198929.007,0,91908,4283,703,1581,878,703,91908,878,1581,248.0185185,3.157407407,7.166666667,42947.40278,1958.810185,10.4212963,99104.86111,0.431010423,0.019647004,0.000106081,0.555344719,0.017201985,31,0
Base,0,10,0,0,0,0,0,0,-682307978.3,338783425,11871.66043,88724956.98,8872495.698,0,95372,4169,834,1972,1138,834,95372,1138,1972,204.2128514,3.273092369,7.787148594,44151.09639,3123.694779,11.13253012,98967.06426,0.442658151,0.031412057,0.000113348,0.577079108,0.020676928,36,0
Base,0,10,0,0,0,0,0,0,-571391360,1027579040,9838.87882,79447419.01,7944741.901,0,84543,3752,958,1634,676,958,84543,676,1634,139.9476923,2.852307692,4.898461538,50773.58462,1962.036923,7.833846154,99115.53231,0.509698118,0.019720062,8.01581E-05,0.41370869,0.019327443,46,0
Base,0,10,0,0,0,0,0,0,-668773850.6,764973813,11613.21095,88113303.27,8811330.327,0,94571,4006,718,1929,1211,718,94571,1211,1929,207.0326531,2.848979592,7.746938776,40442.51837,2628.502041,10.67755102,98891.06531,0.405798602,0.026415108,0.000108634,0.627786418,0.020397373,34,0
Base,0,10,0,0,0,0,0,0,-733627885.1,1245753446,12798.05983,93724893.33,9372489.333,0,97900,4300,651,2126,1475,651,97900,1475,2126,294.8087432,3.486338798,11.49726776,41405.99454,3661.120219,15.0273224,98883.0765,0.41507225,0.036781786,0.000152542,0.693791157,0.021716037,27,0
Base,0,10,0,0,0,0,0,0,-683678591.3,1013177794,11972.50382,85053400.53,8505340.053,0,91062,3932,672,1989,1317,672,91062,1317,1989,240.3694581,3.201970443,9.620689655,43462.76847,1875.512315,12.94581281,98866.78325,0.436534882,0.018840445,0.000131741,0.66214178,0.021842261,29,0
Base,0,10,0,0,0,0,0,0,-574679808.5,1395089249,10111.841,69087758.52,6908775.852,0,71861,3129,1103,1680,577,1103,71861,577,1680,118.4346505,3.212765957,4.930091185,60730.65957,1141.87234,8.291793313,99148.15805,0.610295679,0.011478984,8.50384E-05,0.343452381,0.023378467,47,0
Base,0,10,0,0,0,0,0,0,-470789265.9,1339545835,8140.376914,63770420.19,6377042.019,0,65387,2882,1190,1352,162,1190,65387,162,1352,75.97263158,2.368421053,2.686315789,69858.76842,1045.071579,5.195789474,99415.03158,0.700937387,0.010500945,5.37638E-05,0.119822485,0.020677209,68,0
Base,0,10,0,0,0,0,0,0,-673527786.4,219139554,11579.18041,94568765.74,9456876.574,0,96544,4329,491,1923,1432,491,96544,1432,1923,361.4802632,3.151315789,12.50657895,31722.53289,1667.973684,15.73684211,98752.59211,0.319189979,0.016717509,0.000159276,0.744669787,0.019918379,22,0
Base,0,10,0,0,0,0,0,0,-596277883.9,1336508942,10349.09021,78823373.51,7882337.351,0,82480,3605,776,1719,943,776,82480,943,1719,195.7619048,3.281385281,7.298701299,53636.34199,1450.264069,10.64935065,99110.32468,0.538538564,0.014562506,0.000108475,0.548574753,0.020841416,33,0
Base,0,10,0,0,0,0,0,0,-531369922.2,448559423,9394.843176,61627763.4,6162776.34,0,66737,2754,1257,1561,304,1257,66737,304,1561,78.88761468,2.752293578,3.419724771,65514.79587,1179.688073,6.316513761,99236.48165,0.658194295,0.011864962,6.49879E-05,0.194746957,0.023390323,63,0
Base,0,10,0,0,0,0,0,0,-643350908.6,2110028840,11102.75469,88213174.17,8821317.417,0,92245,4193,739,1844,1105,739,92245,1105,1844,222.877193,3.144736842,7.921052632,43966.5,1974.100877,11.17105263,98986.40351,0.441204221,0.01982579,0.000113836,0.599240781,0.019990243,33,0
Base,0,10,0,0,0,0,0,0,-766960904.6,1982030155,13712.91118,81315345.59,8131534.559,0,92621,3757,826,2279,1453,826,92621,1453,2279,204.0533333,3.564444444,9.973333333,47907.88,2736.684444,13.64444444,98854.59556,0.480627265,0.027547134,0.000138957,0.637560333,0.024605651,33,0
Base,0,10,0,0,0,0,0,0,-687567387.4,696219407,12091.90952,82971911.59,8297191.159,0,90884,3865,611,2009,1398,611,90884,1398,2009,251.5291005,3.126984127,10.48148148,48203.1746,1599.433862,13.70899471,98953.48677,0.483662021,0.016059729,0.000139263,0.695868591,0.022105101,27,0
Base,0,10,0,0,0,0,0,0,-669611979.3,1402539442,11459.75736,96624111.53,9662411.153,0,97681,4405,529,1903,1374,529,97681,1374,1903,319.3409091,2.914772727,10.68181818,34945.33523,2541.017045,13.67045455,98848.25568,0.35083781,0.025493686,0.000138703,0.722017867,0.019481783,26,0
Base,0,10,0,0,0,0,0,0,-716502204.6,1319833493,12408.44562,96079923.54,9607992.354,0,98667,4445,602,2061,1459,602,98667,1459,2061,308.5333333,3.272222222,11.31111111,33996.01111,3701.288889,14.63888889,98769.35,0.341248867,0.037164623,0.000148638,0.707908782,0.020888443,26,0
Base,0,10,0,0,0,0,0,0,-641638040.5,663608076,11155.45369,83865355.79,8386535.579,0,89060,3866,823,1853,1030,823,89060,1030,1853,200.325,3.3375,7.5625,47226.66667,2243.458333,10.97916667,98998.87917,0.474103836,0.022542197,0.00011207,0.55585537,0.020806198,35,0
Base,0,10,0,0,0,0,0,0,-604723160.5,414696500,10558.68112,76789104.6,7678910.46,0,81530,3543,985,1754,769,985,81530,769,1754,143.75,3.121710526,5.595394737,59464.97697,1854.016447,8.825657895,99202.04605,0.596569083,0.018639624,9.05889E-05,0.438426454,0.021513553,43,0
Base,0,10,0,0,0,0,0,0,-565282351.8,1249738535,9966.997061,66932498.73,6693249.873,0,71408,2997,1047,1656,609,1047,71408,609,1656,120.6070288,3.21086262,5.099041534,60883.63578,909.7859425,8.47284345,99153.92652,0.611835048,0.009144077,8.67926E-05,0.367753623,0.023191328,45,0
Base,0,10,0,0,0,0,0,0,-600695847.4,614415382,10480.59241,76666226.81,7666622.681,0,81156,3437,969,1741,772,969,81156,772,1741,141.8311688,3.051948052,5.506493506,53335.33117,1677.727273,8.655844156,99076.01299,0.535704666,0.016865081,8.84713E-05,0.44342332,0.021452511,44,0
Base,0,10,0,0,0,0,0,0,-500094682.4,524899953,8533.775742,73405895.33,7340589.533,0,74628,3421,993,1417,424,993,74628,424,1417,116.1850829,2.643646409,3.781767956,57789.56077,1196.237569,6.513812155,99248.29558,0.58030069,0.012014346,6.68582E-05,0.299223712,0.018987511,52,0
Base,0,10,0,0,0,0,0,0,-729269052.2,1338977757,12654.74449,96531827.47,9653182.747,0,99030,4415,403,2102,1699,403,99030,1699,2102,363.6623377,2.551948052,13.53896104,26117.36364,1690.915584,16.14935065,98549.65584,0.263005445,0.016956562,0.000163283,0.808277831,0.021225891,22,0
Base,0,10,0,0,0,0,0,0,-708471605,341384587,12394.06726,88768242.24,8876824.224,0,94685,4043,574,2059,1485,574,94685,1485,2059,267.5183246,2.947643979,10.66492147,33136.2356,1681.659686,13.67015707,98651.95812,0.333360266,0.016889633,0.000138533,0.721223895,0.021745789,28,0
Base,0,10,0,0,0,0,0,0,-720150998.1,2032000160,12675.61672,86370162.15,8637016.215,0,92669,3984,813,2106,1293,813,92669,1293,2106,190.2779923,3.046332046,7.980694981,40051.28958,2411.629344,11.12355212,98751.65251,0.40229375,0.024262021,0.000113453,0.613960114,0.022726046,37,0
Base,0,10,0,0,0,0,0,0,-723469523.6,779488939,12611.56483,92891282.22,9289128.222,0,97872,4285,531,2095,1564,531,97872,1564,2095,301.252809,2.893258427,11.62359551,36522.35955,2086.617978,14.61235955,98773.74719,0.366490501,0.020947331,0.000148232,0.746539379,0.021405509,26,0
Base,0,10,0,0,0,0,0,0,-665745213.1,1449019578,11724.56454,79516986.27,7951698.627,0,87212,3662,858,1948,1090,858,87212,1090,1948,184.6571429,3.387755102,7.787755102,52308.79592,2217.020408,11.28979592,99035.94694,0.524924304,0.022289409,0.000115182,0.559548255,0.022336376,34,0
Base,0,10,0,0,0,0,0,0,-486364223.2,351952211,8239.809133,74373766.56,7437376.656,0,72282,3411,933,1368,435,933,72282,435,1368,131.3619632,2.739263804,4.036809816,59426.40491,985.1441718,6.898773006,99278.40798,0.596760408,0.009889453,7.08428E-05,0.317982456,0.018926135,47,0
Base,0,10,0,0,0,0,0,0,-590094402.7,486595046,10211.27234,79530785.76,7953078.576,0,83164,3653,1021,1696,675,1021,83164,675,1696,123.486413,2.654891304,4.453804348,55287.0625,1857.730978,7.233695652,99161.05435,0.554750878,0.018680604,7.42545E-05,0.397995283,0.020393439,51,0
Base,0,10,0,0,0,0,0,0,-692900779.6,296745624,12069.98499,89401530.16,8940153.016,0,95157,4121,616,2005,1389,616,95157,1389,2005,268.25,3.125,10.29166667,39402.00521,2434.739583,13.49479167,98834.5,0.395559963,0.02445726,0.000137162,0.69276808,0.021070441,28,0
Base,0,10,0,0,0,0,0,0,-560509883.3,1671484194,9723.098057,74354980.44,7435498.044,0,79825,3469,871,1615,744,871,79825,744,1615,162.221374,3.20610687,6,53685.58397,1559.664122,9.316793893,99135.79771,0.539247005,0.015659228,9.52876E-05,0.460681115,0.020231757,38,0
Base,0,10,0,0,0,0,0,0,-692192526.3,422157396,11969.23942,93730555.49,9373055.549,0,98974,4389,486,1988,1502,486,98974,1502,1988,350.3096774,3.070967742,12.72903226,29539.45806,2383.735484,15.84516129,98717.79355,0.297024665,0.023902093,0.000160155,0.755533199,0.020086083,23,0
Base,0,10,0,0,0,0,0,0,-734504893.9,1916599091,12774.64263,95772762.3,9577276.23,0,98759,4258,437,2122,1685,437,98759,1685,2122,330.4761905,2.535714286,12.51190476,25892.47024,2044.928571,15.11904762,98531.31548,0.260703388,0.020519787,0.000153002,0.794062205,0.021486649,24,0
Base,0,10,0,0,0,0,0,0,-711787003.5,1005953941,12282.83327,97645340.1,9764534.01,0,98971,4357,499,2040,1541,499,98971,1541,2040,402.177305,3.453900709,14.32624113,32099.46099,2843.460993,17.85106383,98759.79433,0.322593797,0.028494088,0.000180604,0.755392157,0.020612098,21,0
Base,0,10,0,0,0,0,0,0,-759892294.2,1422765615,13385.54949,90614819.66,9061481.966,0,97367,4140,582,2224,1642,582,97367,1642,2224,292.1011236,3.196629213,12.35393258,31869.86517,1895.174157,15.63483146,98580.18539,0.320413555,0.019044851,0.000158499,0.738309353,0.022841414,26,0
Base,0,10,0,0,0,0,0,0,-522730474.9,699740192,9155.701512,64945399.3,6494539.93,0,67243,2797,1150,1521,371,1150,67243,371,1521,83.59817352,2.5456621,3.356164384,59569.26712,914.413242,5.95890411,99127.44064,0.599090096,0.009194544,6.13031E-05,0.243918475,0.022619455,63,0
Base,0,10,0,0,0,0,0,0,-516457654.7,240885764,8934.990087,69708150.3,6970815.03,0,71234,3158,1101,1484,383,1101,71234,383,1484,98.31265509,2.622828784,3.533498759,65352.68983,1078.841191,6.255583127,99326.04218,0.655835253,0.010842533,6.44617E-05,0.258086253,0.020833041,58,0
Base,0,10,0,0,0,0,0,0,-650735935.4,2023806564,11134.64632,94003619.34,9400361.934,0,95736,4350,636,1849,1213,636,95736,1213,1849,320.7058824,3.635294118,10.71764706,39468.91176,2360.711765,14.45882353,98960.82353,0.396174979,0.02367349,0.000146655,0.656030287,0.019313529,25,0
Base,0,10,0,0,0,0,0,0,-554693915.6,1907493879,9614.913771,73948227.01,7394822.701,0,77655,3402,969,1597,628,969,77655,628,1597,120.8968481,2.670487106,4.429799427,55049.08309,1397.332378,7.191977077,99137.83954,0.552960018,0.014040989,7.38998E-05,0.39323732,0.020565586,49,0
Base,0,10,0,0,0,0,0,0,-728980314.2,1565815291,12832.10796,87374916.15,8737491.615,0,93888,3921,816,2132,1316,816,93888,1316,2132,208.7740586,3.322175732,8.769874477,43257.68619,3177.811715,12.17991632,98832.25941,0.434086449,0.031975256,0.000124145,0.617260788,0.022707907,35,0
Base,0,10,0,0,0,0,0,0,-481770926.6,784442364,8238.343669,69853743.1,6985374.31,0,71601,3304,1002,1368,366,1002,71601,366,1368,117.1260997,2.80058651,3.832844575,56676.91789,1113.683284,6.7771261,99224.60117,0.569558669,0.011179635,6.97716E-05,0.26754386,0.019105878,48,0
Base,0,10,0,0,0,0,0,0,-677865989.8,206369745,11698.7557,92928204.86,9292820.486,0,97548,4340,546,1943,1397,546,97548,1397,1943,305.8011364,3.005681818,10.88068182,36332.34091,2312.909091,14.00568182,98852.25568,0.364655776,0.023207837,0.00014198,0.718991251,0.019918399,26,0
Base,0,10,0,0,0,0,0,0,-702699544.4,2087235992,12203.10294,92544397.6,9254439.76,0,98502,4245,555,2027,1472,555,98502,1472,2027,263.4630542,2.665024631,9.852216749,26905.99015,2111.990148,12.591133,98618.62562,0.270595418,0.021210206,0.000127845,0.726196349,0.020578262,29,0
Base,0,10,0,0,0,0,0,0,-679627646.1,1019092536,11835.33869,87860711.44,8786071.144,0,91625,4030,774,1966,1192,774,91625,1192,1966,221.254386,3.293859649,8.456140351,45980.84211,2219.368421,11.85526316,98960.38158,0.461405575,0.022301933,0.000120834,0.606307223,0.021457026,33,0
Base,0,10,0,0,0,0,0,0,-640061001.9,1885906113,11178.55478,81133262.81,8113326.281,0,85791,3672,700,1857,1157,700,85791,1157,1857,207.8526786,3.035714286,8.142857143,44662.04464,1169.665179,11.26785714,98883.44196,0.449112329,0.011748287,0.000114699,0.623047927,0.021645627,32,0
Base,0,10,0,0,0,0,0,0,-613940844.3,2028637200,10644.24922,81728383.1,8172838.31,0,86674,3867,728,1768,1040,728,86674,1040,1768,219.3831776,3.308411215,8.11682243,47257.12617,1568.485981,11.4953271,99012.94393,0.474697737,0.01574383,0.000117111,0.588235294,0.020398274,31,0
Base,0,10,0,0,0,0,0,0,-693886204.3,181476086,12040.70268,91851070.52,9185107.052,0,97834,4334,537,2000,1463,537,97834,1463,2000,253.9043062,2.502392344,9.454545455,28927.2201,2191.277512,12.01913876,98654.31579,0.290783791,0.022014165,0.000122014,0.7315,0.020442791,30,0
Base,0,10,0,0,0,0,0,0,-715127157.9,2097578470,12408.0068,94726817.74,9472681.774,0,97714,4353,593,2061,1468,593,97714,1468,2061,305.7653631,3.217877095,11.36871508,33450.27933,2954.782123,14.67039106,98735.7486,0.336018805,0.029665432,0.000148953,0.712275594,0.021092167,26,0
Base,0,10,0,0,0,0,0,0,-670051437.8,119646392,11743.6752,82867677.91,8286767.791,0,88807,3787,865,1951,1086,865,88807,1086,1951,188.4541833,3.338645418,7.601593625,49562.41833,2242.545817,11.03585657,98988.34263,0.497445819,0.022552633,0.000112835,0.556637622,0.021968989,36,0
Base,0,10,0,0,0,0,0,0,-699770831.9,1298895859,12125.32761,93504451.48,9350445.148,0,98000,4326,530,2014,1484,530,98000,1484,2014,276.0459184,2.637755102,10.14285714,26327.2551,2081.505102,12.83673469,98594.40306,0.264983468,0.020903824,0.000130426,0.736842105,0.02055102,28,0
Base,0,10,0,0,0,0,0,0,-706915062.4,1489316290,12322.64031,90783046.94,9078304.694,0,95545,4199,575,2047,1472,575,95545,1472,2047,307.8529412,3.288235294,11.89411765,35953.68235,1955.382353,15.26470588,98747.05882,0.361332507,0.019623436,0.000154888,0.719101124,0.02142446,25,0
Base,0,10,0,0,0,0,0,0,-806056629.4,855602142,14322.14533,89949362.95,8994936.295,0,98392,4040,481,2380,1899,481,98392,1899,2380,316.006135,2.889570552,14.47239264,32228.48466,2152.165644,17.42944785,98501.90798,0.323849213,0.021624768,0.000176516,0.79789916,0.024188958,24,0
Base,0,10,0,0,0,0,0,0,-707800156.9,1438649896,12370.2525,89287532.13,8928753.213,0,94277,4113,717,2055,1338,717,94277,1338,2055,234.0639269,3.164383562,9.223744292,41891.31507,2192.520548,12.49315068,98851.71689,0.420393183,0.022041055,0.000127299,0.651094891,0.021797469,31,0
Base,0,10,0,0,0,0,0,0,-632149208.8,952489126,11294.34928,67431744.66,6743174.466,0,78498,3161,1119,1877,758,1119,78498,758,1877,111.5756677,3.207715134,5.403560831,58880.18694,1793.724036,8.71810089,99094.38576,0.591318799,0.018050839,8.9473E-05,0.403835908,0.023911437,49,0
Base,0,10,0,0,0,0,0,0,-722846194.6,1550779155,12646.77144,90507622.32,9050762.232,0,99159,4214,404,2101,1697,404,99159,1697,2101,360.462069,2.724137931,14.3862069,24044.51034,1912.337931,17.16551724,98517.24828,0.242499829,0.019170535,0.000173353,0.807710614,0.021188193,21,0
Base,0,10,0,0,0,0,0,0,-568617103.4,607323321,9867.553199,75239443.41,7523944.341,0,76909,3462,944,1639,695,944,76909,695,1639,135.0440252,2.877358491,5.009433962,55126.65409,1171.707547,7.981132075,99102.27358,0.553954526,0.011775817,8.16315E-05,0.424039048,0.0213109,46,0
Base,0,10,0,0,0,0,0,0,-652232615,2103646485,11336.05475,85429877.65,8542987.765,0,89515,3907,624,1883,1259,624,89515,1259,1883,281.3028571,3.48,10.61714286,44566.79429,1544.08,14.17142857,98929.69714,0.447773762,0.015492109,0.000143774,0.668613914,0.021035581,25,0
Base,0,10,0,0,0,0,0,0,-656131786.7,258120157,11236.74668,94294452.8,9429445.28,0,97969,4439,456,1866,1410,456,97969,1410,1866,353.8645161,2.864516129,11.90322581,26413.10968,1607.748387,14.84516129,98709.27097,0.26613062,0.016111575,0.000150226,0.75562701,0.019046841,23,0
Base,0,10,0,0,0,0,0,0,-612945527.2,1068951401,10525.75682,86657686.32,8665768.632,0,88470,3941,690,1748,1058,690,88470,1058,1748,240.9086538,3.235576923,8.25,48853.6875,1665.014423,11.56730769,99084.625,0.49025471,0.016704255,0.000117663,0.605263158,0.01975811,30,0
Base,0,10,0,0,0,0,0,0,-654738356.2,635956235,11478.77764,80799474.29,8079947.429,0,86621,3775,942,1907,965,942,86621,965,1907,146.4363057,2.891719745,5.917197452,49220.6051,2085.098726,8.914012739,98969.1051,0.494223771,0.020976467,9.13077E-05,0.506030414,0.022015447,44,0
Base,0,10,0,0,0,0,0,0,-517436555.4,1346693470,9077.090438,63582033.54,6358203.354,0,68870,2949,1028,1508,480,1028,68870,480,1508,109.3567073,3.015243902,4.426829268,60722.78049,1074.012195,7.576219512,99186.91768,0.610334064,0.010790156,7.76629E-05,0.318302387,0.021896962,47,0
Base,0,10,0,0,0,0,0,0,-742105547.1,847102011,13013.42306,91434393.87,9143439.387,0,98910,4258,476,2162,1686,476,98910,1686,2162,317.3373494,2.795180723,12.87951807,27466.98193,2033.012048,15.75301205,98550.53614,0.276372684,0.020410688,0.000159654,0.779833488,0.021858255,24,0
Base,0,10,0,0,0,0,0,0,-754061131.3,812083272,13360.10532,86055865.18,8605586.518,0,96071,3928,728,2220,1492,728,96071,1492,2220,229.135514,3.308411215,10.23364486,42864.45794,2744.126168,13.64018692,98821.14486,0.429860934,0.027605427,0.000138644,0.672072072,0.02310791,31,0
Base,0,10,0,0,0,0,0,0,-687494285.7,2146825809,11819.99652,96494459.83,9649445.983,0,99020,4488,463,1963,1500,463,99020,1500,1963,368.9078947,2.973684211,12.80263158,26214.07237,2056.710526,15.83552632,98665.71053,0.263997546,0.020610328,0.000160092,0.764136526,0.019824278,22,0
Base,0,10,0,0,0,0,0,0,-741973072.1,226186520,12983.85251,92780446.64,9278044.664,0,98220,4259,484,2157,1673,484,98220,1673,2157,374.2517483,3.321678322,14.95104895,33463.67133,2002.482517,18.29370629,98679.05594,0.336294932,0.020086027,0.00018537,0.775614279,0.021960904,21,0
Base,0,10,0,0,0,0,0,0,-710251933.1,1110225441,12418.35588,89334139.1,8933413.91,0,96025,4059,791,2063,1272,791,96025,1272,2063,200.015625,3.00390625,7.9375,39949.51563,2899.140625,11.0078125,98835.27344,0.400722437,0.029164218,0.000112204,0.616577799,0.021483989,37,0
Base,0,10,0,0,0,0,0,0,-629058461.2,1190767082,10643.1452,96901201.12,9690120.112,0,96338,4465,624,1767,1143,624,96338,1143,1767,279.3910891,3,8.613861386,40175.32178,2547.529703,11.68811881,99008.91089,0.40292535,0.025560103,0.000118818,0.646859083,0.018341672,29,0
Base,0,10,0,0,0,0,0,0,-607419490.9,2108234095,10659.97733,74420624.63,7442062.463,0,82745,3434,903,1771,868,903,82745,868,1771,159.6264151,3.298113208,6.516981132,51943.82264,1927.298113,9.901886792,99055.75094,0.521758014,0.019364274,0.000101418,0.490118577,0.021403106,38,0
Base,0,10,0,0,0,0,0,0,-748676129.8,465621985,13039.18491,96716884.45,9671688.445,0,99070,4391,478,2166,1688,478,99070,1688,2166,327.2163743,2.725146199,12.56725146,25039.40351,1992.643275,15.33918129,98492.80117,0.252154856,0.020008345,0.000155371,0.779316713,0.021863329,25,0
Base,0,10,0,0,0,0,0,0,-611945330.5,1487072553,10490.00928,87444866.26,8744486.626,0,87297,3857,690,1742,1052,690,87297,1052,1742,220.1608696,2.943478261,7.460869565,44719.66522,1362.969565,10.45652174,98976.4913,0.449315957,0.013681798,0.000106197,0.603903559,0.019954867,33,0
Base,0,10,0,0,0,0,0,0,-684908687,1213733847,11996.5392,85081727.04,8508172.704,0,91773,3963,683,1993,1310,683,91773,1310,1993,212.9606987,2.912663755,8.576419214,38573.36681,1694.196507,11.54148472,98759.04367,0.387766094,0.01703145,0.000117504,0.657300552,0.021716627,33,0
Base,0,10,0,0,0,0,0,0,-704272855,2003658337,12327.7301,87886350.19,8788635.019,0,94996,4011,605,2048,1443,605,94996,1443,2048,251.4228856,2.940298507,10.05970149,38148.27363,1925.736318,13.06467662,98768.41294,0.383087061,0.019351443,0.000132676,0.704589844,0.021558802,29,0
Base,0,10,0,0,0,0,0,0,-575973409.1,1170868072,10011.7485,75385984.02,7538598.402,0,77502,3372,947,1663,716,947,77502,716,1663,147.4006849,3.119863014,5.544520548,58039.55479,1549.787671,8.77739726,99172.7774,0.582796489,0.015571048,8.9821E-05,0.430547204,0.021457788,42,0
Base,0,10,0,0,0,0,0,0,-693862097.6,569919592,11969.74069,95375063.29,9537506.329,0,99341,4494,428,1988,1560,428,99341,1560,1988,366.7019868,2.754966887,13.05298013,24877.82781,1713.847682,15.90728477,98624.90066,0.25065404,0.017178189,0.000160512,0.784708249,0.020011878,22,0
Base,0,10,0,0,0,0,0,0,-627902217.3,1833180623,10737.31576,91036429.51,9103642.951,0,94133,4315,670,1783,1113,670,94133,1113,1783,301.28,3.691428571,9.977142857,43539.01143,2496.302857,13.82285714,99052.89143,0.43679709,0.025028671,0.000140619,0.624228828,0.018941285,25,0
Base,0,10,0,0,0,0,0,0,-765927301.5,1123666637,13505.63469,90645567.21,9064556.721,0,97886,4112,490,2244,1754,490,97886,1754,2244,312.011976,2.856287425,13.29341317,28066.91617,1766.377246,16.22754491,98480.33533,0.282554766,0.017741344,0.00016455,0.781639929,0.022924627,24,0
Base,0,10,0,0,0,0,0,0,-720328008.6,1682024981,12510.1514,94820438.41,9482043.841,0,98278,4336,651,2078,1427,651,98278,1427,2078,279.1632653,3.224489796,10.42346939,38413.34694,4109.030612,13.75510204,98852.79592,0.385171118,0.041276119,0.000139978,0.686717998,0.021144101,27,0
Base,0,10,0,0,0,0,0,0,-703059844.2,1687523543,12280.08469,89055609.93,8905560.993,0,93871,4108,681,2040,1359,681,93871,1359,2040,230.490991,2.986486486,9.045045045,42533.8018,1614.09009,12.0990991,98862.54955,0.426807136,0.0162213,0.000123263,0.666176471,0.021731951,32,0
Base,0,10,0,0,0,0,0,0,-713188588.2,178034412,12466.42701,89867237.65,8986723.765,0,97592,4232,492,2071,1579,492,97592,1579,2071,327.8291139,3.050632911,12.98101266,32512.94304,2172.28481,16.08860759,98695.82278,0.32683488,0.021794245,0.000162854,0.762433607,0.021221002,23,0
Base,0,10,0,0,0,0,0,0,-683761977,739490003,11824.74659,92524647.73,9252464.773,0,96578,4227,511,1964,1453,511,96578,1453,1964,306.3485714,2.857142857,11.08571429,31140.47429,1540.737143,13.98285714,98709.36571,0.313217735,0.01545674,0.000142,0.739816701,0.020335894,25,0
Base,0,10,0,0,0,0,0,0,-749015079,178482706,13198.86421,89071868.7,8907186.87,0,96382,4189,596,2193,1597,596,96382,1597,2193,286.6573034,3.275280899,12.17977528,37647.52809,2320.601124,15.52808989,98715.97191,0.378009324,0.023310085,0.000157501,0.728226174,0.022753211,26,0
Base,0,10,0,0,0,0,0,0,-710760489.8,1919366370,12448.00702,88360138.7,8836013.87,0,94151,3965,625,2068,1443,625,94151,1443,2068,229.9366516,2.737556561,9.208144796,38175.97285,1469.113122,12.04524887,98738.38914,0.383438433,0.014770398,0.000122554,0.697775629,0.021964716,32,0
Base,0,10,0,0,0,0,0,0,-679080523.9,1819796913,11657.75284,96192881.66,9619288.166,0,98677,4502,470,1936,1466,470,98677,1466,1936,334.742515,2.77245509,11.49101796,29224.13772,2431.802395,14.28742515,98737.13174,0.29381831,0.024383914,0.000144595,0.757231405,0.019619567,24,0
Base,0,10,0,0,0,0,0,0,-734316696,1866591913,12904.67693,89082849.31,8908284.931,0,96607,4222,803,2144,1341,803,96607,1341,2144,212.790795,3.276150628,8.824267782,47006.17992,3346.598326,12.20083682,98970.21757,0.470901209,0.033663282,0.000124114,0.625466418,0.022193009,35,0
Base,0,10,0,0,0,0,0,0,-720120523,1219425989,12498.16819,95212113.67,9521211.367,0,99338,4486,456,2076,1620,456,99338,1620,2076,374.9931973,3,13.97959184,25658.85034,1751.312925,17.10204082,98582.78231,0.258483568,0.017560016,0.000172841,0.780346821,0.020898347,21,0
Base,0,10,0,0,0,0,0,0,-686968214.7,502409586,11884.83974,92726227.94,9272622.794,0,98677,4335,491,1974,1483,491,98677,1483,1974,298.3444444,2.666666667,10.86111111,26474.60556,2210.338889,13.59444444,98647.1,0.266402495,0.022178832,0.000137525,0.751266464,0.020004662,26,0
Base,0,10,0,0,0,0,0,0,-689304946.6,1405887957,11950.6165,91774121.47,9177412.147,0,94592,4270,558,1985,1427,558,94592,1427,1985,310.1871345,3.169590643,11.45614035,37958.79532,1676.526316,14.70760234,98813.11111,0.381362407,0.016821619,0.000149307,0.718891688,0.020984861,25,0
Base,0,10,0,0,0,0,0,0,-765078765.2,283033753,13611.75713,84490908.8,8449090.88,0,95531,3906,581,2262,1681,581,95531,1681,2262,246.9589744,2.917948718,11.47179487,30313.83077,1303.487179,14.45641026,98463.40513,0.30522663,0.013107362,0.000146688,0.743147657,0.023678178,28,0
Base,0,10,0,0,0,0,0,0,-733247659.5,1083157068,12868.87066,89804126.71,8980412.671,0,95768,4068,689,2138,1449,689,95768,1449,2138,239.6046512,3.111627907,9.795348837,35211.51163,2267.75814,13.00465116,98677.2186,0.353759642,0.022801712,0.000132278,0.677736202,0.022324785,31,0
Base,0,10,0,0,0,0,0,0,-698012657.6,1988704626,12331.67721,81428797.09,8142879.709,0,88296,3725,704,2049,1345,704,88296,1345,2049,236.9744898,3.505102041,10.30612245,47010.72959,1156.5,13.90306122,98868.89796,0.472313892,0.011620249,0.000141165,0.656417765,0.023206034,28,0
Base,0,10,0,0,0,0,0,0,-731222589.9,884761309,12738.09758,94317710.68,9431771.068,0,99110,4395,435,2116,1681,435,99110,1681,2116,381.4965035,2.972027972,14.67132867,24934.76224,1801.06993,17.72027972,98529.76224,0.251386399,0.018059413,0.00017901,0.79442344,0.021350015,21,0
Base,0,10,0,0,0,0,0,0,-557964646.8,533485933,9397.226816,88103305.99,8810330.599,0,85167,3967,693,1560,867,693,85167,867,1560,236.2764977,3.105990783,7.046082949,49764.4424,1071.668203,10.23502304,99152.36866,0.499574606,0.010748352,0.000104148,0.555769231,0.018316954,31,0
Base,0,10,0,0,0,0,0,0,-640417688.3,632196071,11131.38536,83848420.49,8384842.049,0,86532,3815,686,1849,1163,686,86532,1163,1849,229.7333333,3.185714286,8.657142857,48936.8,1061.109524,11.94285714,98993.08571,0.491455217,0.010653529,0.00012125,0.628988643,0.021367818,30,0
Base,0,10,0,0,0,0,0,0,-735208248.6,393400457,12881.19942,91148277.8,9114827.78,0,98040,4252,446,2140,1694,446,98040,1694,2140,332.6835443,2.740506329,13.41139241,32070.27848,1942.183544,16.21518987,98634.4557,0.322348265,0.019490359,0.000164349,0.791588785,0.021827825,23,0
Base,0,10,0,0,0,0,0,0,-709333738,398973227,12400.2474,89321368.09,8932136.809,0,94948,4102,583,2060,1477,583,94948,1477,2060,287.2290503,3.195530726,11.36871508,34684.36872,1588.547486,14.62011173,98700.4581,0.348770133,0.015947067,0.000148332,0.716990291,0.021696086,26,0
Base,0,10,0,0,0,0,0,0,-678414592.1,1402256491,11781.73601,89327791.37,8932779.137,0,95049,4163,715,1957,1242,715,95049,1242,1957,243.549763,3.308056872,9.142180095,42551.1327,2841.540284,12.53554502,98936.95261,0.426814734,0.028549146,0.000127275,0.634644865,0.02058938,31,0
Base,0,10,0,0,0,0,0,0,-754883933.7,2102527413,13200.76623,94845622.04,9484562.204,0,98812,4339,615,2193,1578,615,98812,1578,2193,300.0164835,3.291208791,11.9010989,35379.15934,3145.945055,15.25824176,98725.40659,0.354980177,0.031604194,0.000155124,0.719562244,0.022193661,26,0
Base,0,10,0,0,0,0,0,0,-746740958.7,1748031099,13103.62802,91559557.67,9155955.767,0,97698,4135,617,2177,1560,617,97698,1560,2177,295.6067416,3.387640449,12.08988764,34974.7809,2966.58427,15.54494382,98696.4382,0.351222789,0.029808629,0.000157777,0.716582453,0.022282954,26,0
Base,0,10,0,0,0,0,0,0,-628394178.4,1946754629,10879.33778,84427289.31,8442728.931,0,89059,3896,689,1807,1118,689,89059,1118,1807,209.6336207,2.887931034,7.659482759,44754.28879,1474.387931,10.62931034,98955.21552,0.449476771,0.014811225,0.000108086,0.618705036,0.02028992,34,0
Base,0,10,0,0,0,0,0,0,-639886709,2097712204,11054.36804,87168307.06,8716830.706,0,89579,4018,655,1836,1181,655,89579,1181,1836,245.4878049,3.097560976,8.804878049,45505.12683,1369.736585,12.0097561,98969.26829,0.456930565,0.013750893,0.000122027,0.643246187,0.020495875,30,0
Base,0,10,0,0,0,0,0,0,-650643863.4,1198827119,11418.37339,79725194.08,7972519.408,0,85024,3691,903,1897,994,903,85024,994,1897,161.4875445,3.117437722,6.604982206,54131.02847,1948.619217,9.825622776,99062.05694,0.543265787,0.019597162,0.000100233,0.52398524,0.022311347,41,0
Base,0,10,0,0,0,0,0,0,-497941232.7,109253198,8669.066769,64487894.19,6448789.419,0,66754,2881,1135,1440,305,1135,66754,305,1440,75.68879668,2.22406639,2.831950207,60924.95643,979.5414938,5.190871369,99199.58091,0.612383969,0.009845935,5.36953E-05,0.211805556,0.021571741,68,0
Base,0,10,0,0,0,0,0,0,-603680765.9,314481292,10416.46123,82857704.4,8285770.44,0,82677,3710,756,1730,974,756,82677,974,1730,206.7229437,3.168831169,7.329004329,50337.09091,1065.887446,10.62770563,99036.54113,0.505762386,0.010700437,0.000108087,0.56300578,0.020924804,33,0
D:0| T0: 0.17| T1: 0.00| R0: 0.0| R1: 0.0| WTP: 0,0,0.173076923,0,0,0,0,0,0,-617314354,1178568022,10828.61095,75883806.41,7588380.641,0,81991,3539,950,1799,849,950,81991,849,1799,137.2579618,2.917197452,5.582802548,56509.78344,1341.041401,8.589171975,99121.03503,0.567165912,0.013485093,8.80556E-05,0.471928849,0.021941433,44,0
D:0| T0: 0.17| T1: 0.00| R0: 0.0| R1: 0.0| WTP: 0,0,0.173076923,0,0,0,0,0,0,-695200574.1,2029998696,12005.65528,94917810.29,9491781.029,0,98264,4412,479,1994,1515,479,98264,1515,1994,295.9731183,2.505376344,10.60215054,28035.65054,1785.774194,13.1827957,98650.67742,0.281958529,0.017921992,0.000133548,0.759779338,0.020292274,27,0
D:0| T0: 0.17| T1: 0.00| R0: 0.0| R1: 0.0| WTP: 0,0,0.173076923,0,0,0,0,0,0,-754810398.7,776062361,13301.19084,89750856.92,8975085.692,0,98223,4202,637,2210,1573,637,98223,1573,2210,243.5545024,2.928909953,10.32701422,35472.82938,2888.336493,13.3507109,98690.75355,0.355913367,0.029048319,0.00013578,0.711764706,0.022499822,30,0
D:0| T0: 0.17| T1: 0.00| R0: 0.0| R1: 0.0| WTP: 0,0,0.173076923,0,0,0,0,0,0,-632979343.9,1813046880,11099.57292,78000698.05,7800069.805,0,83445,3511,981,1844,863,981,83445,863,1844,152.962069,3.25862069,6.175862069,56734.86207,1826.32069,9.572413793,99123.13793,0.569341545,0.018370334,9.79801E-05,0.468004338,0.022098388,42,0
D:0| T0: 0.17| T1: 0.00| R0: 0.0| R1: 0.0| WTP: 0,0,0.173076923,0,0,0,0,0,0,-612070786,2032407216,10555.00822,84320374.91,8432037.491,0,87730,3910,680,1753,1073,680,87730,1073,1753,253.34375,3.458333333,8.984375,48446.20313,1597.057292,12.52083333,99059.93229,0.486388281,0.01602248,0.000127166,0.612093554,0.019981762,28,0
D:0| T0: 0.17| T1: 0.00| R0: 0.0| R1: 0.0| WTP: 0,0,0.173076923,0,0,0,0,0,0,-561498180.2,1507873352,9930.362108,64980074.8,6498007.48,0,71651,2930,1164,1650,486,1164,71651,486,1650,82.4479638,2.497737557,3.570135747,67341.47059,1174.719457,6.212669683,99302.78281,0.675720983,0.011816048,6.40466E-05,0.294545455,0.02302829,63,0
D:0| T0: 0.17| T1: 0.00| R0: 0.0| R1: 0.0| WTP: 0,0,0.173076923,0,0,0,0,0,0,-545732523.1,1855899401,9511.581761,70153435.09,7015343.509,0,74059,3232,943,1580,637,943,74059,637,1580,119.1283582,2.710447761,4.570149254,55469.80597,829.9820896,7.376119403,99103.17612,0.5576231,0.008340362,7.56842E-05,0.403164557,0.021334342,48,0
D:0| T0: 0.17| T1: 0.00| R0: 0.0| R1: 0.0| WTP: 0,0,0.173076923,0,0,0,0,0,0,-698116260.2,1819459251,12248.90771,85670874.69,8567087.469,0,94027,4049,596,2035,1439,596,94027,1439,2035,282.4885057,3.327586207,11.54022989,41151.57471,1939.591954,14.95977011,98846.42529,0.413198444,0.01946725,0.000151861,0.707125307,0.02164272,25,0
D:0| T0: 0.17| T1: 0.00| R0: 0.0| R1: 0.0| WTP: 0,0,0.173076923,0,0,0,0,0,0,-555831137.5,909791748,9638.903499,73885962.58,7388596.258,0,75990,3337,883,1601,718,883,75990,718,1601,144.6883562,2.938356164,5.352739726,55376.63356,845.0273973,8.380136986,99120.30137,0.556453283,0.008486946,8.54538E-05,0.448469706,0.021068562,42,0
D:0| T0: 0.17| T1: 0.00| R0: 0.0| R1: 0.0| WTP: 0,0,0.173076923,0,0,0,0,0,0,-705277199.6,1339092841,12511.2541,79714494.6,7971449.46,0,88559,3668,650,2079,1429,650,88559,1429,2079,242.8342246,3.374331551,10.96256684,46415.67914,1700.374332,14.43315508,98842.6738,0.46640418,0.017082808,0.000146656,0.687349687,0.023475875,27,0
D:0| T0: 0.17| T1: 0.00| R0: 0.0| R1: 0.0| WTP: 0,0,0.173076923,0,0,0,0,0,0,-727335922.2,1365866345,12642.327,95219572.09,9521957.209,0,98911,4412,491,2100,1609,491,98911,1609,2100,346.4528302,2.993710692,13.05031447,30563.20755,1945.421384,16.14465409,98662.91824,0.307192879,0.019521242,0.000163629,0.766190476,0.021231208,23,0
D:0| T0: 0.17| T1: 0.00| R0: 0.0| R1: 0.0| WTP: 0,0,0.173076923,0,0,0,0,0,0,-666696783.1,825453433,11441.15592,94638986.97,9463898.697,0,93935,4242,655,1900,1245,655,93935,1245,1900,270.3596059,3.118226601,9.187192118,42220.30049,2354.507389,12.4137931,98948.53202,0.423656396,0.023636044,0.00012643,0.655263158,0.020226753,29,0
D:0| T0: 0.17| T1: 0.00| R0: 0.0| R1: 0.0| WTP: 0,0,0.173076923,0,0,0,0,0,0,-728451839.3,939711378,12695.84445,93659616.78,9365961.678,0,98897,4387,449,2109,1660,449,98897,1660,2109,336.2795031,2.714285714,12.95652174,30668.30435,2413.645963,15.74534161,98655.29814,0.308199101,0.024218371,0.00015955,0.787102892,0.021325217,23,0
D:0| T0: 0.17| T1: 0.00| R0: 0.0| R1: 0.0| WTP: 0,0,0.173076923,0,0,0,0,0,0,-663599370.3,638950699,11475.6419,89817275.17,8981727.517,0,92702,4181,793,1906,1113,793,92702,1113,1906,227.7444934,3.370044053,8.202643172,44253.14537,2570.008811,11.71365639,98970.36564,0.444060988,0.025822641,0.000119507,0.583945435,0.020560506,33,0
D:0| T0: 0.17| T1: 0.00| R0: 0.0| R1: 0.0| WTP: 0,0,0.173076923,0,0,0,0,0,0,-621494453.1,938699148,10747.1414,84137382.84,8413738.284,0,86981,3864,724,1785,1061,724,86981,1061,1785,218.2837838,3.162162162,7.891891892,47924.77928,1318.441441,11.15315315,99014.17568,0.481288743,0.013239532,0.000113513,0.594397759,0.020521723,32,0
D:0| T0: 0.17| T1: 0.00| R0: 0.0| R1: 0.0| WTP: 0,0,0.173076923,0,0,0,0,0,0,-568529313,121790188,9778.923271,79583149.44,7958314.944,0,80993,3572,1010,1624,614,1010,80993,614,1624,128.4591549,2.74084507,4.43943662,58222.61127,1649.453521,7.256338028,99226.88169,0.584111724,0.016580231,7.45874E-05,0.378078818,0.020051116,50,0
D:0| T0: 0.17| T1: 0.00| R0: 0.0| R1: 0.0| WTP: 0,0,0.173076923,0,0,0,0,0,0,-719006687.6,1331335240,12521.54221,92929577.28,9292957.728,0,98109,4303,642,2080,1438,642,98109,1438,2080,257.3173077,3.028846154,9.879807692,33538.11538,3101.783654,12.9375,98729.125,0.336659633,0.031169551,0.000131599,0.691346154,0.021200909,30,0
D:0| T0: 0.17| T1: 0.00| R0: 0.0| R1: 0.0| WTP: 0,0,0.173076923,0,0,0,0,0,0,-758771517.8,470935411,13326.06748,92468143.6,9246814.36,0,98975,4158,470,2214,1744,470,98975,1744,2214,343.8774194,2.948387097,14.16774194,26911.39355,1652.574194,17.16774194,98501.38065,0.270936276,0.016588043,0.000173941,0.787714544,0.022369285,23,0
D:0| T0: 0.17| T1: 0.00| R0: 0.0| R1: 0.0| WTP: 0,0,0.173076923,0,0,0,0,0,0,-716564045.7,823434397,12668.54484,83136803.63,8313680.363,0,91798,3750,709,2105,1396,709,91798,1396,2105,220.6186047,3.227906977,9.651162791,46808.49767,2193.618605,12.93953488,98895.94884,0.469692775,0.022052463,0.000131646,0.663182898,0.022930783,31,0
D:0| T0: 0.17| T1: 0.00| R0: 0.0| R1: 0.0| WTP: 0,0,0.173076923,0,0,0,0,0,0,-562850724.8,493045351,9723.849831,76658233.25,7665823.325,0,78717,3460,819,1615,796,819,78717,796,1615,164.25,2.944029851,5.884328358,53998.20149,745.6492537,8.951492537,99118.69776,0.542467537,0.007488666,9.12173E-05,0.492879257,0.020516534,39,0
D:0| T0: 0.17| T1: 0.00| R0: 0.0| R1: 0.0| WTP: 0,0,0.173076923,0,0,0,0,0,0,-605772953.6,1700216563,10334.36868,89054519.44,8905451.944,0,88673,4155,758,1716,958,758,88673,958,1716,201.9960784,2.898039216,6.6,48117.67843,1878.6,9.568627451,99071.76078,0.482862414,0.018870697,9.74648E-05,0.558275058,0.019352001,37,0
D:0| T0: 0.17| T1: 0.00| R0: 0.0| R1: 0.0| WTP: 0,0,0.173076923,0,0,0,0,0,0,-564749685.8,1744119059,9677.077485,80895811.55,8089581.155,0,86383,3836,640,1607,967,640,86383,967,1607,210.6396396,2.792792793,7.099099099,41744.62613,1075.806306,9.990990991,98983.54955,0.419794633,0.010792738,0.000101565,0.601742377,0.018603197,32,0
D:0| T0: 0.17| T1: 0.00| R0: 0.0| R1: 0.0| WTP: 0,0,0.173076923,0,0,0,0,0,0,-626532959.2,2036906360,10902.51794,81407062.38,8140706.238,0,84696,3657,1015,1811,796,1015,84696,796,1811,128.7036011,2.709141274,4.87534626,49912.87812,1636.398892,7.667590028,99005.52078,0.501253436,0.016462144,7.87683E-05,0.439536168,0.021382356,51,0
D:0| T0: 0.17| T1: 0.00| R0: 0.0| R1: 0.0| WTP: 0,0,0.173076923,0,0,0,0,0,0,-627914997.2,809704121,10766.91401,89569296.58,8956929.658,0,91325,4175,744,1788,1044,744,91325,1044,1788,232.0672646,3.228699552,7.865470852,48939.19283,2120.986547,11.21076233,99099.21076,0.490754319,0.02129521,0.000114045,0.583892617,0.019578643,31,0
D:0| T0: 0.17| T1: 0.00| R0: 0.0| R1: 0.0| WTP: 0,0,0.173076923,0,0,0,0,0,0,-689876992.3,1219866412,11874.03504,96175240.13,9617524.013,0,98384,4371,666,1972,1306,666,98384,1306,1972,262.6792453,3.04245283,9.150943396,31383.17453,3812.504717,12.30660377,98763.44811,0.315146158,0.038296738,0.000125074,0.662271805,0.02004391,31,0
D:0| T0: 0.17| T1: 0.00| R0: 0.0| R1: 0.0| WTP: 0,0,0.173076923,0,0,0,0,0,0,-566746625.8,843498920,9866.95088,73399081.83,7339908.183,0,77365,3362,927,1639,712,927,77365,712,1639,138.0924092,2.95709571,5.254125413,55798.29043,1227.316832,8.320132013,99125.09241,0.560535675,0.012331531,8.50998E-05,0.434411226,0.021185291,44,0
D:0| T0: 0.17| T1: 0.00| R0: 0.0| R1: 0.0| WTP: 0,0,0.173076923,0,0,0,0,0,0,-760215563.1,107351963,13509.84965,84723080.42,8472308.042,0,93459,3855,828,2245,1417,828,93459,1417,2245,209.9039301,3.532751092,9.655021834,44171.47598,2845.336245,13.26200873,98796.39301,0.443306638,0.028636599,0.000135118,0.631180401,0.024021229,33,0
D:0| T0: 0.17| T1: 0.00| R0: 0.0| R1: 0.0| WTP: 0,0,0.173076923,0,0,0,0,0,0,-662511521.7,773789021,11439.85065,90518989.38,9051898.938,0,92985,4130,770,1900,1130,770,92985,1130,1900,225.9090909,3.225108225,8.073593074,44802.22511,2728.424242,11.42424242,98984.51515,0.449447407,0.027413046,0.000116181,0.594736842,0.020433403,33,0
D:0| T0: 0.17| T1: 0.00| R0: 0.0| R1: 0.0| WTP: 0,0,0.173076923,0,0,0,0,0,0,-735732877.5,850936611,13041.05973,83679891.14,8367989.114,0,91161,3774,747,2167,1420,747,91161,1420,2167,206.3160173,3.121212121,9.207792208,42829.02597,2070.874459,12.47619048,98747.96104,0.430287487,0.020835212,0.000126969,0.655283802,0.02377113,33,0
D:0| T0: 0.17| T1: 0.00| R0: 0.0| R1: 0.0| WTP: 0,0,0.173076923,0,0,0,0,0,0,-692568809,1701318364,12111.26951,87005333.61,8700533.361,0,92608,4009,676,2012,1336,676,92608,1336,2012,257.4896907,3.386597938,10.22164948,39622.04124,2028.979381,13.71649485,98806.29381,0.398177485,0.020376164,0.000139228,0.664015905,0.021725985,28,0
D:0| T0: 0.17| T1: 0.00| R0: 0.0| R1: 0.0| WTP: 0,0,0.173076923,0,0,0,0,0,0,-589506263.2,778708269,10270.23691,75994417.89,7599441.789,0,77483,3411,1125,1706,581,1125,77483,581,1706,113.8865435,2.854881266,4.340369393,61381.23747,1569.174142,7.306068602,99215.38522,0.616024109,0.015784522,7.51394E-05,0.34056272,0.022017733,55,0
D:0| T0: 0.17| T1: 0.00| R0: 0.0| R1: 0.0| WTP: 0,0,0.173076923,0,0,0,0,0,0,-667335589.2,1391938506,11813.69249,76650964.47,7665096.447,0,83791,3454,768,1963,1195,768,83791,1195,1963,208.5933014,3.545454545,9.19138756,49894.73684,1431.320574,12.8708134,98915.23445,0.501575178,0.014382938,0.000131325,0.608762099,0.023427337,30,0
D:0| T0: 0.17| T1: 0.00| R0: 0.0| R1: 0.0| WTP: 0,0,0.173076923,0,0,0,0,0,0,-518340134.3,43418681,9030.118199,66834224.31,6683422.431,0,68458,3066,1060,1500,440,1060,68458,440,1500,102.3351351,2.748648649,3.889189189,61848.52432,1030.340541,6.754054054,99220.35405,0.621433735,0.010350307,6.95197E-05,0.293333333,0.021911245,53,0
D:0| T0: 0.17| T1: 0.00| R0: 0.0| R1: 0.0| WTP: 0,0,0.173076923,0,0,0,0,0,0,-749550521.1,817384966,13187.18309,90191366.49,9019136.649,0,98186,4148,465,2191,1726,465,98186,1726,2191,256.950495,2.242574257,10.74257426,21868.36634,1323.138614,13.03960396,98357.62871,0.220545355,0.013294958,0.00013225,0.787768142,0.02231479,29,0
D:0| T0: 0.17| T1: 0.00| R0: 0.0| R1: 0.0| WTP: 0,0,0.173076923,0,0,0,0,0,0,-720616972.6,762053968,12522.00461,94516742,9451674.2,0,97860,4382,507,2080,1573,507,97860,1573,2080,327.2215569,2.988023952,12.34730539,29888.65269,1831.257485,15.38323353,98640.66467,0.300627422,0.018376546,0.000155577,0.75625,0.021254854,24,0
D:0| T0: 0.17| T1: 0.00| R0: 0.0| R1: 0.0| WTP: 0,0,0.173076923,0,0,0,0,0,0,-664653268.8,1692506311,11487.82279,90262129.47,9026212.947,0,91311,4147,818,1908,1090,818,91311,1090,1908,187.5451264,2.866425993,6.747292419,43602.94946,2187.859206,9.711191336,98915.8556,0.437708372,0.022004105,9.89969E-05,0.571278826,0.02089562,39,0
D:0| T0: 0.17| T1: 0.00| R0: 0.0| R1: 0.0| WTP: 0,0,0.173076923,0,0,0,0,0,0,-532247164.8,1037620300,9300.43547,67225391.33,6722539.133,0,71917,3080,928,1545,617,928,71917,617,1545,129.0371622,2.993243243,5.033783784,63790.89527,1026.192568,8.175675676,99273.12162,0.6403694,0.01030799,8.39115E-05,0.399352751,0.021483099,43,0
D:0| T0: 0.17| T1: 0.00| R0: 0.0| R1: 0.0| WTP: 0,0,0.173076923,0,0,0,0,0,0,-634659062.3,301400999,11052.78363,82019880.55,8201988.055,0,84013,3657,821,1836,1015,821,84013,1015,1836,191.9510204,3.240816327,7.318367347,49291.91837,1418.718367,10.67346939,98973.35102,0.495349725,0.014257306,0.000108998,0.552832244,0.021853761,35,0
D:0| T0: 0.17| T1: 0.00| R0: 0.0| R1: 0.0| WTP: 0,0,0.173076923,0,0,0,0,0,0,-718769186,1868336855,12509.64306,93287033.1,9328703.31,0,97065,4219,596,2078,1482,596,97065,1482,2078,244.7818182,2.622727273,9.309090909,31378.4,1717.85,12.03181818,98641.36818,0.315295723,0.01726577,0.000122245,0.713185756,0.021408335,32,0
D:0| T0: 0.17| T1: 0.00| R0: 0.0| R1: 0.0| WTP: 0,0,0.173076923,0,0,0,0,0,0,-732907138.9,1868498144,12845.08639,90652819.26,9065281.926,0,96366,4215,639,2134,1495,639,96366,1495,2134,265.5612245,3.178571429,10.75510204,35889.26531,2046.505102,14,98711.09694,0.360445977,0.020562939,0.00014226,0.700562324,0.02214474,28,0
D:0| T0: 0.17| T1: 0.00| R0: 0.0| R1: 0.0| WTP: 0,0,0.173076923,0,0,0,0,0,0,-575823523.6,2101566889,9976.219416,77012552.79,7701255.279,0,79895,3525,949,1657,708,949,79895,708,1657,147.2809365,3.036789298,5.347826087,53873.28428,1511.956522,8.56187291,99108.48161,0.54116444,0.015195255,8.75897E-05,0.427278214,0.02074024,43,0
D:0| T0: 0.17| T1: 0.00| R0: 0.0| R1: 0.0| WTP: 0,0,0.173076923,0,0,0,0,0,0,-741864385.9,1665097450,13007.42655,91493058.35,9149305.835,0,98719,4249,439,2161,1722,439,98719,1722,2161,329.7375,2.68125,13.38125,27909.3375,2114.775,16.1375,98544.8625,0.280851358,0.021227854,0.000163217,0.796853309,0.021890416,23,0
D:0| T0: 0.17| T1: 0.00| R0: 0.0| R1: 0.0| WTP: 0,0,0.173076923,0,0,0,0,0,0,-662826836.7,1716179948,11345.28405,95562634.37,9556263.437,0,99095,4423,486,1884,1398,486,99095,1398,1884,334.8915663,2.873493976,11.22891566,28923.22892,2058.084337,14.15060241,98773.43976,0.290764589,0.020632686,0.000143238,0.742038217,0.019012059,24,0
D:0| T0: 0.17| T1: 0.00| R0: 0.0| R1: 0.0| WTP: 0,0,0.173076923,0,0,0,0,0,0,-634158888.6,1560278715,11294.9511,69411333.74,6941133.374,0,75833,3087,910,1877,967,910,75833,967,1877,160.9176955,3.62962963,7.567901235,61382.72016,1061.55144,11.30864198,99119.16872,0.616514747,0.010671048,0.000115289,0.515183804,0.024752084,34,0
D:0| T0: 0.17| T1: 0.00| R0: 0.0| R1: 0.0| WTP: 0,0,0.173076923,0,0,0,0,0,0,-747816425.2,991019385,13133.49717,91141566.96,9114156.696,0,98318,4162,583,2182,1599,583,98318,1599,2182,283.1027027,3.075675676,11.67567568,34587.07568,3157.908108,14.82702703,98695.38919,0.347170772,0.031726455,0.000150272,0.732813932,0.022193291,27,0
D:0| T0: 0.17| T1: 0.00| R0: 0.0| R1: 0.0| WTP: 0,0,0.173076923,0,0,0,0,0,0,-736947521.3,118052103,12946.83231,89605905.81,8960590.581,0,96633,4227,656,2151,1495,656,96633,1495,2151,255.4228856,3.184079602,10.56716418,41567.88557,2422.174129,13.83084577,98835.62687,0.416832852,0.024345991,0.000140456,0.69502557,0.022259477,29,0
D:0| T0: 0.17| T1: 0.00| R0: 0.0| R1: 0.0| WTP: 0,0,0.173076923,0,0,0,0,0,0,-761282297.9,1209758844,13504.17446,86073574.87,8607357.487,0,95860,3925,560,2244,1684,560,95860,1684,2244,303.7407407,3.358024691,13.69753086,36303.97531,1733.549383,17.14197531,98635.08642,0.364886585,0.017415983,0.000173952,0.750445633,0.023409138,24,0
D:0| T0: 0.17| T1: 0.00| R0: 0.0| R1: 0.0| WTP: 0,0,0.173076923,0,0,0,0,0,0,-603237954.8,70671723,10534.61071,76507419.43,7650741.943,0,79500,3436,1022,1750,728,1022,79500,728,1750,128.339233,2.926253687,5.03539823,52399.29794,1438.873156,8.044247788,99022.61357,0.526653316,0.014469659,8.2242E-05,0.416,0.022012579,49,0
D:0| T0: 0.17| T1: 0.00| R0: 0.0| R1: 0.0| WTP: 0,0,0.173076923,0,0,0,0,0,0,-540962547.2,1722612191,9315.090036,75208045.35,7520804.535,0,75249,3375,1019,1547,528,1019,75249,528,1547,119.4916667,2.711111111,4.155555556,62483.125,1153.508333,6.994444444,99289.01111,0.626964079,0.011590223,7.1633E-05,0.341305753,0.020558686,51,0
D:0| T0: 0.17| T1: 0.00| R0: 0.0| R1: 0.0| WTP: 0,0,0.173076923,0,0,0,0,0,0,-505605872.8,1968291596,8624.167481,74397498.72,7439749.872,0,72131,3360,929,1432,503,929,72131,503,1432,109.9691517,2.28277635,3.542416452,56048.71722,741.5475578,5.94344473,99168.98972,0.563316224,0.007450029,6.09729E-05,0.351256983,0.019852768,56,0
D:0| T0: 0.17| T1: 0.00| R0: 0.0| R1: 0.0| WTP: 0,0,0.173076923,0,0,0,0,0,0,-772151892.3,1877569084,13602.18262,92042761.34,9204276.134,0,98978,4152,490,2260,1770,490,98978,1770,2260,297.4382022,2.691011236,12.59550562,25539.60112,1775.426966,15.34269663,98431.34831,0.257095747,0.017838756,0.000155355,0.783185841,0.022833357,26,0
D:0| T0: 0.17| T1: 0.00| R0: 0.0| R1: 0.0| WTP: 0,0,0.173076923,0,0,0,0,0,0,-764972838.5,1726322189,13517.13775,89115951.13,8911595.113,0,98174,4184,534,2246,1712,534,98174,1712,2246,295.1271676,3.005780347,12.83815029,29061.50289,1929.427746,15.94219653,98516.90751,0.292345127,0.019382542,0.000161555,0.762243989,0.022877748,25,0
D:0| T0: 0.17| T1: 0.00| R0: 0.0| R1: 0.0| WTP: 0,0,0.173076923,0,0,0,0,0,0,-717132070.7,307848836,12491.35485,92564327.97,9256432.797,0,97357,4267,534,2075,1541,534,97357,1541,2075,290.4565217,2.820652174,11.14673913,31311.40761,1866.521739,14.05978261,98654.40761,0.314746647,0.018741872,0.000142482,0.742650602,0.021313311,27,0
D:0| T0: 0.17| T1: 0.00| R0: 0.0| R1: 0.0| WTP: 0,0,0.173076923,0,0,0,0,0,0,-694525647.2,1154000220,11975.86493,95732400.98,9573240.098,0,99096,4501,433,1989,1556,433,99096,1556,1989,279.3467337,2.115577889,9.899497487,19816.96985,1299.366834,12.08040201,98487.13568,0.19993622,0.013043102,0.000122288,0.782302665,0.020071446,29,0
D:0| T0: 0.17| T1: 0.00| R0: 0.0| R1: 0.0| WTP: 0,0,0.173076923,0,0,0,0,0,0,-547749686.8,2028661055,9506.31472,72433950.83,7243395.083,0,76239,3296,920,1579,659,920,76239,659,1579,131.7038217,2.821656051,4.869426752,55277.23248,1272.031847,7.808917197,99128.59236,0.555444398,0.012779928,7.99557E-05,0.417352755,0.020711185,45,0
D:0| T0: 0.17| T1: 0.00| R0: 0.0| R1: 0.0| WTP: 0,0,0.173076923,0,0,0,0,0,0,-689686172.2,1629114640,11903.54156,94509094.32,9450909.432,0,95836,4325,727,1977,1250,727,95836,1250,1977,227.3708333,2.95,8.104166667,36434.00417,2492.175,11.14166667,98809.53333,0.365746896,0.02504853,0.000113312,0.632271118,0.020628991,35,0
D:0| T0: 0.17| T1: 0.00| R0: 0.0| R1: 0.0| WTP: 0,0,0.173076923,0,0,0,0,0,0,-750778153.5,1439048174,13181.69957,91693175.13,9169317.513,0,98793,4165,519,2190,1671,519,98793,1671,2190,329.88125,3.175,13.56875,30819.54375,2627.975,16.8125,98612.6375,0.309780631,0.026386221,0.000170097,0.763013699,0.022167562,23,0
D:0| T0: 0.17| T1: 0.00| R0: 0.0| R1: 0.0| WTP: 0,0,0.173076923,0,0,0,0,0,0,-761713588,865227006,13439.25341,89750917.52,8975091.752,0,99233,4139,438,2233,1795,438,99233,1795,2233,344,2.84,14.76666667,24644.89333,1777.693333,17.7,98444.21333,0.248399924,0.017835693,0.000178847,0.803851321,0.022502595,22,0
D:0| T0: 0.17| T1: 0.00| R0: 0.0| R1: 0.0| WTP: 0,0,0.173076923,0,0,0,0,0,0,-711807955.5,890479738,12341.98599,94708656.16,9470865.616,0,97864,4288,672,2050,1378,672,97864,1378,2050,251.9354839,3.01843318,9.30875576,34474.97235,3230.56682,12.40552995,98759.06452,0.346010264,0.032472051,0.000126141,0.672195122,0.020947437,31,0
D:0| T0: 0.17| T1: 0.00| R0: 0.0| R1: 0.0| WTP: 0,0,0.173076923,0,0,0,0,0,0,-609307656.5,1017049163,10554.14155,81600579.04,8160057.904,0,83746,3728,717,1753,1036,717,83746,1036,1753,213.5136364,3.140909091,7.777272727,51424.03636,1362.140909,11.04090909,99057.67273,0.516459805,0.013676023,0.000112735,0.59098688,0.020932343,32,0
D:0| T0: 0.17| T1: 0.00| R0: 0.0| R1: 0.0| WTP: 0,0,0.173076923,0,0,0,0,0,0,-530456542.1,1707305064,9063.517842,77280649.97,7728064.997,0,76051,3475,958,1505,547,958,76051,547,1505,134.5545455,2.806060606,4.421212121,58729.73333,1206.193939,7.318181818,99240.75152,0.589573523,0.01211463,7.49681E-05,0.36345515,0.019789352,48,0
D:0| T0: 0.17| T1: 0.00| R0: 0.0| R1: 0.0| WTP: 0,0,0.173076923,0,0,0,0,0,0,-763226687,400145663,13410.17616,92717879,9271787.9,0,99088,4284,408,2228,1820,408,99088,1820,2228,293.7417582,2.181318681,12.15384615,20558.84615,1460.549451,14.41208791,98322.45604,0.207477744,0.01467035,0.000145634,0.816876122,0.022485064,26,0
D:0| T0: 0.17| T1: 0.00| R0: 0.0| R1: 0.0| WTP: 0,0,0.173076923,0,0,0,0,0,0,-627991242,1662654181,10891.06185,83438149.64,8343814.964,0,86021,3770,744,1809,1065,744,86021,1065,1809,197.5349794,2.962962963,7.296296296,51404.48971,1448.872428,10.34979424,99062.19753,0.515931599,0.014553019,0.00010558,0.588723051,0.021029749,35,0
D:0| T0: 0.17| T1: 0.00| R0: 0.0| R1: 0.0| WTP: 0,0,0.173076923,0,0,0,0,0,0,-723120148.6,182136456,12564.16388,94911954.51,9491195.451,0,98897,4399,492,2087,1595,492,98897,1595,2087,301.6428571,2.653846154,11.36813187,24809.94505,1883.093407,14.06043956,98533.93956,0.249806983,0.018904701,0.00014239,0.764254911,0.021102763,26,0
D:0| T0: 0.17| T1: 0.00| R0: 0.0| R1: 0.0| WTP: 0,0,0.173076923,0,0,0,0,0,0,-510805827.8,979575387,8749.985431,73306556.27,7330655.627,0,73446,3306,1071,1453,382,1071,73446,382,1453,114.510929,2.81420765,3.816939891,60939.7541,1352.377049,6.759562842,99283.5929,0.611757537,0.013584382,6.92741E-05,0.262904336,0.019783242,53,0
D:0| T0: 0.17| T1: 0.00| R0: 0.0| R1: 0.0| WTP: 0,0,0.173076923,0,0,0,0,0,0,-752865721.7,2142525414,13253.29308,90201067.86,9020106.786,0,97981,4132,577,2202,1625,577,97981,1625,2202,304.5411765,3.311764706,12.81176471,37058.72941,2259.817647,16.2,98731.66471,0.371897656,0.022698971,0.000164296,0.737965486,0.022473745,25,0
D:0| T0: 0.17| T1: 0.00| R0: 0.0| R1: 0.0| WTP: 0,0,0.173076923,0,0,0,0,0,0,-669374779.2,1464057597,11595.62435,89593561.73,8959356.173,0,94756,4165,637,1926,1289,637,94756,1289,1926,252.1707317,3.024390244,9.248780488,41995.52683,1727.434146,12.37560976,98927.07805,0.421312851,0.017348916,0.000125611,0.669262721,0.02032589,30,0
D:0| T0: 0.17| T1: 0.00| R0: 0.0| R1: 0.0| WTP: 0,0,0.173076923,0,0,0,0,0,0,-717781660.4,364562610,12574.29869,89066726.1,8906672.61,0,96029,4108,544,2089,1545,544,96029,1545,2089,305.1309524,3.148809524,12.28571429,35301.55357,1931.017857,15.53571429,98718.52976,0.354767598,0.019381356,0.000157415,0.73958832,0.021753845,24,0
D:0| T0: 0.17| T1: 0.00| R0: 0.0| R1: 0.0| WTP: 0,0,0.173076923,0,0,0,0,0,0,-739123549.4,40350784,12994.79264,89383917.23,8938391.723,0,96707,4119,577,2159,1582,577,96707,1582,2159,293.2571429,3.205714286,12.21142857,37783.58857,2141.005714,15.50857143,98742.28,0.379308437,0.021504096,0.000157128,0.732746642,0.022325168,25,0
D:0| T0: 0.17| T1: 0.00| R0: 0.0| R1: 0.0| WTP: 0,0,0.173076923,0,0,0,0,0,0,-630320686.5,804064356,10690.75706,95782833.57,9578283.357,0,96699,4465,469,1775,1306,469,96699,1306,1775,315.7514124,2.587570621,9.920903955,32584.49153,1581.214689,12.55367232,98856.37853,0.327467534,0.015851822,0.000127174,0.735774648,0.018355929,26,0
D:0| T0: 0.17| T1: 0.00| R0: 0.0| R1: 0.0| WTP: 0,0,0.173076923,0,0,0,0,0,0,-685991650.3,2125493986,12055.98206,83192547.17,8319254.717,0,89136,3772,638,2003,1365,638,89136,1365,2003,266.4134078,3.463687151,11.03351955,44495.07263,1574.268156,14.58659218,98853.69274,0.447203762,0.015805759,0.000148186,0.681477783,0.02247128,26,0
D:0| T0: 0.17| T1: 0.00| R0: 0.0| R1: 0.0| WTP: 0,0,0.173076923,0,0,0,0,0,0,-593797431.9,23154253,10046.8236,91456251.81,9145625.181,0,92235,4223,568,1668,1100,568,92235,1100,1668,313.4647059,3.229411765,9.664705882,41380.3,1443.670588,13.02941176,99035.56471,0.415550581,0.014463954,0.000131843,0.659472422,0.018084241,25,0
D:0| T0: 0.17| T1: 0.00| R0: 0.0| R1: 0.0| WTP: 0,0,0.173076923,0,0,0,0,0,0,-558924058.9,1391367689,9752.159013,71316108.24,7131610.824,0,75735,3244,877,1620,743,877,75735,743,1620,154.5703422,3.216730038,5.996197719,55303.64259,972.9391635,9.338403042,99103.77947,0.555887137,0.009771367,9.53439E-05,0.458641975,0.021390374,38,0
D:0| T0: 0.17| T1: 0.00| R0: 0.0| R1: 0.0| WTP: 0,0,0.173076923,0,0,0,0,0,0,-645565870.7,574142276,11186.19609,86256066.06,8625606.606,0,91196,3996,678,1858,1180,678,91196,1180,1858,233.3192488,3.093896714,8.577464789,44200.78873,1965.924883,11.77464789,98959.32394,0.443715522,0.019740069,0.000119607,0.635091496,0.020373701,31,0
D:0| T0: 0.17| T1: 0.00| R0: 0.0| R1: 0.0| WTP: 0,0,0.173076923,0,0,0,0,0,0,-555434148.1,898736779,9709.763895,69945953.4,6994595.34,0,74196,3227,1138,1613,475,1138,74196,475,1613,102.1162791,2.821705426,4.023255814,61634.25323,1423.284238,6.971576227,99221.41602,0.61881962,0.014310927,7.14708E-05,0.294482331,0.021739716,56,0
D:0| T0: 0.17| T1: 0.00| R0: 0.0| R1: 0.0| WTP: 0,0,0.173076923,0,0,0,0,0,0,-616130920,346473503,10355.32283,98364778.3,9836477.83,0,97542,4624,578,1719,1141,578,97542,1141,1719,300.6701571,2.916230366,8.853403141,39478.46597,2894.570681,11.90052356,99047.81152,0.395819988,0.029026163,0.000120658,0.663757999,0.017623178,28,0
D:0| T0: 0.17| T1: 0.00| R0: 0.0| R1: 0.0| WTP: 0,0,0.173076923,0,0,0,0,0,0,-695358939.5,445552282,12106.23608,90047135.26,9004713.526,0,94991,4212,677,2011,1334,677,94991,1334,2011,274.1005291,3.465608466,10.47619048,46304.55026,2868.232804,14.05820106,98991.91005,0.464212257,0.028806681,0.000142894,0.663351566,0.021170427,26,0
D:0| T0: 0.17| T1: 0.00| R0: 0.0| R1: 0.0| WTP: 0,0,0.173076923,0,0,0,0,0,0,-693418273.8,911758476,11892.8024,98778153.77,9877815.377,0,99257,4509,432,1975,1543,432,99257,1543,1975,359.61875,2.6125,12.2125,24559.5875,1736.79375,14.93125,98616.59375,0.247418936,0.017413658,0.000150958,0.781265823,0.019897841,23,0
D:0| T0: 0.17| T1: 0.00| R0: 0.0| R1: 0.0| WTP: 0,0,0.173076923,0,0,0,0,0,0,-682420205.5,1464197940,11641.14532,100362939.5,10036293.95,0,98729,4592,565,1933,1368,565,98729,1368,1933,319.1639344,3.016393443,10.44808743,29949.21858,3144.420765,13.53005464,98755.02186,0.300938917,0.031555308,0.000137068,0.707708226,0.019578847,27,0
D:0| T0: 0.17| T1: 0.00| R0: 0.0| R1: 0.0| WTP: 0,0,0.173076923,0,0,0,0,0,0,-672442760.2,500405854,11856.65665,79609927.7,7960992.77,0,88003,3750,755,1970,1215,755,88003,1215,1970,219.0772947,3.536231884,9.342995169,47447.14976,1727.101449,12.98067633,98923.6715,0.476609454,0.017354382,0.000132303,0.616751269,0.0223856,30,0
D:0| T0: 0.17| T1: 0.00| R0: 0.0| R1: 0.0| WTP: 0,0,0.173076923,0,0,0,0,0,0,-717230902.9,772037341,12621.36541,86162632.14,8616263.214,0,96894,4044,487,2097,1610,487,96894,1610,2097,311.3081761,2.987421384,13.06289308,34017.59119,1997.371069,16.11949686,98692.80503,0.341901555,0.020039729,0.000163166,0.767763472,0.021642207,23,0
D:0| T0: 0.17| T1: 0.00| R0: 0.0| R1: 0.0| WTP: 0,0,0.173076923,0,0,0,0,0,0,-505771492.3,1543158763,8795.603304,65991327.09,6599132.709,0,69390,3038,992,1461,469,992,69390,469,1461,112.8975904,2.846385542,4.21686747,62257.57831,1012.490964,7.219879518,99251.10241,0.625358985,0.010168947,7.41951E-05,0.321013005,0.02105521,48,0
D:0| T0: 0.17| T1: 0.00| R0: 0.0| R1: 0.0| WTP: 0,0,0.173076923,0,0,0,0,0,0,-778892987.2,1604932531,13763.8525,90700362.31,9070036.231,0,98943,4191,439,2287,1848,439,98943,1848,2287,377.5217391,3.115942029,16.46376812,30493.11594,2115.115942,19.62318841,98544.52899,0.306701045,0.021215747,0.000198321,0.808045474,0.023114318,20,0
D:0| T0: 0.17| T1: 0.00| R0: 0.0| R1: 0.0| WTP: 0,0,0.173076923,0,0,0,0,0,0,-734323694.5,539051477,12762.81044,96183172.55,9618317.255,0,98459,4348,601,2120,1519,601,98459,1519,2120,272.4019608,2.862745098,10.23529412,32016.20098,2768.79902,13.17156863,98672.72549,0.321484261,0.027831208,0.000134137,0.716509434,0.021531805,30,0
D:0| T0: 0.17| T1: 0.00| R0: 0.0| R1: 0.0| WTP: 0,0,0.173076923,0,0,0,0,0,0,-548227284.1,1743124675,9470.998305,74677368.9,7467736.89,0,76233,3354,850,1573,723,850,76233,723,1573,152.405694,2.928825623,5.455516014,56833.71174,918.6619217,8.459074733,99160.48399,0.570895005,0.009226293,8.65954E-05,0.459631278,0.020634109,41,0
D:0| T0: 0.17| T1: 0.00| R0: 0.0| R1: 0.0| WTP: 0,0,0.173076923,0,0,0,0,0,0,-674434843.3,1965983789,11833.71598,82749044.39,8274904.439,0,89740,3776,856,1966,1110,856,89740,1110,1966,189.6305221,3.333333333,7.730923695,48045.12851,2100.37751,11.17269076,98971.45382,0.482185986,0.0211164,0.000113996,0.564598169,0.021907733,36,0
D:0| T0: 0.17| T1: 0.00| R0: 0.0| R1: 0.0| WTP: 0,0,0.173076923,0,0,0,0,0,0,-646551797.6,516774280,11204.33785,86334905.15,8633490.515,0,87385,3866,861,1861,1000,861,87385,1000,1861,177.0785714,2.992857143,6.521428571,45975.06071,2008.121429,9.589285714,98935.58214,0.461852872,0.020191309,9.77697E-05,0.537345513,0.021296561,39,0
D:0| T0: 0.17| T1: 0.00| R0: 0.0| R1: 0.0| WTP: 0,0,0.173076923,0,0,0,0,0,0,-713550984.2,86603142,12383.81147,94360410.94,9436041.094,0,98898,4265,403,2057,1654,403,98898,1654,2057,405.5185185,2.925925926,15.13333333,27696.96296,1901.059259,18.11111111,98622.25185,0.278952662,0.019046616,0.000182696,0.804083617,0.020799207,20,0
D:0| T0: 0.17| T1: 0.00| R0: 0.0| R1: 0.0| WTP: 0,0,0.173076923,0,0,0,0,0,0,-573761478.6,1431870609,9886.929183,79415019.48,7941501.948,0,82998,3636,946,1642,696,946,82998,696,1642,130.7758621,2.637931034,4.58908046,50437.72414,1655.818966,7.295977011,99087.63218,0.506501078,0.016641673,7.4763E-05,0.423873325,0.019783609,50,0
D:0| T0: 0.17| T1: 0.00| R0: 0.0| R1: 0.0| WTP: 0,0,0.173076923,0,0,0,0,0,0,-648270298.7,1592383984,11240.22261,86259168.06,8625916.806,0,91945,3987,618,1867,1249,618,91945,1249,1867,227.2191781,2.735159817,8.388127854,39334.63927,1227.438356,11.21004566,98852.12329,0.395220387,0.012328099,0.000114003,0.668987681,0.020305617,32,0
D:0| T0: 0.17| T1: 0.00| R0: 0.0| R1: 0.0| WTP: 0,0,0.173076923,0,0,0,0,0,0,-649246888.5,1440183867,11240.57629,87218073.97,8721807.397,0,90401,4012,712,1867,1155,712,90401,1155,1867,241.5673077,3.336538462,8.822115385,46862.13942,2099.067308,12.22596154,99007.34135,0.470314749,0.021075583,0.000124547,0.618639529,0.020652426,30,0
D:0| T0: 0.17| T1: 0.00| R0: 0.0| R1: 0.0| WTP: 0,0,0.173076923,0,0,0,0,0,0,-676799220.2,1696510588,11822.59613,85669413.63,8566941.363,0,91617,3904,699,1964,1265,699,91617,1265,1964,226.6774194,3.138248848,8.903225806,48506.90783,1989.760369,12.11520737,99005.70046,0.486481376,0.019985704,0.000123356,0.644093686,0.02143707,31,0
D:0| T0: 0.17| T1: 0.00| R0: 0.0| R1: 0.0| WTP: 0,0,0.173076923,0,0,0,0,0,0,-734758884,895039877,12827.95857,93360955.29,9336095.529,0,98327,4226,601,2131,1530,601,98327,1530,2131,314.6315789,3.450292398,12.31578947,34618.76608,3014.690058,15.81871345,98745.46199,0.347554789,0.03026429,0.000160528,0.717972783,0.021672582,25,0
D:0| T0: 0.17| T1: 0.00| R0: 0.0| R1: 0.0| WTP: 0,0,0.173076923,0,0,0,0,0,0,-712524408.7,129565953,12495.93698,87727559.62,8772755.962,0,91996,3956,864,2076,1212,864,91996,1212,2076,200.52,3.36,8.156,44259.412,2601.612,11.596,98860.564,0.444315446,0.026174086,0.000118352,0.583815029,0.022566199,35,0
D:0| T0: 0.17| T1: 0.00| R0: 0.0| R1: 0.0| WTP: 0,0,0.173076923,0,0,0,0,0,0,-617331711.1,1902565669,10651.24023,84769699.35,8476969.935,0,88098,3916,684,1769,1085,684,88098,1085,1769,218.3348214,2.959821429,7.754464286,48843.17857,1504.4375,10.80803571,99055.32143,0.49019222,0.015103927,0.000109978,0.613340871,0.020079911,32,0
D:0| T0: 0.17| T1: 0.00| R0: 0.0| R1: 0.0| WTP: 0,0,0.173076923,0,0,0,0,0,0,-673541249.6,1984179288,11809.87474,83047512.77,8304751.277,0,85286,3698,1024,1962,938,1024,85286,938,1962,157.5133333,3.306666667,6.383333333,49598.64667,2143.453333,9.786666667,98940.39667,0.49827358,0.021565166,0.000100176,0.478083588,0.023004948,43,0
D:0| T0: 0.17| T1: 0.00| R0: 0.0| R1: 0.0| WTP: 0,0,0.173076923,0,0,0,0,0,0,-747857677.9,677377223,13115.84607,92065374.24,9206537.424,0,96280,4223,770,2179,1409,770,96280,1409,2179,221.5756303,3.147058824,9.012605042,39363.58403,3290.365546,12.24789916,98768.97479,0.394909604,0.033104249,0.000124738,0.646626893,0.022631907,33,0
D:0| T0: 0.17| T1: 0.00| R0: 0.0| R1: 0.0| WTP: 0,0,0.173076923,0,0,0,0,0,0,-675178391.6,973583301,11526.63031,98846876.14,9884687.614,0,95958,4478,760,1914,1154,760,95958,1154,1914,259.3257919,3.334841629,8.497737557,43850.80995,3535.565611,11.92307692,99005.99548,0.439586763,0.035519439,0.000121604,0.60292581,0.019946226,32,0
D:0| T0: 0.17| T1: 0.00| R0: 0.0| R1: 0.0| WTP: 0,0,0.173076923,0,0,0,0,0,0,-568218003.9,781062938,9524.574277,91989290.07,9198929.007,0,91908,4283,703,1581,878,703,91908,878,1581,248.0185185,3.157407407,7.166666667,42947.40278,1958.810185,10.4212963,99104.86111,0.431010423,0.019647004,0.000106081,0.555344719,0.017201985,31,0
D:0| T0: 0.17| T1: 0.00| R0: 0.0| R1: 0.0| WTP: 0,0,0.173076923,0,0,0,0,0,0,-682307978.3,338783425,11871.66043,88724956.98,8872495.698,0,95372,4169,834,1972,1138,834,95372,1138,1972,204.2128514,3.273092369,7.787148594,44151.09639,3123.694779,11.13253012,98967.06426,0.442658151,0.031412057,0.000113348,0.577079108,0.020676928,36,0
D:0| T0: 0.17| T1: 0.00| R0: 0.0| R1: 0.0| WTP: 0,0,0.173076923,0,0,0,0,0,0,-571391360,1027579040,9838.87882,79447419.01,7944741.901,0,84543,3752,958,1634,676,958,84543,676,1634,139.9476923,2.852307692,4.898461538,50773.58462,1962.036923,7.833846154,99115.53231,0.509698118,0.019720062,8.01581E-05,0.41370869,0.019327443,46,0
D:0| T0: 0.17| T1: 0.00| R0: 0.0| R1: 0.0| WTP: 0,0,0.173076923,0,0,0,0,0,0,-668773850.6,764973813,11613.21095,88113303.27,8811330.327,0,94571,4006,718,1929,1211,718,94571,1211,1929,207.0326531,2.848979592,7.746938776,40442.51837,2628.502041,10.67755102,98891.06531,0.405798602,0.026415108,0.000108634,0.627786418,0.020397373,34,0
D:0| T0: 0.17| T1: 0.00| R0: 0.0| R1: 0.0| WTP: 0,0,0.173076923,0,0,0,0,0,0,-733627885.1,1245753446,12798.05983,93724893.33,9372489.333,0,97900,4300,651,2126,1475,651,97900,1475,2126,294.8087432,3.486338798,11.49726776,41405.99454,3661.120219,15.0273224,98883.0765,0.41507225,0.036781786,0.000152542,0.693791157,0.021716037,27,0
D:0| T0: 0.17| T1: 0.00| R0: 0.0| R1: 0.0| WTP: 0,0,0.173076923,0,0,0,0,0,0,-683678591.3,1013177794,11972.50382,85053400.53,8505340.053,0,91062,3932,672,1989,1317,672,91062,1317,1989,240.3694581,3.201970443,9.620689655,43462.76847,1875.512315,12.94581281,98866.78325,0.436534882,0.018840445,0.000131741,0.66214178,0.021842261,29,0
D:0| T0: 0.17| T1: 0.00| R0: 0.0| R1: 0.0| WTP: 0,0,0.173076923,0,0,0,0,0,0,-574679808.5,1395089249,10111.841,69087758.52,6908775.852,0,71861,3129,1103,1680,577,1103,71861,577,1680,118.4346505,3.212765957,4.930091185,60730.65957,1141.87234,8.291793313,99148.15805,0.610295679,0.011478984,8.50384E-05,0.343452381,0.023378467,47,0
D:0| T0: 0.17| T1: 0.00| R0: 0.0| R1: 0.0| WTP: 0,0,0.173076923,0,0,0,0,0,0,-470789265.9,1339545835,8140.376914,63770420.19,6377042.019,0,65387,2882,1190,1352,162,1190,65387,162,1352,75.97263158,2.368421053,2.686315789,69858.76842,1045.071579,5.195789474,99415.03158,0.700937387,0.010500945,5.37638E-05,0.119822485,0.020677209,68,0
D:0| T0: 0.17| T1: 0.00| R0: 0.0| R1: 0.0| WTP: 0,0,0.173076923,0,0,0,0,0,0,-673527786.4,219139554,11579.18041,94568765.74,9456876.574,0,96544,4329,491,1923,1432,491,96544,1432,1923,361.4802632,3.151315789,12.50657895,31722.53289,1667.973684,15.73684211,98752.59211,0.319189979,0.016717509,0.000159276,0.744669787,0.019918379,22,0
D:0| T0: 0.17| T1: 0.00| R0: 0.0| R1: 0.0| WTP: 0,0,0.173076923,0,0,0,0,0,0,-596277883.9,1336508942,10349.09021,78823373.51,7882337.351,0,82480,3605,776,1719,943,776,82480,943,1719,195.7619048,3.281385281,7.298701299,53636.34199,1450.264069,10.64935065,99110.32468,0.538538564,0.014562506,0.000108475,0.548574753,0.020841416,33,0
D:0| T0: 0.17| T1: 0.00| R0: 0.0| R1: 0.0| WTP: 0,0,0.173076923,0,0,0,0,0,0,-531369922.2,448559423,9394.843176,61627763.4,6162776.34,0,66737,2754,1257,1561,304,1257,66737,304,1561,78.88761468,2.752293578,3.419724771,65514.79587,1179.688073,6.316513761,99236.48165,0.658194295,0.011864962,6.49879E-05,0.194746957,0.023390323,63,0
D:0| T0: 0.17| T1: 0.00| R0: 0.0| R1: 0.0| WTP: 0,0,0.173076923,0,0,0,0,0,0,-643350908.6,2110028840,11102.75469,88213174.17,8821317.417,0,92245,4193,739,1844,1105,739,92245,1105,1844,222.877193,3.144736842,7.921052632,43966.5,1974.100877,11.17105263,98986.40351,0.441204221,0.01982579,0.000113836,0.599240781,0.019990243,33,0
D:0| T0: 0.17| T1: 0.00| R0: 0.0| R1: 0.0| WTP: 0,0,0.173076923,0,0,0,0,0,0,-766960904.6,1982030155,13712.91118,81315345.59,8131534.559,0,92621,3757,826,2279,1453,826,92621,1453,2279,204.0533333,3.564444444,9.973333333,47907.88,2736.684444,13.64444444,98854.59556,0.480627265,0.027547134,0.000138957,0.637560333,0.024605651,33,0
D:0| T0: 0.17| T1: 0.00| R0: 0.0| R1: 0.0| WTP: 0,0,0.173076923,0,0,0,0,0,0,-687567387.4,696219407,12091.90952,82971911.59,8297191.159,0,90884,3865,611,2009,1398,611,90884,1398,2009,251.5291005,3.126984127,10.48148148,48203.1746,1599.433862,13.70899471,98953.48677,0.483662021,0.016059729,0.000139263,0.695868591,0.022105101,27,0
D:0| T0: 0.17| T1: 0.00| R0: 0.0| R1: 0.0| WTP: 0,0,0.173076923,0,0,0,0,0,0,-669611979.3,1402539442,11459.75736,96624111.53,9662411.153,0,97681,4405,529,1903,1374,529,97681,1374,1903,319.3409091,2.914772727,10.68181818,34945.33523,2541.017045,13.67045455,98848.25568,0.35083781,0.025493686,0.000138703,0.722017867,0.019481783,26,0
D:0| T0: 0.17| T1: 0.00| R0: 0.0| R1: 0.0| WTP: 0,0,0.173076923,0,0,0,0,0,0,-716502204.6,1319833493,12408.44562,96079923.54,9607992.354,0,98667,4445,602,2061,1459,602,98667,1459,2061,308.5333333,3.272222222,11.31111111,33996.01111,3701.288889,14.63888889,98769.35,0.341248867,0.037164623,0.000148638,0.707908782,0.020888443,26,0
D:0| T0: 0.17| T1: 0.00| R0: 0.0| R1: 0.0| WTP: 0,0,0.173076923,0,0,0,0,0,0,-641638040.5,663608076,11155.45369,83865355.79,8386535.579,0,89060,3866,823,1853,1030,823,89060,1030,1853,200.325,3.3375,7.5625,47226.66667,2243.458333,10.97916667,98998.87917,0.474103836,0.022542197,0.00011207,0.55585537,0.020806198,35,0
D:0| T0: 0.17| T1: 0.00| R0: 0.0| R1: 0.0| WTP: 0,0,0.173076923,0,0,0,0,0,0,-604723160.5,414696500,10558.68112,76789104.6,7678910.46,0,81530,3543,985,1754,769,985,81530,769,1754,143.75,3.121710526,5.595394737,59464.97697,1854.016447,8.825657895,99202.04605,0.596569083,0.018639624,9.05889E-05,0.438426454,0.021513553,43,0
D:0| T0: 0.17| T1: 0.00| R0: 0.0| R1: 0.0| WTP: 0,0,0.173076923,0,0,0,0,0,0,-565282351.8,1249738535,9966.997061,66932498.73,6693249.873,0,71408,2997,1047,1656,609,1047,71408,609,1656,120.6070288,3.21086262,5.099041534,60883.63578,909.7859425,8.47284345,99153.92652,0.611835048,0.009144077,8.67926E-05,0.367753623,0.023191328,45,0
D:0| T0: 0.17| T1: 0.00| R0: 0.0| R1: 0.0| WTP: 0,0,0.173076923,0,0,0,0,0,0,-600695847.4,614415382,10480.59241,76666226.81,7666622.681,0,81156,3437,969,1741,772,969,81156,772,1741,141.8311688,3.051948052,5.506493506,53335.33117,1677.727273,8.655844156,99076.01299,0.535704666,0.016865081,8.84713E-05,0.44342332,0.021452511,44,0
D:0| T0: 0.17| T1: 0.00| R0: 0.0| R1: 0.0| WTP: 0,0,0.173076923,0,0,0,0,0,0,-500094682.4,524899953,8533.775742,73405895.33,7340589.533,0,74628,3421,993,1417,424,993,74628,424,1417,116.1850829,2.643646409,3.781767956,57789.56077,1196.237569,6.513812155,99248.29558,0.58030069,0.012014346,6.68582E-05,0.299223712,0.018987511,52,0
D:0| T0: 0.17| T1: 0.00| R0: 0.0| R1: 0.0| WTP: 0,0,0.173076923,0,0,0,0,0,0,-729269052.2,1338977757,12654.74449,96531827.47,9653182.747,0,99030,4415,403,2102,1699,403,99030,1699,2102,363.6623377,2.551948052,13.53896104,26117.36364,1690.915584,16.14935065,98549.65584,0.263005445,0.016956562,0.000163283,0.808277831,0.021225891,22,0
D:0| T0: 0.17| T1: 0.00| R0: 0.0| R1: 0.0| WTP: 0,0,0.173076923,0,0,0,0,0,0,-708471605,341384587,12394.06726,88768242.24,8876824.224,0,94685,4043,574,2059,1485,574,94685,1485,2059,267.5183246,2.947643979,10.66492147,33136.2356,1681.659686,13.67015707,98651.95812,0.333360266,0.016889633,0.000138533,0.721223895,0.021745789,28,0
D:0| T0: 0.17| T1: 0.00| R0: 0.0| R1: 0.0| WTP: 0,0,0.173076923,0,0,0,0,0,0,-720150998.1,2032000160,12675.61672,86370162.15,8637016.215,0,92669,3984,813,2106,1293,813,92669,1293,2106,190.2779923,3.046332046,7.980694981,40051.28958,2411.629344,11.12355212,98751.65251,0.40229375,0.024262021,0.000113453,0.613960114,0.022726046,37,0
D:0| T0: 0.17| T1: 0.00| R0: 0.0| R1: 0.0| WTP: 0,0,0.173076923,0,0,0,0,0,0,-723469523.6,779488939,12611.56483,92891282.22,9289128.222,0,97872,4285,531,2095,1564,531,97872,1564,2095,301.252809,2.893258427,11.62359551,36522.35955,2086.617978,14.61235955,98773.74719,0.366490501,0.020947331,0.000148232,0.746539379,0.021405509,26,0
D:0| T0: 0.17| T1: 0.00| R0: 0.0| R1: 0.0| WTP: 0,0,0.173076923,0,0,0,0,0,0,-665745213.1,1449019578,11724.56454,79516986.27,7951698.627,0,87212,3662,858,1948,1090,858,87212,1090,1948,184.6571429,3.387755102,7.787755102,52308.79592,2217.020408,11.28979592,99035.94694,0.524924304,0.022289409,0.000115182,0.559548255,0.022336376,34,0
D:0| T0: 0.17| T1: 0.00| R0: 0.0| R1: 0.0| WTP: 0,0,0.173076923,0,0,0,0,0,0,-486364223.2,351952211,8239.809133,74373766.56,7437376.656,0,72282,3411,933,1368,435,933,72282,435,1368,131.3619632,2.739263804,4.036809816,59426.40491,985.1441718,6.898773006,99278.40798,0.596760408,0.009889453,7.08428E-05,0.317982456,0.018926135,47,0
D:0| T0: 0.17| T1: 0.00| R0: 0.0| R1: 0.0| WTP: 0,0,0.173076923,0,0,0,0,0,0,-590094402.7,486595046,10211.27234,79530785.76,7953078.576,0,83164,3653,1021,1696,675,1021,83164,675,1696,123.486413,2.654891304,4.453804348,55287.0625,1857.730978,7.233695652,99161.05435,0.554750878,0.018680604,7.42545E-05,0.397995283,0.020393439,51,0
D:0| T0: 0.17| T1: 0.00| R0: 0.0| R1: 0.0| WTP: 0,0,0.173076923,0,0,0,0,0,0,-692900779.6,296745624,12069.98499,89401530.16,8940153.016,0,95157,4121,616,2005,1389,616,95157,1389,2005,268.25,3.125,10.29166667,39402.00521,2434.739583,13.49479167,98834.5,0.395559963,0.02445726,0.000137162,0.69276808,0.021070441,28,0
D:0| T0: 0.17| T1: 0.00| R0: 0.0| R1: 0.0| WTP: 0,0,0.173076923,0,0,0,0,0,0,-560509883.3,1671484194,9723.098057,74354980.44,7435498.044,0,79825,3469,871,1615,744,871,79825,744,1615,162.221374,3.20610687,6,53685.58397,1559.664122,9.316793893,99135.79771,0.539247005,0.015659228,9.52876E-05,0.460681115,0.020231757,38,0
D:0| T0: 0.17| T1: 0.00| R0: 0.0| R1: 0.0| WTP: 0,0,0.173076923,0,0,0,0,0,0,-692192526.3,422157396,11969.23942,93730555.49,9373055.549,0,98974,4389,486,1988,1502,486,98974,1502,1988,350.3096774,3.070967742,12.72903226,29539.45806,2383.735484,15.84516129,98717.79355,0.297024665,0.023902093,0.000160155,0.755533199,0.020086083,23,0
D:0| T0: 0.17| T1: 0.00| R0: 0.0| R1: 0.0| WTP: 0,0,0.173076923,0,0,0,0,0,0,-734504893.9,1916599091,12774.64263,95772762.3,9577276.23,0,98759,4258,437,2122,1685,437,98759,1685,2122,330.4761905,2.535714286,12.51190476,25892.47024,2044.928571,15.11904762,98531.31548,0.260703388,0.020519787,0.000153002,0.794062205,0.021486649,24,0
D:0| T0: 0.17| T1: 0.00| R0: 0.0| R1: 0.0| WTP: 0,0,0.173076923,0,0,0,0,0,0,-711787003.5,1005953941,12282.83327,97645340.1,9764534.01,0,98971,4357,499,2040,1541,499,98971,1541,2040,402.177305,3.453900709,14.32624113,32099.46099,2843.460993,17.85106383,98759.79433,0.322593797,0.028494088,0.000180604,0.755392157,0.020612098,21,0
D:0| T0: 0.17| T1: 0.00| R0: 0.0| R1: 0.0| WTP: 0,0,0.173076923,0,0,0,0,0,0,-759892294.2,1422765615,13385.54949,90614819.66,9061481.966,0,97367,4140,582,2224,1642,582,97367,1642,2224,292.1011236,3.196629213,12.35393258,31869.86517,1895.174157,15.63483146,98580.18539,0.320413555,0.019044851,0.000158499,0.738309353,0.022841414,26,0
D:0| T0: 0.17| T1: 0.00| R0: 0.0| R1: 0.0| WTP: 0,0,0.173076923,0,0,0,0,0,0,-522730474.9,699740192,9155.701512,64945399.3,6494539.93,0,67243,2797,1150,1521,371,1150,67243,371,1521,83.59817352,2.5456621,3.356164384,59569.26712,914.413242,5.95890411,99127.44064,0.599090096,0.009194544,6.13031E-05,0.243918475,0.022619455,63,0
D:0| T0: 0.17| T1: 0.00| R0: 0.0| R1: 0.0| WTP: 0,0,0.173076923,0,0,0,0,0,0,-516457654.7,240885764,8934.990087,69708150.3,6970815.03,0,71234,3158,1101,1484,383,1101,71234,383,1484,98.31265509,2.622828784,3.533498759,65352.68983,1078.841191,6.255583127,99326.04218,0.655835253,0.010842533,6.44617E-05,0.258086253,0.020833041,58,0
D:0| T0: 0.17| T1: 0.00| R0: 0.0| R1: 0.0| WTP: 0,0,0.173076923,0,0,0,0,0,0,-650735935.4,2023806564,11134.64632,94003619.34,9400361.934,0,95736,4350,636,1849,1213,636,95736,1213,1849,320.7058824,3.635294118,10.71764706,39468.91176,2360.711765,14.45882353,98960.82353,0.396174979,0.02367349,0.000146655,0.656030287,0.019313529,25,0
D:0| T0: 0.17| T1: 0.00| R0: 0.0| R1: 0.0| WTP: 0,0,0.173076923,0,0,0,0,0,0,-554693915.6,1907493879,9614.913771,73948227.01,7394822.701,0,77655,3402,969,1597,628,969,77655,628,1597,120.8968481,2.670487106,4.429799427,55049.08309,1397.332378,7.191977077,99137.83954,0.552960018,0.014040989,7.38998E-05,0.39323732,0.020565586,49,0
D:0| T0: 0.17| T1: 0.00| R0: 0.0| R1: 0.0| WTP: 0,0,0.173076923,0,0,0,0,0,0,-728980314.2,1565815291,12832.10796,87374916.15,8737491.615,0,93888,3921,816,2132,1316,816,93888,1316,2132,208.7740586,3.322175732,8.769874477,43257.68619,3177.811715,12.17991632,98832.25941,0.434086449,0.031975256,0.000124145,0.617260788,0.022707907,35,0
D:0| T0: 0.17| T1: 0.00| R0: 0.0| R1: 0.0| WTP: 0,0,0.173076923,0,0,0,0,0,0,-481770926.6,784442364,8238.343669,69853743.1,6985374.31,0,71601,3304,1002,1368,366,1002,71601,366,1368,117.1260997,2.80058651,3.832844575,56676.91789,1113.683284,6.7771261,99224.60117,0.569558669,0.011179635,6.97716E-05,0.26754386,0.019105878,48,0
D:0| T0: 0.17| T1: 0.00| R0: 0.0| R1: 0.0| WTP: 0,0,0.173076923,0,0,0,0,0,0,-677865989.8,206369745,11698.7557,92928204.86,9292820.486,0,97548,4340,546,1943,1397,546,97548,1397,1943,305.8011364,3.005681818,10.88068182,36332.34091,2312.909091,14.00568182,98852.25568,0.364655776,0.023207837,0.00014198,0.718991251,0.019918399,26,0
D:0| T0: 0.17| T1: 0.00| R0: 0.0| R1: 0.0| WTP: 0,0,0.173076923,0,0,0,0,0,0,-702699544.4,2087235992,12203.10294,92544397.6,9254439.76,0,98502,4245,555,2027,1472,555,98502,1472,2027,263.4630542,2.665024631,9.852216749,26905.99015,2111.990148,12.591133,98618.62562,0.270595418,0.021210206,0.000127845,0.726196349,0.020578262,29,0
D:0| T0: 0.17| T1: 0.00| R0: 0.0| R1: 0.0| WTP: 0,0,0.173076923,0,0,0,0,0,0,-679627646.1,1019092536,11835.33869,87860711.44,8786071.144,0,91625,4030,774,1966,1192,774,91625,1192,1966,221.254386,3.293859649,8.456140351,45980.84211,2219.368421,11.85526316,98960.38158,0.461405575,0.022301933,0.000120834,0.606307223,0.021457026,33,0
D:0| T0: 0.17| T1: 0.00| R0: 0.0| R1: 0.0| WTP: 0,0,0.173076923,0,0,0,0,0,0,-640061001.9,1885906113,11178.55478,81133262.81,8113326.281,0,85791,3672,700,1857,1157,700,85791,1157,1857,207.8526786,3.035714286,8.142857143,44662.04464,1169.665179,11.26785714,98883.44196,0.449112329,0.011748287,0.000114699,0.623047927,0.021645627,32,0
D:0| T0: 0.17| T1: 0.00| R0: 0.0| R1: 0.0| WTP: 0,0,0.173076923,0,0,0,0,0,0,-613940844.3,2028637200,10644.24922,81728383.1,8172838.31,0,86674,3867,728,1768,1040,728,86674,1040,1768,219.3831776,3.308411215,8.11682243,47257.12617,1568.485981,11.4953271,99012.94393,0.474697737,0.01574383,0.000117111,0.588235294,0.020398274,31,0
D:0| T0: 0.17| T1: 0.00| R0: 0.0| R1: 0.0| WTP: 0,0,0.173076923,0,0,0,0,0,0,-693886204.3,181476086,12040.70268,91851070.52,9185107.052,0,97834,4334,537,2000,1463,537,97834,1463,2000,253.9043062,2.502392344,9.454545455,28927.2201,2191.277512,12.01913876,98654.31579,0.290783791,0.022014165,0.000122014,0.7315,0.020442791,30,0
D:0| T0: 0.17| T1: 0.00| R0: 0.0| R1: 0.0| WTP: 0,0,0.173076923,0,0,0,0,0,0,-715127157.9,2097578470,12408.0068,94726817.74,9472681.774,0,97714,4353,593,2061,1468,593,97714,1468,2061,305.7653631,3.217877095,11.36871508,33450.27933,2954.782123,14.67039106,98735.7486,0.336018805,0.029665432,0.000148953,0.712275594,0.021092167,26,0
D:0| T0: 0.17| T1: 0.00| R0: 0.0| R1: 0.0| WTP: 0,0,0.173076923,0,0,0,0,0,0,-670051437.8,119646392,11743.6752,82867677.91,8286767.791,0,88807,3787,865,1951,1086,865,88807,1086,1951,188.4541833,3.338645418,7.601593625,49562.41833,2242.545817,11.03585657,98988.34263,0.497445819,0.022552633,0.000112835,0.556637622,0.021968989,36,0
D:0| T0: 0.17| T1: 0.00| R0: 0.0| R1: 0.0| WTP: 0,0,0.173076923,0,0,0,0,0,0,-699770831.9,1298895859,12125.32761,93504451.48,9350445.148,0,98000,4326,530,2014,1484,530,98000,1484,2014,276.0459184,2.637755102,10.14285714,26327.2551,2081.505102,12.83673469,98594.40306,0.264983468,0.020903824,0.000130426,0.736842105,0.02055102,28,0
D:0| T0: 0.17| T1: 0.00| R0: 0.0| R1: 0.0| WTP: 0,0,0.173076923,0,0,0,0,0,0,-706915062.4,1489316290,12322.64031,90783046.94,9078304.694,0,95545,4199,575,2047,1472,575,95545,1472,2047,307.8529412,3.288235294,11.89411765,35953.68235,1955.382353,15.26470588,98747.05882,0.361332507,0.019623436,0.000154888,0.719101124,0.02142446,25,0
D:0| T0: 0.17| T1: 0.00| R0: 0.0| R1: 0.0| WTP: 0,0,0.173076923,0,0,0,0,0,0,-806056629.4,855602142,14322.14533,89949362.95,8994936.295,0,98392,4040,481,2380,1899,481,98392,1899,2380,316.006135,2.889570552,14.47239264,32228.48466,2152.165644,17.42944785,98501.90798,0.323849213,0.021624768,0.000176516,0.79789916,0.024188958,24,0
D:0| T0: 0.17| T1: 0.00| R0: 0.0| R1: 0.0| WTP: 0,0,0.173076923,0,0,0,0,0,0,-707800156.9,1438649896,12370.2525,89287532.13,8928753.213,0,94277,4113,717,2055,1338,717,94277,1338,2055,234.0639269,3.164383562,9.223744292,41891.31507,2192.520548,12.49315068,98851.71689,0.420393183,0.022041055,0.000127299,0.651094891,0.021797469,31,0
D:0| T0: 0.17| T1: 0.00| R0: 0.0| R1: 0.0| WTP: 0,0,0.173076923,0,0,0,0,0,0,-632149208.8,952489126,11294.34928,67431744.66,6743174.466,0,78498,3161,1119,1877,758,1119,78498,758,1877,111.5756677,3.207715134,5.403560831,58880.18694,1793.724036,8.71810089,99094.38576,0.591318799,0.018050839,8.9473E-05,0.403835908,0.023911437,49,0
D:0| T0: 0.17| T1: 0.00| R0: 0.0| R1: 0.0| WTP: 0,0,0.173076923,0,0,0,0,0,0,-722846194.6,1550779155,12646.77144,90507622.32,9050762.232,0,99159,4214,404,2101,1697,404,99159,1697,2101,360.462069,2.724137931,14.3862069,24044.51034,1912.337931,17.16551724,98517.24828,0.242499829,0.019170535,0.000173353,0.807710614,0.021188193,21,0
D:0| T0: 0.17| T1: 0.00| R0: 0.0| R1: 0.0| WTP: 0,0,0.173076923,0,0,0,0,0,0,-568617103.4,607323321,9867.553199,75239443.41,7523944.341,0,76909,3462,944,1639,695,944,76909,695,1639,135.0440252,2.877358491,5.009433962,55126.65409,1171.707547,7.981132075,99102.27358,0.553954526,0.011775817,8.16315E-05,0.424039048,0.0213109,46,0
D:0| T0: 0.17| T1: 0.00| R0: 0.0| R1: 0.0| WTP: 0,0,0.173076923,0,0,0,0,0,0,-652232615,2103646485,11336.05475,85429877.65,8542987.765,0,89515,3907,624,1883,1259,624,89515,1259,1883,281.3028571,3.48,10.61714286,44566.79429,1544.08,14.17142857,98929.69714,0.447773762,0.015492109,0.000143774,0.668613914,0.021035581,25,0
D:0| T0: 0.17| T1: 0.00| R0: 0.0| R1: 0.0| WTP: 0,0,0.173076923,0,0,0,0,0,0,-656131786.7,258120157,11236.74668,94294452.8,9429445.28,0,97969,4439,456,1866,1410,456,97969,1410,1866,353.8645161,2.864516129,11.90322581,26413.10968,1607.748387,14.84516129,98709.27097,0.26613062,0.016111575,0.000150226,0.75562701,0.019046841,23,0
D:0| T0: 0.17| T1: 0.00| R0: 0.0| R1: 0.0| WTP: 0,0,0.173076923,0,0,0,0,0,0,-612945527.2,1068951401,10525.75682,86657686.32,8665768.632,0,88470,3941,690,1748,1058,690,88470,1058,1748,240.9086538,3.235576923,8.25,48853.6875,1665.014423,11.56730769,99084.625,0.49025471,0.016704255,0.000117663,0.605263158,0.01975811,30,0
D:0| T0: 0.17| T1: 0.00| R0: 0.0| R1: 0.0| WTP: 0,0,0.173076923,0,0,0,0,0,0,-654738356.2,635956235,11478.77764,80799474.29,8079947.429,0,86621,3775,942,1907,965,942,86621,965,1907,146.4363057,2.891719745,5.917197452,49220.6051,2085.098726,8.914012739,98969.1051,0.494223771,0.020976467,9.13077E-05,0.506030414,0.022015447,44,0
D:0| T0: 0.17| T1: 0.00| R0: 0.0| R1: 0.0| WTP: 0,0,0.173076923,0,0,0,0,0,0,-517436555.4,1346693470,9077.090438,63582033.54,6358203.354,0,68870,2949,1028,1508,480,1028,68870,480,1508,109.3567073,3.015243902,4.426829268,60722.78049,1074.012195,7.576219512,99186.91768,0.610334064,0.010790156,7.76629E-05,0.318302387,0.021896962,47,0
D:0| T0: 0.17| T1: 0.00| R0: 0.0| R1: 0.0| WTP: 0,0,0.173076923,0,0,0,0,0,0,-742105547.1,847102011,13013.42306,91434393.87,9143439.387,0,98910,4258,476,2162,1686,476,98910,1686,2162,317.3373494,2.795180723,12.87951807,27466.98193,2033.012048,15.75301205,98550.53614,0.276372684,0.020410688,0.000159654,0.779833488,0.021858255,24,0
D:0| T0: 0.17| T1: 0.00| R0: 0.0| R1: 0.0| WTP: 0,0,0.173076923,0,0,0,0,0,0,-754061131.3,812083272,13360.10532,86055865.18,8605586.518,0,96071,3928,728,2220,1492,728,96071,1492,2220,229.135514,3.308411215,10.23364486,42864.45794,2744.126168,13.64018692,98821.14486,0.429860934,0.027605427,0.000138644,0.672072072,0.02310791,31,0
D:0| T0: 0.17| T1: 0.00| R0: 0.0| R1: 0.0| WTP: 0,0,0.173076923,0,0,0,0,0,0,-687494285.7,2146825809,11819.99652,96494459.83,9649445.983,0,99020,4488,463,1963,1500,463,99020,1500,1963,368.9078947,2.973684211,12.80263158,26214.07237,2056.710526,15.83552632,98665.71053,0.263997546,0.020610328,0.000160092,0.764136526,0.019824278,22,0
D:0| T0: 0.17| T1: 0.00| R0: 0.0| R1: 0.0| WTP: 0,0,0.173076923,0,0,0,0,0,0,-741973072.1,226186520,12983.85251,92780446.64,9278044.664,0,98220,4259,484,2157,1673,484,98220,1673,2157,374.2517483,3.321678322,14.95104895,33463.67133,2002.482517,18.29370629,98679.05594,0.336294932,0.020086027,0.00018537,0.775614279,0.021960904,21,0
D:0| T0: 0.17| T1: 0.00| R0: 0.0| R1: 0.0| WTP: 0,0,0.173076923,0,0,0,0,0,0,-710251933.1,1110225441,12418.35588,89334139.1,8933413.91,0,96025,4059,791,2063,1272,791,96025,1272,2063,200.015625,3.00390625,7.9375,39949.51563,2899.140625,11.0078125,98835.27344,0.400722437,0.029164218,0.000112204,0.616577799,0.021483989,37,0
D:0| T0: 0.17| T1: 0.00| R0: 0.0| R1: 0.0| WTP: 0,0,0.173076923,0,0,0,0,0,0,-629058461.2,1190767082,10643.1452,96901201.12,9690120.112,0,96338,4465,624,1767,1143,624,96338,1143,1767,279.3910891,3,8.613861386,40175.32178,2547.529703,11.68811881,99008.91089,0.40292535,0.025560103,0.000118818,0.646859083,0.018341672,29,0
D:0| T0: 0.17| T1: 0.00| R0: 0.0| R1: 0.0| WTP: 0,0,0.173076923,0,0,0,0,0,0,-607419490.9,2108234095,10659.97733,74420624.63,7442062.463,0,82745,3434,903,1771,868,903,82745,868,1771,159.6264151,3.298113208,6.516981132,51943.82264,1927.298113,9.901886792,99055.75094,0.521758014,0.019364274,0.000101418,0.490118577,0.021403106,38,0
D:0| T0: 0.17| T1: 0.00| R0: 0.0| R1: 0.0| WTP: 0,0,0.173076923,0,0,0,0,0,0,-748676129.8,465621985,13039.18491,96716884.45,9671688.445,0,99070,4391,478,2166,1688,478,99070,1688,2166,327.2163743,2.725146199,12.56725146,25039.40351,1992.643275,15.33918129,98492.80117,0.252154856,0.020008345,0.000155371,0.779316713,0.021863329,25,0
D:0| T0: 0.17| T1: 0.00| R0: 0.0| R1: 0.0| WTP: 0,0,0.173076923,0,0,0,0,0,0,-611945330.5,1487072553,10490.00928,87444866.26,8744486.626,0,87297,3857,690,1742,1052,690,87297,1052,1742,220.1608696,2.943478261,7.460869565,44719.66522,1362.969565,10.45652174,98976.4913,0.449315957,0.013681798,0.000106197,0.603903559,0.019954867,33,0
D:0| T0: 0.17| T1: 0.00| R0: 0.0| R1: 0.0| WTP: 0,0,0.173076923,0,0,0,0,0,0,-684908687,1213733847,11996.5392,85081727.04,8508172.704,0,91773,3963,683,1993,1310,683,91773,1310,1993,212.9606987,2.912663755,8.576419214,38573.36681,1694.196507,11.54148472,98759.04367,0.387766094,0.01703145,0.000117504,0.657300552,0.021716627,33,0
D:0| T0: 0.17| T1: 0.00| R0: 0.0| R1: 0.0| WTP: 0,0,0.173076923,0,0,0,0,0,0,-704272855,2003658337,12327.7301,87886350.19,8788635.019,0,94996,4011,605,2048,1443,605,94996,1443,2048,251.4228856,2.940298507,10.05970149,38148.27363,1925.736318,13.06467662,98768.41294,0.383087061,0.019351443,0.000132676,0.704589844,0.021558802,29,0
D:0| T0: 0.17| T1: 0.00| R0: 0.0| R1: 0.0| WTP: 0,0,0.173076923,0,0,0,0,0,0,-575973409.1,1170868072,10011.7485,75385984.02,7538598.402,0,77502,3372,947,1663,716,947,77502,716,1663,147.4006849,3.119863014,5.544520548,58039.55479,1549.787671,8.77739726,99172.7774,0.582796489,0.015571048,8.9821E-05,0.430547204,0.021457788,42,0
D:0| T0: 0.17| T1: 0.00| R0: 0.0| R1: 0.0| WTP: 0,0,0.173076923,0,0,0,0,0,0,-693862097.6,569919592,11969.74069,95375063.29,9537506.329,0,99341,4494,428,1988,1560,428,99341,1560,1988,366.7019868,2.754966887,13.05298013,24877.82781,1713.847682,15.90728477,98624.90066,0.25065404,0.017178189,0.000160512,0.784708249,0.020011878,22,0
D:0| T0: 0.17| T1: 0.00| R0: 0.0| R1: 0.0| WTP: 0,0,0.173076923,0,0,0,0,0,0,-627902217.3,1833180623,10737.31576,91036429.51,9103642.951,0,94133,4315,670,1783,1113,670,94133,1113,1783,301.28,3.691428571,9.977142857,43539.01143,2496.302857,13.82285714,99052.89143,0.43679709,0.025028671,0.000140619,0.624228828,0.018941285,25,0
D:0| T0: 0.17| T1: 0.00| R0: 0.0| R1: 0.0| WTP: 0,0,0.173076923,0,0,0,0,0,0,-765927301.5,1123666637,13505.63469,90645567.21,9064556.721,0,97886,4112,490,2244,1754,490,97886,1754,2244,312.011976,2.856287425,13.29341317,28066.91617,1766.377246,16.22754491,98480.33533,0.282554766,0.017741344,0.00016455,0.781639929,0.022924627,24,0
D:0| T0: 0.17| T1: 0.00| R0: 0.0| R1: 0.0| WTP: 0,0,0.173076923,0,0,0,0,0,0,-720328008.6,1682024981,12510.1514,94820438.41,9482043.841,0,98278,4336,651,2078,1427,651,98278,1427,2078,279.1632653,3.224489796,10.42346939,38413.34694,4109.030612,13.75510204,98852.79592,0.385171118,0.041276119,0.000139978,0.686717998,0.021144101,27,0
D:0| T0: 0.17| T1: 0.00| R0: 0.0| R1: 0.0| WTP: 0,0,0.173076923,0,0,0,0,0,0,-703059844.2,1687523543,12280.08469,89055609.93,8905560.993,0,93871,4108,681,2040,1359,681,93871,1359,2040,230.490991,2.986486486,9.045045045,42533.8018,1614.09009,12.0990991,98862.54955,0.426807136,0.0162213,0.000123263,0.666176471,0.021731951,32,0
D:0| T0: 0.17| T1: 0.00| R0: 0.0| R1: 0.0| WTP: 0,0,0.173076923,0,0,0,0,0,0,-713188588.2,178034412,12466.42701,89867237.65,8986723.765,0,97592,4232,492,2071,1579,492,97592,1579,2071,327.8291139,3.050632911,12.98101266,32512.94304,2172.28481,16.08860759,98695.82278,0.32683488,0.021794245,0.000162854,0.762433607,0.021221002,23,0
D:0| T0: 0.17| T1: 0.00| R0: 0.0| R1: 0.0| WTP: 0,0,0.173076923,0,0,0,0,0,0,-683761977,739490003,11824.74659,92524647.73,9252464.773,0,96578,4227,511,1964,1453,511,96578,1453,1964,306.3485714,2.857142857,11.08571429,31140.47429,1540.737143,13.98285714,98709.36571,0.313217735,0.01545674,0.000142,0.739816701,0.020335894,25,0
D:0| T0: 0.17| T1: 0.00| R0: 0.0| R1: 0.0| WTP: 0,0,0.173076923,0,0,0,0,0,0,-749015079,178482706,13198.86421,89071868.7,8907186.87,0,96382,4189,596,2193,1597,596,96382,1597,2193,286.6573034,3.275280899,12.17977528,37647.52809,2320.601124,15.52808989,98715.97191,0.378009324,0.023310085,0.000157501,0.728226174,0.022753211,26,0
D:0| T0: 0.17| T1: 0.00| R0: 0.0| R1: 0.0| WTP: 0,0,0.173076923,0,0,0,0,0,0,-710760489.8,1919366370,12448.00702,88360138.7,8836013.87,0,94151,3965,625,2068,1443,625,94151,1443,2068,229.9366516,2.737556561,9.208144796,38175.97285,1469.113122,12.04524887,98738.38914,0.383438433,0.014770398,0.000122554,0.697775629,0.021964716,32,0
D:0| T0: 0.17| T1: 0.00| R0: 0.0| R1: 0.0| WTP: 0,0,0.173076923,0,0,0,0,0,0,-679080523.9,1819796913,11657.75284,96192881.66,9619288.166,0,98677,4502,470,1936,1466,470,98677,1466,1936,334.742515,2.77245509,11.49101796,29224.13772,2431.802395,14.28742515,98737.13174,0.29381831,0.024383914,0.000144595,0.757231405,0.019619567,24,0
D:0| T0: 0.17| T1: 0.00| R0: 0.0| R1: 0.0| WTP: 0,0,0.173076923,0,0,0,0,0,0,-734316696,1866591913,12904.67693,89082849.31,8908284.931,0,96607,4222,803,2144,1341,803,96607,1341,2144,212.790795,3.276150628,8.824267782,47006.17992,3346.598326,12.20083682,98970.21757,0.470901209,0.033663282,0.000124114,0.625466418,0.022193009,35,0
D:0| T0: 0.17| T1: 0.00| R0: 0.0| R1: 0.0| WTP: 0,0,0.173076923,0,0,0,0,0,0,-720120523,1219425989,12498.16819,95212113.67,9521211.367,0,99338,4486,456,2076,1620,456,99338,1620,2076,374.9931973,3,13.97959184,25658.85034,1751.312925,17.10204082,98582.78231,0.258483568,0.017560016,0.000172841,0.780346821,0.020898347,21,0
D:0| T0: 0.17| T1: 0.00| R0: 0.0| R1: 0.0| WTP: 0,0,0.173076923,0,0,0,0,0,0,-686968214.7,502409586,11884.83974,92726227.94,9272622.794,0,98677,4335,491,1974,1483,491,98677,1483,1974,298.3444444,2.666666667,10.86111111,26474.60556,2210.338889,13.59444444,98647.1,0.266402495,0.022178832,0.000137525,0.751266464,0.020004662,26,0
D:0| T0: 0.17| T1: 0.00| R0: 0.0| R1: 0.0| WTP: 0,0,0.173076923,0,0,0,0,0,0,-689304946.6,1405887957,11950.6165,91774121.47,9177412.147,0,94592,4270,558,1985,1427,558,94592,1427,1985,310.1871345,3.169590643,11.45614035,37958.79532,1676.526316,14.70760234,98813.11111,0.381362407,0.016821619,0.000149307,0.718891688,0.020984861,25,0
D:0| T0: 0.17| T1: 0.00| R0: 0.0| R1: 0.0| WTP: 0,0,0.173076923,0,0,0,0,0,0,-765078765.2,283033753,13611.75713,84490908.8,8449090.88,0,95531,3906,581,2262,1681,581,95531,1681,2262,246.9589744,2.917948718,11.47179487,30313.83077,1303.487179,14.45641026,98463.40513,0.30522663,0.013107362,0.000146688,0.743147657,0.023678178,28,0
D:0| T0: 0.17| T1: 0.00| R0: 0.0| R1: 0.0| WTP: 0,0,0.173076923,0,0,0,0,0,0,-733247659.5,1083157068,12868.87066,89804126.71,8980412.671,0,95768,4068,689,2138,1449,689,95768,1449,2138,239.6046512,3.111627907,9.795348837,35211.51163,2267.75814,13.00465116,98677.2186,0.353759642,0.022801712,0.000132278,0.677736202,0.022324785,31,0
D:0| T0: 0.17| T1: 0.00| R0: 0.0| R1: 0.0| WTP: 0,0,0.173076923,0,0,0,0,0,0,-698012657.6,1988704626,12331.67721,81428797.09,8142879.709,0,88296,3725,704,2049,1345,704,88296,1345,2049,236.9744898,3.505102041,10.30612245,47010.72959,1156.5,13.90306122,98868.89796,0.472313892,0.011620249,0.000141165,0.656417765,0.023206034,28,0
D:0| T0: 0.17| T1: 0.00| R0: 0.0| R1: 0.0| WTP: 0,0,0.173076923,0,0,0,0,0,0,-731222589.9,884761309,12738.09758,94317710.68,9431771.068,0,99110,4395,435,2116,1681,435,99110,1681,2116,381.4965035,2.972027972,14.67132867,24934.76224,1801.06993,17.72027972,98529.76224,0.251386399,0.018059413,0.00017901,0.79442344,0.021350015,21,0
D:0| T0: 0.17| T1: 0.00| R0: 0.0| R1: 0.0| WTP: 0,0,0.173076923,0,0,0,0,0,0,-557964646.8,533485933,9397.226816,88103305.99,8810330.599,0,85167,3967,693,1560,867,693,85167,867,1560,236.2764977,3.105990783,7.046082949,49764.4424,1071.668203,10.23502304,99152.36866,0.499574606,0.010748352,0.000104148,0.555769231,0.018316954,31,0
D:0| T0: 0.17| T1: 0.00| R0: 0.0| R1: 0.0| WTP: 0,0,0.173076923,0,0,0,0,0,0,-640417688.3,632196071,11131.38536,83848420.49,8384842.049,0,86532,3815,686,1849,1163,686,86532,1163,1849,229.7333333,3.185714286,8.657142857,48936.8,1061.109524,11.94285714,98993.08571,0.491455217,0.010653529,0.00012125,0.628988643,0.021367818,30,0
D:0| T0: 0.17| T1: 0.00| R0: 0.0| R1: 0.0| WTP: 0,0,0.173076923,0,0,0,0,0,0,-735208248.6,393400457,12881.19942,91148277.8,9114827.78,0,98040,4252,446,2140,1694,446,98040,1694,2140,332.6835443,2.740506329,13.41139241,32070.27848,1942.183544,16.21518987,98634.4557,0.322348265,0.019490359,0.000164349,0.791588785,0.021827825,23,0
D:0| T0: 0.17| T1: 0.00| R0: 0.0| R1: 0.0| WTP: 0,0,0.173076923,0,0,0,0,0,0,-709333738,398973227,12400.2474,89321368.09,8932136.809,0,94948,4102,583,2060,1477,583,94948,1477,2060,287.2290503,3.195530726,11.36871508,34684.36872,1588.547486,14.62011173,98700.4581,0.348770133,0.015947067,0.000148332,0.716990291,0.021696086,26,0
D:0| T0: 0.17| T1: 0.00| R0: 0.0| R1: 0.0| WTP: 0,0,0.173076923,0,0,0,0,0,0,-678414592.1,1402256491,11781.73601,89327791.37,8932779.137,0,95049,4163,715,1957,1242,715,95049,1242,1957,243.549763,3.308056872,9.142180095,42551.1327,2841.540284,12.53554502,98936.95261,0.426814734,0.028549146,0.000127275,0.634644865,0.02058938,31,0
D:0| T0: 0.17| T1: 0.00| R0: 0.0| R1: 0.0| WTP: 0,0,0.173076923,0,0,0,0,0,0,-754883933.7,2102527413,13200.76623,94845622.04,9484562.204,0,98812,4339,615,2193,1578,615,98812,1578,2193,300.0164835,3.291208791,11.9010989,35379.15934,3145.945055,15.25824176,98725.40659,0.354980177,0.031604194,0.000155124,0.719562244,0.022193661,26,0
D:0| T0: 0.17| T1: 0.00| R0: 0.0| R1: 0.0| WTP: 0,0,0.173076923,0,0,0,0,0,0,-746740958.7,1748031099,13103.62802,91559557.67,9155955.767,0,97698,4135,617,2177,1560,617,97698,1560,2177,295.6067416,3.387640449,12.08988764,34974.7809,2966.58427,15.54494382,98696.4382,0.351222789,0.029808629,0.000157777,0.716582453,0.022282954,26,0
D:0| T0: 0.17| T1: 0.00| R0: 0.0| R1: 0.0| WTP: 0,0,0.173076923,0,0,0,0,0,0,-628394178.4,1946754629,10879.33778,84427289.31,8442728.931,0,89059,3896,689,1807,1118,689,89059,1118,1807,209.6336207,2.887931034,7.659482759,44754.28879,1474.387931,10.62931034,98955.21552,0.449476771,0.014811225,0.000108086,0.618705036,0.02028992,34,0
D:0| T0: 0.17| T1: 0.00| R0: 0.0| R1: 0.0| WTP: 0,0,0.173076923,0,0,0,0,0,0,-639886709,2097712204,11054.36804,87168307.06,8716830.706,0,89579,4018,655,1836,1181,655,89579,1181,1836,245.4878049,3.097560976,8.804878049,45505.12683,1369.736585,12.0097561,98969.26829,0.456930565,0.013750893,0.000122027,0.643246187,0.020495875,30,0
D:0| T0: 0.17| T1: 0.00| R0: 0.0| R1: 0.0| WTP: 0,0,0.173076923,0,0,0,0,0,0,-650643863.4,1198827119,11418.37339,79725194.08,7972519.408,0,85024,3691,903,1897,994,903,85024,994,1897,161.4875445,3.117437722,6.604982206,54131.02847,1948.619217,9.825622776,99062.05694,0.543265787,0.019597162,0.000100233,0.52398524,0.022311347,41,0
D:0| T0: 0.17| T1: 0.00| R0: 0.0| R1: 0.0| WTP: 0,0,0.173076923,0,0,0,0,0,0,-497941232.7,109253198,8669.066769,64487894.19,6448789.419,0,66754,2881,1135,1440,305,1135,66754,305,1440,75.68879668,2.22406639,2.831950207,60924.95643,979.5414938,5.190871369,99199.58091,0.612383969,0.009845935,5.36953E-05,0.211805556,0.021571741,68,0
D:0| T0: 0.17| T1: 0.00| R0: 0.0| R1: 0.0| WTP: 0,0,0.173076923,0,0,0,0,0,0,-603680765.9,314481292,10416.46123,82857704.4,8285770.44,0,82677,3710,756,1730,974,756,82677,974,1730,206.7229437,3.168831169,7.329004329,50337.09091,1065.887446,10.62770563,99036.54113,0.505762386,0.010700437,0.000108087,0.56300578,0.020924804,33,0
D:0| T0: 0.17| T1: 4.00| R0: 0.0| R1: 0.0| WTP: 0,0,0.173076923,4,0,0,0,0,0,-960331752,1178568022,10666.64738,426999383.1,42699938.31,2,82121,3507,955,1772,817,955,82121,817,1772,119.4120879,2.535714286,4.741758242,62954.87088,1161.195055,7.348901099,99262.02198,0.631119545,0.011681849,7.53727E-05,0.461060948,0.021577916,51,4
D:0| T0: 0.17| T1: 4.00| R0: 0.0| R1: 0.0| WTP: 0,0,0.173076923,4,0,0,0,0,0,-1030944939,2029998696,11758.62268,443013805,44301380.5,2,95789,4302,473,1953,1480,473,95789,1480,1953,347.8246753,3.006493506,12.56493506,34898.51948,2101.084416,15.62337662,98805.97403,0.350751607,0.021057218,0.000158024,0.7578085,0.020388562,22,4
D:0| T0: 0.17| T1: 4.00| R0: 0.0| R1: 0.0| WTP: 0,0,0.173076923,4,0,0,0,0,0,-1063410853,776062361,12566.94921,435063393,43506339.3,2,92252,3879,922,2088,1166,922,92252,1166,2088,204.3106383,3.812765957,8.714893617,39403.4,2436.757447,12.63829787,98753.67234,0.396203891,0.024510108,0.00012894,0.558429119,0.022633656,33,4
D:0| T0: 0.17| T1: 4.00| R0: 0.0| R1: 0.0| WTP: 0,0,0.173076923,4,0,0,0,0,0,-959903670.7,1813046880,10654.69426,427168957.8,42716895.78,2,82639,3503,973,1770,797,973,82639,797,1770,128.5309735,2.761061947,5.056047198,60431.05015,1546.218289,7.91740413,99226.63717,0.605992441,0.015548068,8.13904E-05,0.450282486,0.021418459,49,4
D:0| T0: 0.17| T1: 4.00| R0: 0.0| R1: 0.0| WTP: 0,0,0.173076923,4,0,0,0,0,0,-939881023.5,2032407216,10110.55608,434353219.7,43435321.97,2,84082,3769,973,1679,706,973,84082,706,1679,194.8461538,3.809716599,6.603238866,55173.87449,1194.522267,10.55465587,99177.1336,0.553888525,0.01199468,0.000107794,0.420488386,0.019968602,36,4
D:0| T0: 0.17| T1: 4.00| R0: 0.0| R1: 0.0| WTP: 0,0,0.173076923,4,0,0,0,0,0,-911683699.7,1507873352,9900.708188,416648290.3,41664829.03,2,71147,2901,1178,1645,467,1178,71147,467,1645,76.82401656,2.33126294,3.262939959,66800.80538,1061.045549,5.703933747,99283.54037,0.670391174,0.010674687,5.88062E-05,0.283890578,0.023121144,68,4
D:0| T0: 0.17| T1: 4.00| R0: 0.0| R1: 0.0| WTP: 0,0,0.173076923,4,0,0,0,0,0,-884611554.1,1855899401,9271.478839,421037612.2,42103761.22,2,73037,3157,978,1540,562,978,73037,562,1540,115.7319885,2.682997118,4.253602305,66709.79827,788.2449568,7.057636888,99351.95101,0.669137345,0.007920136,7.29137E-05,0.36517219,0.021071512,50,4
D:0| T0: 0.17| T1: 4.00| R0: 0.0| R1: 0.0| WTP: 0,0,0.173076923,4,0,0,0,0,0,-944285588.3,1819459251,10377.8659,425392293.4,42539229.34,2,80262,3471,966,1724,758,966,80262,758,1724,166.0820313,3.63671875,6.56640625,43887.57813,1125.738281,10.3359375,98863.96875,0.442407022,0.011308272,0.000105632,0.439675174,0.021479922,37,4
D:0| T0: 0.17| T1: 4.00| R0: 0.0| R1: 0.0| WTP: 0,0,0.173076923,4,0,0,0,0,0,-907656444.6,909791748,9645.187216,425397083.8,42539708.38,2,75935,3327,842,1602,760,842,75935,760,1602,121.5325779,2.280453258,4.402266289,62934.17847,699.2804533,6.796033994,99268.94051,0.631379818,0.007027941,6.95922E-05,0.474406991,0.021096991,51,4
D:0| T0: 0.17| T1: 4.00| R0: 0.0| R1: 0.0| WTP: 0,0,0.173076923,4,0,0,0,0,0,-991166901.1,1339092841,11326.61252,424836274.9,42483627.49,2,81014,3348,1097,1882,785,1097,81014,785,1882,182.628821,4.689956332,8.030567686,52957.96507,1274.441048,12.81659389,98984.54148,0.532719559,0.012808726,0.000130751,0.417109458,0.023230839,33,4
D:0| T0: 0.17| T1: 4.00| R0: 0.0| R1: 0.0| WTP: 0,0,0.173076923,4,0,0,0,0,0,-1066876664,1365866345,12467.40765,443506281.6,44350628.16,2,97558,4342,474,2071,1597,474,97558,1597,2071,339.9113924,2.917721519,12.9556962,31522.37975,1931.829114,15.96202532,98682.16456,0.316934752,0.019380857,0.000161703,0.77112506,0.021228397,23,4
D:0| T0: 0.17| T1: 4.00| R0: 0.0| R1: 0.0| WTP: 0,0,0.173076923,4,0,0,0,0,0,-999292423.7,825453433,11181.39136,440222855.5,44022285.55,2,90920,4166,974,1857,883,974,90920,883,1857,209.9346939,3.857142857,7.391836735,46730.66122,1884.628571,11.39183673,99012.7551,0.46911775,0.018935275,0.000116114,0.475498115,0.020424549,35,4
D:0| T0: 0.17| T1: 4.00| R0: 0.0| R1: 0.0| WTP: 0,0,0.173076923,4,0,0,0,0,0,-1074230359,939711378,12587.94893,444832912.2,44483291.22,2,97577,4337,447,2091,1644,447,97577,1644,2091,361.2516556,2.874172185,13.70860927,33360.76821,2538.576159,16.65562914,98715.03974,0.335228097,0.025457398,0.000168702,0.786226686,0.02142923,22,4
D:0| T0: 0.17| T1: 4.00| R0: 0.0| R1: 0.0| WTP: 0,0,0.173076923,4,0,0,0,0,0,-997838196.7,638950699,11110.02463,442336965.4,44233696.54,2,91914,4132,950,1845,895,950,91914,895,1845,191.4601449,3.304347826,6.510869565,48153.91667,2095.463768,9.971014493,99046.1558,0.483055525,0.021069389,0.000101809,0.485094851,0.020073112,40,4
D:0| T0: 0.17| T1: 4.00| R0: 0.0| R1: 0.0| WTP: 0,0,0.173076923,4,0,0,0,0,0,-967807406.5,938699148,10627.64001,436425406,43642540.6,2,85381,3916,889,1765,876,889,85381,876,1765,166.2356902,2.868686869,5.771043771,51331.69024,966.2626263,8.774410774,99055.79125,0.515394619,0.009714594,8.9828E-05,0.49631728,0.020672046,43,4
D:0| T0: 0.17| T1: 4.00| R0: 0.0| R1: 0.0| WTP: 0,0,0.173076923,4,0,0,0,0,0,-917268331,121790188,9742.845623,430126049.8,43012604.98,2,80930,3657,992,1618,626,992,80930,626,1618,119.2801047,2.505235602,4.09947644,61886.31414,1534.599476,6.696335079,99306.15707,0.620446392,0.015423131,6.86987E-05,0.386897404,0.019992586,54,4
D:0| T0: 0.17| T1: 4.00| R0: 0.0| R1: 0.0| WTP: 0,0,0.173076923,4,0,0,0,0,0,-1031192529,1331335240,11865.25162,437929947.8,43792994.78,2,93108,4047,939,1971,1032,939,93108,1032,1971,216.9652174,3.982608696,8.386956522,38533.88696,2671.695652,12.47826087,98821.91304,0.387422287,0.026854374,0.000127262,0.523592085,0.021169192,33,4
D:0| T0: 0.17| T1: 4.00| R0: 0.0| R1: 0.0| WTP: 0,0,0.173076923,4,0,0,0,0,0,-1111934969,470935411,13362.35035,443817451.6,44381745.16,2,98777,4173,475,2220,1745,475,98777,1745,2220,312.5,2.697674419,12.81395349,24472.48256,1485.953488,15.54651163,98426.86628,0.246564887,0.014924394,0.000157498,0.786036036,0.022474868,25,4
D:0| T0: 0.17| T1: 4.00| R0: 0.0| R1: 0.0| WTP: 0,0,0.173076923,4,0,0,0,0,0,-1077067355,823434397,12849.04374,434615167.7,43461516.77,2,90310,3815,865,2135,1270,865,90310,1270,2135,172.3862816,3.036101083,7.577617329,49695.57762,1656.754513,10.6967509,98905.68231,0.498678775,0.016675974,0.000109042,0.594847775,0.023640793,40,4
D:0| T0: 0.17| T1: 4.00| R0: 0.0| R1: 0.0| WTP: 0,0,0.173076923,4,0,0,0,0,0,-894744671.1,493045351,9386.906844,425399329,42539932.9,2,78278,3496,807,1559,752,807,78278,752,1559,123.3965517,2.209770115,4.336206897,57853.4569,573.9626437,6.675287356,99206.62644,0.580652783,0.005767987,6.83172E-05,0.482360487,0.019916196,50,4
D:0| T0: 0.17| T1: 4.00| R0: 0.0| R1: 0.0| WTP: 0,0,0.173076923,4,0,0,0,0,0,-965878947.1,1700216563,10550.16281,438370806.8,43837080.68,2,88021,4078,806,1752,946,806,88021,946,1752,194.7423077,2.996153846,6.592307692,57796.83846,1819.657692,9.673076923,99245.42308,0.579173703,0.018277574,9.88597E-05,0.539954338,0.019904341,38,4
D:0| T0: 0.17| T1: 4.00| R0: 0.0| R1: 0.0| WTP: 0,0,0.173076923,4,0,0,0,0,0,-889364465.9,1744119059,9213.964559,428666238,42866623.8,2,77385,3582,1130,1530,400,1130,77385,400,1530,169,4.159090909,5.625,52655.27273,809.0643939,9.890151515,99131.33712,0.529619187,0.008120735,0.00010115,0.261437908,0.019771529,38,4
D:0| T0: 0.17| T1: 4.00| R0: 0.0| R1: 0.0| WTP: 0,0,0.173076923,4,0,0,0,0,0,-965456362.9,2036906360,10691.93285,430859720.5,43085972.05,2,84390,3686,1018,1776,758,1018,84390,758,1776,133.1133721,2.825581395,4.98255814,61110.78779,1713.055233,7.950581395,99261.25581,0.612580441,0.017226412,8.17049E-05,0.426801802,0.021045148,49,4
D:0| T0: 0.17| T1: 4.00| R0: 0.0| R1: 0.0| WTP: 0,0,0.173076923,4,0,0,0,0,0,-971294214,809704121,10664.2067,438083879,43808387.9,2,90184,4000,864,1771,907,864,90184,907,1771,183.24,3.036363636,6.290909091,51615.23273,1695.829091,9.443636364,99117.84,0.517622655,0.017048022,9.62956E-05,0.512140034,0.01963763,39,4
D:0| T0: 0.17| T1: 4.00| R0: 0.0| R1: 0.0| WTP: 0,0,0.173076923,4,0,0,0,0,0,-1001507810,1219866412,11217.59032,440628294.5,44062829.45,2,92399,4066,997,1863,866,997,92399,866,1863,192.1561338,3.602230483,6.762081784,33242.67286,2814.996283,10.47583643,98761.7658,0.334680179,0.028295583,0.000106963,0.464841653,0.020162556,39,4
D:0| T0: 0.17| T1: 4.00| R0: 0.0| R1: 0.0| WTP: 0,0,0.173076923,4,0,0,0,0,0,-929397185.9,843498920,10071.72618,425810876.9,42581087.69,2,76884,3388,927,1673,746,927,76884,746,1673,131.7331288,2.726993865,4.969325153,64524.49693,1134.236196,7.825153374,99287.19632,0.647184638,0.011400181,8.01728E-05,0.445905559,0.021760054,47,4
D:0| T0: 0.17| T1: 4.00| R0: 0.0| R1: 0.0| WTP: 0,0,0.173076923,4,0,0,0,0,0,-1109999122,107351963,13515.52951,434222646,43422264.6,2,92804,3833,946,2246,1300,946,92804,1300,2246,176.358209,3.414179104,8.205223881,50419.3097,2407.171642,11.73880597,98921.01493,0.505647752,0.024242741,0.000119976,0.578806768,0.024201543,39,4
D:0| T0: 0.17| T1: 4.00| R0: 0.0| R1: 0.0| WTP: 0,0,0.173076923,4,0,0,0,0,0,-1028371681,773789021,11746.12062,441065649.7,44106564.97,2,92179,4178,858,1951,1093,858,92179,1093,1951,178.0273973,2.815068493,6.510273973,47224.01712,2137.506849,9.479452055,98974.79452,0.473677711,0.021501156,9.67936E-05,0.560225525,0.021165341,42,4
D:0| T0: 0.17| T1: 4.00| R0: 0.0| R1: 0.0| WTP: 0,0,0.173076923,4,0,0,0,0,0,-1057727030,850936611,12488.32668,433310695.7,43331069.57,2,89696,3731,931,2075,1144,931,89696,1144,2075,192.5122951,3.696721311,8.336065574,52786.95082,1942.368852,12.17213115,99002.69262,0.529642255,0.019541953,0.000123927,0.551325301,0.023133954,35,4
D:0| T0: 0.17| T1: 4.00| R0: 0.0| R1: 0.0| WTP: 0,0,0.173076923,4,0,0,0,0,0,-959786463,1701318364,10631.09764,428231581.2,42823158.12,2,81536,3578,1170,1766,596,1170,81536,596,1766,162.8814815,4.203703704,6.348148148,44747.15926,1281.874074,10.7037037,98878.52593,0.450920295,0.012883264,0.000109348,0.337677054,0.02164688,39,4
D:0| T0: 0.17| T1: 4.00| R0: 0.0| R1: 0.0| WTP: 0,0,0.173076923,4,0,0,0,0,0,-926959511.8,778708269,9964.666759,428726173.8,42872617.38,2,77691,3418,1108,1655,547,1108,77691,547,1655,104.203271,2.48364486,3.731308411,62466,1396.953271,6.320093458,99259.36682,0.626655401,0.014051564,6.49409E-05,0.330513595,0.021302339,62,4
D:0| T0: 0.17| T1: 4.00| R0: 0.0| R1: 0.0| WTP: 0,0,0.173076923,4,0,0,0,0,0,-1019073792,1391938506,11914.6165,423342966.7,42334296.67,2,80771,3278,1050,1980,930,1050,80771,930,1980,154.7992424,3.810606061,7.272727273,57875.64773,1097.988636,11.29545455,99047.41667,0.581459818,0.011045307,0.00011543,0.46969697,0.024514052,38,4
D:0| T0: 0.17| T1: 4.00| R0: 0.0| R1: 0.0| WTP: 0,0,0.173076923,4,0,0,0,0,0,-863990733.6,43418681,8993.06526,414337470.6,41433747.06,2,69255,2952,1061,1494,433,1061,69255,433,1494,81.96127563,2.287015945,3.243735763,64931.96811,891.977221,5.662870159,99285.31207,0.651885095,0.00896768,5.85022E-05,0.289825971,0.02157245,63,4
D:0| T0: 0.17| T1: 4.00| R0: 0.0| R1: 0.0| WTP: 0,0,0.173076923,4,0,0,0,0,0,-1092180613,817384966,13042.80165,440040529.9,44004052.99,2,97824,4117,441,2167,1726,441,97824,1726,2167,235.1506849,1.96803653,9.808219178,20560.84475,1216.534247,11.82648402,98330.76712,0.207477291,0.012227889,0.000119801,0.796492847,0.022152028,32,4
D:0| T0: 0.17| T1: 4.00| R0: 0.0| R1: 0.0| WTP: 0,0,0.173076923,4,0,0,0,0,0,-1057128335,762053968,12263.39926,443958372.1,44395837.21,2,95496,4288,496,2037,1541,496,95496,1541,2037,295.2295082,2.655737705,11.01639344,28947.01093,1632.508197,13.72677596,98602.65027,0.291514493,0.016386589,0.00013905,0.756504664,0.021330736,27,4
D:0| T0: 0.17| T1: 4.00| R0: 0.0| R1: 0.0| WTP: 0,0,0.173076923,4,0,0,0,0,0,-973011704.2,1692506311,10682.47025,438888191.8,43888819.18,2,90754,4105,871,1774,903,871,90754,903,1774,162.9871795,2.695512821,5.541666667,49818.69231,1943.525641,8.326923077,99097.1859,0.499570476,0.019543326,8.52429E-05,0.509019166,0.019547348,44,4
D:0| T0: 0.17| T1: 4.00| R0: 0.0| R1: 0.0| WTP: 0,0,0.173076923,4,0,0,0,0,0,-352501125.5,1037620300,36.06084053,350698083.5,35069808.35,2,198,3,6,6,0,6,198,0,6,0.532110092,0,0,99901.3945,6.623853211,0.064220183,99997.98165,0.999035784,6.80013E-05,1.09094E-06,0,0.030612245,16,4
D:0| T0: 0.17| T1: 4.00| R0: 0.0| R1: 0.0| WTP: 0,0,0.173076923,4,0,0,0,0,0,-966597489.5,301400999,10727.73069,430210955.1,43021095.51,2,82911,3610,915,1782,867,915,82911,867,1782,159.6561404,3.087719298,6.070175439,57550.39649,1213.192982,9.266666667,99161.10175,0.577494355,0.012194967,9.51292E-05,0.486805166,0.021480865,41,4
D:0| T0: 0.17| T1: 4.00| R0: 0.0| R1: 0.0| WTP: 0,0,0.173076923,4,0,0,0,0,0,-1003100543,1868336855,11371.75121,434512982.3,43451298.23,2,87495,3755,997,1889,892,997,87495,892,1889,178.7574627,3.611940299,6.880597015,37182.35448,1270.682836,10.60074627,98731.64179,0.374739575,0.012775076,0.000108368,0.472207517,0.021589805,39,4
D:0| T0: 0.17| T1: 4.00| R0: 0.0| R1: 0.0| WTP: 0,0,0.173076923,4,0,0,0,0,0,-1012038056,1868498144,11575.53366,433261372.8,43326137.28,2,87013,3745,1041,1923,882,1041,87013,882,1923,185.8656126,4,7.403162055,40056.88933,1433.094862,11.52173913,98766.74704,0.403561025,0.014408875,0.00011788,0.458658346,0.022100146,37,4
D:0| T0: 0.17| T1: 4.00| R0: 0.0| R1: 0.0| WTP: 0,0,0.173076923,4,0,0,0,0,0,-942169938.4,2101566889,10259.02051,429218913,42921891.3,2,79531,3539,1002,1704,702,1002,79531,702,1704,128.747851,2.733524355,4.699140401,60483.78223,1285.684814,7.598853868,99215.10888,0.60687434,0.012928658,7.79716E-05,0.411971831,0.021425877,50,4
D:0| T0: 0.17| T1: 4.00| R0: 0.0| R1: 0.0| WTP: 0,0,0.173076923,4,0,0,0,0,0,-1091914548,1665097450,13001.34028,441847533.6,44184753.36,2,98304,4245,438,2160,1722,438,98304,1722,2160,335.0573248,2.732484076,13.63694268,28652.68153,2147.834395,16.41401274,98558.82803,0.288330301,0.021556099,0.000166186,0.797222222,0.021972656,23,4
D:0| T0: 0.17| T1: 4.00| R0: 0.0| R1: 0.0| WTP: 0,0,0.173076923,4,0,0,0,0,0,-1007591324,1716179948,11242.95631,445443508.8,44544350.88,2,98061,4381,478,1867,1389,478,98061,1389,1867,363.0855263,3.078947368,12.13815789,32078.25,2222.914474,15.26973684,98842.56579,0.322373547,0.022270107,0.000154679,0.74397429,0.019039169,22,4
D:0| T0: 0.17| T1: 4.00| R0: 0.0| R1: 0.0| WTP: 0,0,0.173076923,4,0,0,0,0,0,-996604929.8,1560278715,11529.21667,420144096.4,42014409.64,2,75609,3034,965,1916,951,965,75609,951,1916,124.6369427,2.917197452,5.904458599,63856.77389,822.6847134,8.984076433,99142.56369,0.641131743,0.008280024,9.2328E-05,0.496346555,0.025340899,44,4
D:0| T0: 0.17| T1: 4.00| R0: 0.0| R1: 0.0| WTP: 0,0,0.173076923,4,0,0,0,0,0,-1029277163,991019385,11894.1788,434568222.7,43456822.27,2,88759,3795,871,1976,1105,871,88759,1105,1976,180.2631579,3.169172932,7.281954887,34299.24812,1984.296992,10.53383459,98633.19173,0.345842773,0.019954945,0.000107751,0.559210526,0.022262531,38,4
D:0| T0: 0.17| T1: 4.00| R0: 0.0| R1: 0.0| WTP: 0,0,0.173076923,4,0,0,0,0,0,-1065905031,118052103,12496.82518,441063771.9,44106377.19,2,95274,4126,894,2076,1182,894,95274,1182,2076,197.5725191,3.320610687,7.763358779,41054.01908,1836.5,11.17175573,98820.01145,0.411989935,0.018475596,0.000114053,0.569364162,0.021789785,38,4
D:0| T0: 0.17| T1: 4.00| R0: 0.0| R1: 0.0| WTP: 0,0,0.173076923,4,0,0,0,0,0,-1056550024,1209758844,12535.07039,429796504.6,42979650.46,2,88491,3625,536,2083,1547,536,88491,1547,2083,239.2222222,2.777777778,10.9047619,36473.16931,1373.322751,13.72486772,98605.31746,0.367585584,0.013797764,0.000139272,0.742678829,0.023539117,27,4
D:0| T0: 0.17| T1: 4.00| R0: 0.0| R1: 0.0| WTP: 0,0,0.173076923,4,0,0,0,0,0,-967229370.4,70671723,10816.6317,426397785.6,42639778.56,2,79742,3461,1076,1797,721,1076,79742,721,1797,103.4795181,2.493975904,4.195180723,55919.06506,1179.640964,6.785542169,99065.86506,0.561591887,0.011872887,6.96836E-05,0.401224263,0.022535176,60,4
D:0| T0: 0.17| T1: 4.00| R0: 0.0| R1: 0.0| WTP: 0,0,0.173076923,4,0,0,0,0,0,-897166463.1,1722612191,9405.539995,426889463.4,42688946.34,2,75073,3417,1081,1562,481,1081,75073,481,1562,103.8261905,2.461904762,3.566666667,66790.43095,987.0904762,6.135714286,99353.33571,0.669795533,0.009925823,6.32641E-05,0.30793854,0.020806415,59,4
D:0| T0: 0.17| T1: 4.00| R0: 0.0| R1: 0.0| WTP: 0,0,0.173076923,4,0,0,0,0,0,-827809084.7,1968291596,8130.506862,421283741.6,42128374.16,2,71651,3264,926,1350,424,926,71651,424,1350,102.9974619,2.246192893,3.291878173,64017.74619,727.4060914,5.644670051,99368.45431,0.642245883,0.007302993,5.80095E-05,0.314074074,0.018841328,57,4
D:0| T0: 0.17| T1: 4.00| R0: 0.0| R1: 0.0| WTP: 0,0,0.173076923,4,0,0,0,0,0,-1117088193,1877569084,13494.00016,442388184.6,44238818.46,2,98400,4145,476,2242,1766,476,98400,1766,2242,330.1125,2.93125,13.925,28630.30625,1965.225,16.875,98518.35,0.288066978,0.019731894,0.000170691,0.787689563,0.022784553,23,4
D:0| T0: 0.17| T1: 4.00| R0: 0.0| R1: 0.0| WTP: 0,0,0.173076923,4,0,0,0,0,0,-1105877933,1726322189,13336.76401,439039732.3,43903973.23,2,96345,4116,529,2216,1687,529,96345,1687,2216,286.4350282,2.920903955,12.38418079,29578.73446,1848.909605,15.37853107,98516.78531,0.297760143,0.018571995,0.000155912,0.761281588,0.023000675,26,4
D:0| T0: 0.17| T1: 4.00| R0: 0.0| R1: 0.0| WTP: 0,0,0.173076923,4,0,0,0,0,0,-1011914746,307848836,11522.08098,435810697.3,43581069.73,2,90530,3990,511,1914,1403,511,90530,1403,1914,267.1467391,2.679347826,10.25543478,35699.51087,1736.858696,13.02717391,98747.96196,0.359383335,0.017427855,0.000132325,0.733019854,0.021142163,27,4
D:0| T0: 0.17| T1: 4.00| R0: 0.0| R1: 0.0| WTP: 0,0,0.173076923,4,0,0,0,0,0,-1047125724,1154000220,12035.59302,445346073.1,44534607.31,2,98939,4480,439,1999,1560,439,98939,1560,1999,356.8766234,2.753246753,12.83766234,25431.02597,1673.532468,15.72077922,98620.52597,0.256197708,0.016774105,0.000158844,0.780390195,0.020204368,22,4
D:0| T0: 0.17| T1: 4.00| R0: 0.0| R1: 0.0| WTP: 0,0,0.173076923,4,0,0,0,0,0,-908722695.9,2028661055,9669.197087,425262841.5,42526284.15,2,75724,3352,965,1606,641,965,75724,641,1606,123.3641618,2.641618497,4.462427746,63405.6763,1150.413295,7.251445087,99274.2341,0.636192451,0.011564152,7.46851E-05,0.399128269,0.02120888,50,4
D:0| T0: 0.17| T1: 4.00| R0: 0.0| R1: 0.0| WTP: 0,0,0.173076923,4,0,0,0,0,0,-1028148581,1629114640,11752.03554,440546803.9,44054680.39,2,94071,4118,1008,1952,944,1008,94071,944,1952,189.9630996,3.612546125,7.051660517,43169.27306,2150.778598,10.77490775,98924.66052,0.433249471,0.021630994,0.00010985,0.483606557,0.020750284,39,4
D:0| T0: 0.17| T1: 4.00| R0: 0.0| R1: 0.0| WTP: 0,0,0.173076923,4,0,0,0,0,0,-1088880738,1439048174,12976.77402,440042037.6,44004203.76,2,97248,4091,505,2156,1651,505,97248,1651,2156,309.9457831,2.963855422,12.87349398,30671.75904,2494.650602,15.92168675,98602,0.308509041,0.025049101,0.000161047,0.765769944,0.022170122,24,4
D:0| T0: 0.17| T1: 4.00| R0: 0.0| R1: 0.0| WTP: 0,0,0.173076923,4,0,0,0,0,0,-1116140419,865227006,13487.76317,441752260.3,44175226.03,2,99171,4141,440,2241,1801,440,99171,1801,2241,253.4975845,2.062801932,10.73429952,18111.4058,1287.507246,12.87439614,98252.28502,0.182903911,0.012941058,0.000130328,0.803659081,0.022597332,30,4
D:0| T0: 0.17| T1: 4.00| R0: 0.0| R1: 0.0| WTP: 0,0,0.173076923,4,0,0,0,0,0,-1048938508,890479738,12101.43291,443866862.6,44386686.26,2,94663,4156,964,2010,1046,964,94663,1046,2010,221.1859504,3.892561983,8.148760331,39308.9876,2801.61157,12.11983471,98829.65702,0.39489886,0.02817432,0.000123619,0.52039801,0.021233217,35,4
D:0| T0: 0.17| T1: 4.00| R0: 0.0| R1: 0.0| WTP: 0,0,0.173076923,4,0,0,0,0,0,-945873105.5,1017049163,10348.761,428435055.7,42843505.57,2,82087,3643,837,1719,882,837,82087,882,1719,148.49,2.666666667,5.563333333,55972.24333,970.72,8.356666667,99139.21667,0.561805629,0.009754901,8.56304E-05,0.513089005,0.020941197,43,4
D:0| T0: 0.17| T1: 4.00| R0: 0.0| R1: 0.0| WTP: 0,0,0.173076923,4,0,0,0,0,0,-883802306.3,1707305064,9182.574188,424673596.9,42467359.69,2,76172,3393,991,1525,534,991,76172,534,1525,109.7487047,2.453367876,3.803108808,63766.7513,1034.336788,6.380829016,99324.03368,0.6395819,0.010395824,6.55093E-05,0.350163934,0.02002048,56,4
D:0| T0: 0.17| T1: 4.00| R0: 0.0| R1: 0.0| WTP: 0,0,0.173076923,4,0,0,0,0,0,-1116710780,400145663,13458.37785,443791886.9,44379188.69,2,99063,4296,416,2236,1820,416,99063,1820,2236,305.3125,2.301136364,12.61363636,21244.23864,1511.471591,14.97727273,98336.77273,0.214354435,0.015179205,0.000151496,0.813953488,0.022571495,26,4
D:0| T0: 0.17| T1: 4.00| R0: 0.0| R1: 0.0| WTP: 0,0,0.173076923,4,0,0,0,0,0,-980347128.6,1662654181,10997.98254,430448001.7,43044800.17,2,85599,3704,783,1827,1044,783,85599,1044,1827,157.5827586,2.593103448,6.148275862,58364.88966,1216.031034,8.834482759,99184.42414,0.585126131,0.012224901,9.05032E-05,0.571428571,0.021343707,42,4
D:0| T0: 0.17| T1: 4.00| R0: 0.0| R1: 0.0| WTP: 0,0,0.173076923,4,0,0,0,0,0,-1064734480,182136456,12413.54214,444057373.1,44405737.31,2,98242,4374,473,2062,1589,473,98242,1589,2062,319.7810651,2.75147929,12.10059172,27025.21302,2014.384615,14.88757396,98594.7929,0.272041564,0.020212649,0.000150635,0.770611057,0.020988986,25,4
D:0| T0: 0.17| T1: 4.00| R0: 0.0| R1: 0.0| WTP: 0,0,0.173076923,4,0,0,0,0,0,-862059899.6,979575387,8862.434497,418938174.8,41893817.48,2,72952,3195,1055,1472,417,1055,72952,417,1472,84.22342733,2.173535792,3.04989154,62137.2603,1067.321041,5.336225597,99281.38395,0.623674554,0.010728712,5.51008E-05,0.283288043,0.020177651,66,4
D:0| T0: 0.17| T1: 4.00| R0: 0.0| R1: 0.0| WTP: 0,0,0.173076923,4,0,0,0,0,0,-1027978452,2142525414,11935.07559,431224672.8,43122467.28,2,87352,3675,742,1983,1241,742,87352,1241,1983,197.4892704,3.08583691,8.364806867,36514.45064,1467.519313,11.53218884,98659.44635,0.368067866,0.014750291,0.000117659,0.625819465,0.022701255,34,4
D:0| T0: 0.17| T1: 4.00| R0: 0.0| R1: 0.0| WTP: 0,0,0.173076923,4,0,0,0,0,0,-1028273263,1464057597,11817.04522,437421002,43742100.2,2,92627,3969,920,1963,1043,920,92627,1043,1963,206.8708333,3.716666667,8.008333333,46087.8875,1447.708333,11.86666667,98955.27083,0.46251264,0.014554539,0.000120758,0.531329598,0.021192525,35,4
D:0| T0: 0.17| T1: 4.00| R0: 0.0| R1: 0.0| WTP: 0,0,0.173076923,4,0,0,0,0,0,-1015850118,364562610,11659.28843,432885696.2,43288569.62,2,88368,3788,543,1937,1394,543,88368,1394,1937,247.6387435,2.77486911,10.03664921,36539.28272,1564.376963,12.87434555,98714.2199,0.368094891,0.015699992,0.000130415,0.719669592,0.021919699,28,4
D:0| T0: 0.17| T1: 4.00| R0: 0.0| R1: 0.0| WTP: 0,0,0.173076923,4,0,0,0,0,0,-998085728,40350784,11346.41039,430765208.7,43076520.87,2,84194,3609,755,1885,1130,755,84194,1130,1885,195.2425532,3.093617021,7.85106383,39446.3617,1381.344681,11.06382979,98731.22979,0.397670777,0.013878342,0.000112971,0.599469496,0.022388769,34,4
D:0| T0: 0.17| T1: 4.00| R0: 0.0| R1: 0.0| WTP: 0,0,0.173076923,4,0,0,0,0,0,-934429561.7,804064356,9907.66682,439046220.8,43904622.08,2,89416,4116,441,1645,1204,441,89416,1204,1645,307.1607143,2.529761905,9.660714286,38519.54762,1541.511905,12.28571429,98961.81548,0.387428432,0.015438829,0.00012443,0.731914894,0.018397155,24,4
D:0| T0: 0.17| T1: 4.00| R0: 0.0| R1: 0.0| WTP: 0,0,0.173076923,4,0,0,0,0,0,-958993820.5,2125493986,10719.48436,423019602.7,42301960.27,2,76666,3266,1154,1781,627,1154,76666,627,1781,131.2733119,3.553054662,5.52733119,47203.12862,775.7138264,9.254019293,98830.06109,0.476164434,0.007801157,9.49505E-05,0.35204941,0.023230637,45,4
D:0| T0: 0.17| T1: 4.00| R0: 0.0| R1: 0.0| WTP: 0,0,0.173076923,4,0,0,0,0,0,-846743127.3,23154253,8408.295375,426328358.6,42632835.86,2,76298,3437,670,1396,726,670,76298,726,1396,159.2355072,2.27173913,4.876811594,41714.22464,737.1557971,7.347826087,98987.65942,0.420564515,0.007393588,7.51243E-05,0.520057307,0.018296679,40,4
D:0| T0: 0.17| T1: 4.00| R0: 0.0| R1: 0.0| WTP: 0,0,0.173076923,4,0,0,0,0,0,-903602816.5,1391367689,9602.542543,423475689.4,42347568.94,2,74793,3286,916,1595,679,916,74793,679,1595,130.5141066,2.739811912,4.830721003,60590.28527,788.4482759,7.705329154,99210.80878,0.60837628,0.007922238,7.90866E-05,0.425705329,0.021325525,46,4
D:0| T0: 0.17| T1: 4.00| R0: 0.0| R1: 0.0| WTP: 0,0,0.173076923,4,0,0,0,0,0,-984752956.2,574142276,10999.46541,434779685.5,43477968.55,2,89018,3803,916,1827,911,916,89018,911,1827,192.948,3.556,7.132,51263.644,1637.164,10.796,99078.616,0.514403287,0.016451898,0.000110242,0.498631637,0.020524631,36,4
D:0| T0: 0.17| T1: 4.00| R0: 0.0| R1: 0.0| WTP: 0,0,0.173076923,4,0,0,0,0,0,-910465085.9,898736779,9740.73115,423428528.4,42342852.84,2,73541,3333,1139,1618,479,1139,73541,479,1618,97.61938534,2.586288416,3.690307329,68311.96454,1283.449173,6.36643026,99358.18203,0.685084999,0.012906724,6.55468E-05,0.296044499,0.022001632,61,4
D:0| T0: 0.17| T1: 4.00| R0: 0.0| R1: 0.0| WTP: 0,0,0.173076923,4,0,0,0,0,0,-961559193.1,346473503,10247.45593,449186396.7,44918639.67,2,94931,4540,922,1701,779,922,94931,779,1701,237.4356846,3.738589212,6.900414938,41996.39419,2241.896266,10.74688797,99054.22407,0.421427734,0.022508656,0.000109285,0.457965902,0.017918277,35,4
D:0| T0: 0.17| T1: 4.00| R0: 0.0| R1: 0.0| WTP: 0,0,0.173076923,4,0,0,0,0,0,-1026914707,445552282,11739.84228,439922593.1,43992259.31,2,91621,4104,1054,1950,896,1054,91621,896,1950,174.1604096,3.515358362,6.52559727,41874.67577,1785.017065,10.12627986,98839.51536,0.420800553,0.017962165,0.000103147,0.459487179,0.02128333,41,4
D:0| T0: 0.17| T1: 4.00| R0: 0.0| R1: 0.0| WTP: 0,0,0.173076923,4,0,0,0,0,0,-1044811650,911758476,11946.23269,447500015,44750001.5,2,99146,4479,437,1984,1547,437,99146,1547,1984,396.7676056,2.985915493,13.83098592,27636.58451,1954.535211,16.9084507,98686.9507,0.278200211,0.019581078,0.000170959,0.779737903,0.020010893,21,4
D:0| T0: 0.17| T1: 4.00| R0: 0.0| R1: 0.0| WTP: 0,0,0.173076923,4,0,0,0,0,0,-1003222429,1464197940,11123.41132,447051862.8,44705186.28,2,94389,4388,554,1847,1293,554,94389,1293,1847,282.1758794,2.693467337,9.155778894,30630.21106,2767.909548,11.90954774,98753.27136,0.308263368,0.027778474,0.000121154,0.700054142,0.019567958,29,4
D:0| T0: 0.17| T1: 4.00| R0: 0.0| R1: 0.0| WTP: 0,0,0.173076923,4,0,0,0,0,0,-1008770025,500405854,11556.74434,430932808.5,43093280.85,2,85459,3639,1003,1920,917,1003,85459,917,1920,169.6951673,3.591078067,6.962825279,52374.92193,1292.516729,10.68773234,99006.4052,0.526084053,0.01299911,0.000109257,0.477604167,0.022466914,39,4
D:0| T0: 0.17| T1: 4.00| R0: 0.0| R1: 0.0| WTP: 0,0,0.173076923,4,0,0,0,0,0,-1039287091,772037341,12092.21792,434676195.1,43467619.51,2,92787,3894,461,2009,1548,461,92787,1548,2009,302.40625,2.81875,12.4375,36190.20625,1900.575,15.3125,98733.875,0.364077541,0.019060533,0.000154921,0.770532603,0.02165174,23,4
D:0| T0: 0.17| T1: 4.00| R0: 0.0| R1: 0.0| WTP: 0,0,0.173076923,4,0,0,0,0,0,-863781333,1543158763,8922.09098,417676784,41767678.4,2,69299,2989,1003,1482,479,1003,69299,479,1482,100.9206349,2.526455026,3.753968254,69589.97619,890.6216931,6.420634921,99390.47619,0.698037327,0.008949933,6.60479E-05,0.323211876,0.02138559,54,4
D:0| T0: 0.17| T1: 4.00| R0: 0.0| R1: 0.0| WTP: 0,0,0.173076923,4,0,0,0,0,0,-1132006978,1604932531,13788.30203,442591876.6,44259187.66,2,98722,4189,443,2291,1848,443,98722,1848,2291,357.5405405,2.898648649,15.34459459,28623.48649,1968.560811,18.34459459,98486.59459,0.288063378,0.019754995,0.00018556,0.806634657,0.02320658,22,4
D:0| T0: 0.17| T1: 4.00| R0: 0.0| R1: 0.0| WTP: 0,0,0.173076923,4,0,0,0,0,0,-1040764148,539051477,11992.42042,441143127.1,44114312.71,2,91228,4023,903,1992,1089,903,91228,1089,1992,203.0195313,3.40625,7.59765625,33963.40625,2046.148438,11.1484375,98663.88281,0.342127132,0.020579011,0.000113836,0.546686747,0.021835401,37,4
D:0| T0: 0.17| T1: 4.00| R0: 0.0| R1: 0.0| WTP: 0,0,0.173076923,4,0,0,0,0,0,-890814435,1743124675,9338.405918,423894139.1,42389413.91,2,75300,3374,879,1551,672,879,75300,672,1551,124.9613095,2.464285714,4.4375,64351.34226,756.3392857,7.071428571,99310.89286,0.645514945,0.007599075,7.26589E-05,0.433268859,0.02059761,48,4
D:0| T0: 0.17| T1: 4.00| R0: 0.0| R1: 0.0| WTP: 0,0,0.173076923,4,0,0,0,0,0,-1003707963,1965983789,11419.16883,432749521.2,43274952.12,2,89365,3740,906,1897,991,906,89365,991,1897,162.283737,3.020761246,6.408304498,51563.0692,1796.733564,9.553633218,99061.3564,0.517187477,0.018068432,9.75658E-05,0.522403795,0.02122755,42,4
D:0| T0: 0.17| T1: 4.00| R0: 0.0| R1: 0.0| WTP: 0,0,0.173076923,4,0,0,0,0,0,-982462755.8,516774280,11022.35408,431345052,43134505.2,2,86732,3781,955,1831,876,955,86732,876,1831,146.6178344,2.923566879,5.671974522,53526.8949,1797.216561,8.719745223,99098.3758,0.537060434,0.01807479,8.92424E-05,0.478427089,0.021111252,44,4
D:0| T0: 0.17| T1: 4.00| R0: 0.0| R1: 0.0| WTP: 0,0,0.173076923,4,0,0,0,0,0,-1069612041,86603142,12497.83911,444720085.8,44472008.58,2,98877,4264,422,2076,1654,422,98877,1654,2076,296.4565217,2.239130435,11.19565217,20627.42391,1394.456522,13.48913043,98429.9837,0.20817992,0.013998365,0.000136404,0.79672447,0.020995783,27,4
D:0| T0: 0.17| T1: 4.00| R0: 0.0| R1: 0.0| WTP: 0,0,0.173076923,4,0,0,0,0,0,-962543814.6,1431870609,10614.17072,431835278.8,43183527.88,2,82594,3723,985,1763,778,985,82594,778,1763,118.178117,2.396946565,4.338422392,56612.67684,1447.371501,6.852417303,99139.54707,0.568024289,0.014560281,7.03622E-05,0.44129325,0.021345376,57,4
D:0| T0: 0.17| T1: 4.00| R0: 0.0| R1: 0.0| WTP: 0,0,0.173076923,4,0,0,0,0,0,-974538263.3,1592383984,10801.21767,434477380.1,43447738.01,2,86882,3845,998,1794,796,998,86882,796,1794,185.2007722,3.764478764,6.776061776,45658.67181,983.6911197,10.64092664,98949.91506,0.459059813,0.009885822,0.00010833,0.443701226,0.020648696,37,4
D:0| T0: 0.17| T1: 4.00| R0: 0.0| R1: 0.0| WTP: 0,0,0.173076923,4,0,0,0,0,0,-971580192.4,1440183867,10723.40036,435410174.6,43541017.46,2,88253,3926,904,1781,877,904,88253,877,1781,185.7442748,3.339694656,6.645038168,50880.48092,1626.79771,10.07251908,99089.16412,0.510609659,0.016347299,0.00010297,0.492419989,0.020180617,38,4
D:0| T0: 0.17| T1: 4.00| R0: 0.0| R1: 0.0| WTP: 0,0,0.173076923,4,0,0,0,0,0,-1034140198,1696510588,11984.30536,434924929.7,43492492.97,2,91251,3897,747,1991,1244,747,91251,1244,1991,203.6455696,3.042194093,8.227848101,57845.02954,1822.434599,11.37974684,99173.91139,0.579435333,0.018323162,0.00011617,0.624811652,0.021819178,34,4
D:0| T0: 0.17| T1: 4.00| R0: 0.0| R1: 0.0| WTP: 0,0,0.173076923,4,0,0,0,0,0,-1007820752,895039877,11444.03202,435619151.4,43561915.14,2,88227,3822,650,1901,1251,650,88227,1251,1901,197.4475806,2.524193548,7.516129032,32395.78226,1865.229839,10.13709677,98641.75403,0.326745196,0.01874102,0.000103444,0.658074698,0.021546692,36,4
D:0| T0: 0.17| T1: 4.00| R0: 0.0| R1: 0.0| WTP: 0,0,0.173076923,4,0,0,0,0,0,-1060351803,129565953,12506.92911,435005347,43500534.7,2,90398,3846,1052,2078,1026,1052,90398,1026,2078,156.9409836,3.327868852,6.659016393,47714.55738,2093.796721,10.10819672,98893.06885,0.479038981,0.021084571,0.000103326,0.493743985,0.022987234,43,4
D:0| T0: 0.17| T1: 4.00| R0: 0.0| R1: 0.0| WTP: 0,0,0.173076923,4,0,0,0,0,0,-976046317.5,1902565669,10807.50973,435670831.2,43567083.12,2,87414,3941,781,1795,1014,781,87414,1014,1795,191.203125,2.9453125,6.86328125,57549.61719,1306.78125,9.90234375,99200.27344,0.576877296,0.013131582,0.000101119,0.564902507,0.020534468,37,4
D:0| T0: 0.17| T1: 4.00| R0: 0.0| R1: 0.0| WTP: 0,0,0.173076923,4,0,0,0,0,0,-1014276911,1984179288,11664.86614,431033604.1,43103360.41,2,84868,3681,1031,1938,907,1031,84868,907,1938,142.696875,3.075,5.865625,58918.12813,1997.55,9.0875,99150.50313,0.59092281,0.020104684,9.33892E-05,0.468008256,0.022835462,46,4
D:0| T0: 0.17| T1: 4.00| R0: 0.0| R1: 0.0| WTP: 0,0,0.173076923,4,0,0,0,0,0,-1065631157,677377223,12484.97982,441382165.7,44138216.57,2,94585,4116,1030,2074,1044,1030,94585,1044,2074,209.7530364,4.068825911,8.230769231,46867.31579,3090.348178,12.4048583,98956.21457,0.470098765,0.031095762,0.000126427,0.503375121,0.021927599,35,4
D:0| T0: 0.17| T1: 4.00| R0: 0.0| R1: 0.0| WTP: 0,0,0.173076923,4,0,0,0,0,0,-1036875947,973583301,11790.21034,447365430.3,44736543.03,2,95562,4477,863,1958,1095,863,95562,1095,1958,205.2169118,3.073529412,7.047794118,44931.79044,2854.036765,10.22058824,98976.12132,0.450437643,0.028703687,0.00010433,0.559244127,0.020489316,39,4
D:0| T0: 0.17| T1: 4.00| R0: 0.0| R1: 0.0| WTP: 0,0,0.173076923,4,0,0,0,0,0,-948643886.6,781062938,10089.70292,444158740.6,44415874.06,2,89657,4241,959,1675,716,959,89657,716,1675,218.4556452,3.721774194,6.556451613,51775.12903,1663.818548,10.42741935,99186.38306,0.519333093,0.016705085,0.000106638,0.427462687,0.018682311,36,4
D:0| T0: 0.17| T1: 4.00| R0: 0.0| R1: 0.0| WTP: 0,0,0.173076923,4,0,0,0,0,0,-1033253627,338783425,11877.67441,439369906.3,43936990.63,2,95162,4208,869,1973,1104,869,95162,1104,1973,172.952381,2.846938776,6.551020408,46894.37075,2647.544218,9.510204082,99007.21769,0.469950187,0.026636849,9.72906E-05,0.559553979,0.020733066,42,4
D:0| T0: 0.17| T1: 4.00| R0: 0.0| R1: 0.0| WTP: 0,0,0.173076923,4,0,0,0,0,0,-965688746,1027579040,10656.53401,432862045.6,43286204.56,2,84376,3857,1006,1770,764,1006,84376,764,1770,134.2971429,2.751428571,4.9,59585.63714,1820.128571,7.762857143,99226.85143,0.597423488,0.018305104,7.97863E-05,0.431638418,0.020977529,49,4
D:0| T0: 0.17| T1: 4.00| R0: 0.0| R1: 0.0| WTP: 0,0,0.173076923,4,0,0,0,0,0,-1032838240,764973813,11818.52472,441912003.8,44191200.38,2,93125,4106,954,1963,1009,954,93125,1009,1963,187.1785714,3.285714286,6.842857143,46644.46071,2271.367857,10.25714286,98969.78214,0.467904093,0.02284893,0.000104797,0.51400917,0.021079195,39,4
D:0| T0: 0.17| T1: 4.00| R0: 0.0| R1: 0.0| WTP: 0,0,0.173076923,4,0,0,0,0,0,-1048271298,1245753446,12112.99991,442621302.7,44262130.27,2,95873,4303,956,2012,1056,956,95873,1056,2012,218.5767635,3.89626556,8.215767635,42554.50622,2711.46473,12.15767635,98897.95021,0.427083388,0.027274307,0.000123847,0.524850895,0.020986096,35,4
D:0| T0: 0.17| T1: 4.00| R0: 0.0| R1: 0.0| WTP: 0,0,0.173076923,4,0,0,0,0,0,-1013009803,1013177794,11629.02462,431558572.1,43155857.21,2,86723,3706,1043,1932,889,1043,86723,889,1932,184.5100402,4.068273092,7.578313253,50252.31727,1457.883534,11.77108434,98973.81124,0.504934751,0.014658019,0.000120118,0.460144928,0.022277827,36,4
D:0| T0: 0.17| T1: 4.00| R0: 0.0| R1: 0.0| WTP: 0,0,0.173076923,4,0,0,0,0,0,-913946294.2,1395089249,9883.641732,419764207.6,41976420.76,2,72425,3152,1063,1642,579,1063,72425,579,1642,101.3005181,2.642487047,4.101036269,64153.07513,987.2875648,6.847150259,99246.24093,0.644002281,0.009927137,7.04697E-05,0.352618758,0.022671729,56,4
D:0| T0: 0.17| T1: 4.00| R0: 0.0| R1: 0.0| WTP: 0,0,0.173076923,4,0,0,0,0,0,-351202647.5,1339545835,12.01008238,350602143.4,35060214.34,2,66,0,2,2,0,2,66,0,2,0,0,0,99962.30526,4.557894737,0.021052632,99998.72632,0.999637806,4.76049E-05,4.16669E-07,0,0.03030303,14,4
D:0| T0: 0.17| T1: 4.00| R0: 0.0| R1: 0.0| WTP: 0,0,0.173076923,4,0,0,0,0,0,-1014978262,219139554,11410.78885,444438819.8,44443881.98,2,95417,4272,467,1895,1428,467,95417,1428,1895,354.3506494,2.961038961,12.16883117,31975.66234,1627.155844,15.2012987,98757.69481,0.321838832,0.01630775,0.000153801,0.753562005,0.019860193,22,4
D:0| T0: 0.17| T1: 4.00| R0: 0.0| R1: 0.0| WTP: 0,0,0.173076923,4,0,0,0,0,0,-925793668.6,1336508942,9934.626963,429062320.4,42906232.04,2,81626,3520,833,1650,817,833,81626,817,1650,170.7727273,3.03030303,6.071969697,61946.84091,1248.909091,9.231060606,99293.26515,0.621118652,0.012544272,9.44613E-05,0.495151515,0.020214395,38,4
D:0| T0: 0.17| T1: 4.00| R0: 0.0| R1: 0.0| WTP: 0,0,0.173076923,4,0,0,0,0,0,-883624650.6,448559423,9424.905346,412379383.3,41237938.33,2,66572,2781,1261,1566,305,1261,66572,305,1566,62.37793852,2.151898734,2.68716094,69419.3906,924.1103074,4.95840868,99321.91863,0.696788019,0.009296504,5.1429E-05,0.194763729,0.023523403,79,4
D:0| T0: 0.17| T1: 4.00| R0: 0.0| R1: 0.0| WTP: 0,0,0.173076923,4,0,0,0,0,0,-988691772.8,2110028840,11042.06146,436588699.6,43658869.96,2,91361,3968,888,1834,946,888,91361,946,1834,191.248062,3.333333333,6.941860465,52615.74806,1729.992248,10.36821705,99142.24031,0.527466304,0.017385123,0.000106039,0.515812432,0.020074431,37,4
D:0| T0: 0.17| T1: 4.00| R0: 0.0| R1: 0.0| WTP: 0,0,0.173076923,4,0,0,0,0,0,-1073882111,1982030155,12765.30016,435617102.5,43561710.25,2,92243,3878,899,2121,1222,899,92243,1222,2121,167.8784722,3.024305556,7.222222222,48325.58333,2132.371528,10.32638889,98908.11458,0.484758469,0.021470524,0.000105595,0.576143329,0.022993615,42,4
D:0| T0: 0.17| T1: 4.00| R0: 0.0| R1: 0.0| WTP: 0,0,0.173076923,4,0,0,0,0,0,-1040359447,696219407,12110.46301,434836296.4,43483629.64,2,88555,3816,882,2012,1130,882,88555,1130,2012,175.3467153,3.124087591,7.204379562,46054.67153,1075.715328,10.41970803,98844.66423,0.462744357,0.010821929,0.00010625,0.561630219,0.022720343,40,4
D:0| T0: 0.17| T1: 4.00| R0: 0.0| R1: 0.0| WTP: 0,0,0.173076923,4,0,0,0,0,0,-955604944.9,1402539442,10404.98432,435355728.7,43535572.87,2,86942,3883,599,1728,1129,599,86942,1129,1728,249.1116751,2.913705584,8.604060914,39164.86294,2019.588832,11.63451777,98890.54822,0.394223398,0.020256286,0.000118566,0.653356481,0.019875319,29,4
D:0| T0: 0.17| T1: 4.00| R0: 0.0| R1: 0.0| WTP: 0,0,0.173076923,4,0,0,0,0,0,-998298356.6,1319833493,11228.26602,436885055.7,43688505.57,2,89290,3995,759,1865,1106,759,89290,1106,1865,179.1877256,2.620938628,6.584837545,31055.29242,2178.555957,9.310469314,98648.40794,0.313210312,0.021900883,9.53071E-05,0.593029491,0.020886997,40,4
D:0| T0: 0.17| T1: 4.00| R0: 0.0| R1: 0.0| WTP: 0,0,0.173076923,4,0,0,0,0,0,-991519418.3,663608076,11113.87771,435825532.9,43582553.29,2,88529,3932,898,1846,948,898,88529,948,1846,156.0926518,2.75399361,5.750798722,49049.17252,1712.220447,8.600638978,99012.1246,0.492275586,0.017220414,8.8184E-05,0.513542795,0.020851924,45,4
D:0| T0: 0.17| T1: 4.00| R0: 0.0| R1: 0.0| WTP: 0,0,0.173076923,4,0,0,0,0,0,-946606138.4,414696500,10396.34729,426788773.8,42678877.38,2,81356,3471,991,1727,736,991,81356,736,1727,121.5434174,2.655462185,4.675070028,62291.2409,1576.764706,7.453781513,99262.71989,0.624602664,0.015857804,7.65761E-05,0.426172554,0.021227691,50,4
D:0| T0: 0.17| T1: 4.00| R0: 0.0| R1: 0.0| WTP: 0,0,0.173076923,4,0,0,0,0,0,-930434488.3,1249738535,10255.29585,417669695.9,41766969.59,2,71408,3034,1067,1704,637,1067,71408,637,1704,101.7358491,2.741239892,4.423180593,64206.68464,767.5444744,7.299191375,99192.37736,0.644842435,0.00772216,7.51231E-05,0.373826291,0.023862873,53,4
D:0| T0: 0.17| T1: 4.00| R0: 0.0| R1: 0.0| WTP: 0,0,0.173076923,4,0,0,0,0,0,-965354891.6,614415382,10745.09578,428100102.5,42810010.25,2,80818,3478,986,1785,799,986,80818,799,1785,131.3571429,2.81547619,5.151785714,58538.85714,1521.392857,8.101190476,99155.89881,0.587453563,0.015299417,8.29562E-05,0.447619048,0.022086664,48,4
D:0| T0: 0.17| T1: 4.00| R0: 0.0| R1: 0.0| WTP: 0,0,0.173076923,4,0,0,0,0,0,-850351194.3,524899953,8468.687179,426916835.3,42691683.53,2,74649,3418,1009,1406,397,1009,74649,397,1406,114.6631854,2.519582245,3.522193211,65423.95822,1129.253264,6.146214099,99397.27415,0.656050374,0.011343657,6.33329E-05,0.282361309,0.018834814,55,4
D:0| T0: 0.17| T1: 4.00| R0: 0.0| R1: 0.0| WTP: 0,0,0.173076923,4,0,0,0,0,0,-1079636616,1338977757,12666.47924,446312653.9,44631265.39,2,98968,4419,404,2104,1700,404,98968,1700,2104,390.7323944,2.76056338,14.68309859,28274.72535,1832.619718,17.53521127,98604.11268,0.28457337,0.018367422,0.000177199,0.807984791,0.021259397,21,4
D:0| T0: 0.17| T1: 4.00| R0: 0.0| R1: 0.0| WTP: 0,0,0.173076923,4,0,0,0,0,0,-951029400.8,341384587,10498.0643,426126186,42612618.6,2,79824,3408,538,1744,1206,538,79824,1206,1744,220.6192893,2.624365482,8.700507614,42093.3198,1373.19797,11.41624365,98824.86294,0.424412323,0.013772571,0.000116247,0.691513761,0.021848066,29,4
D:0| T0: 0.17| T1: 4.00| R0: 0.0| R1: 0.0| WTP: 0,0,0.173076923,4,0,0,0,0,0,-1067581749,2032000160,12627.38409,436212544,43621254.4,2,91709,3907,945,2098,1153,945,91709,1153,2098,166.7876712,3.126712329,7.023972603,45510.84932,2119.253425,10.24657534,98852.63014,0.4568375,0.021333257,0.000104931,0.54957102,0.022876708,42,4
D:0| T0: 0.17| T1: 4.00| R0: 0.0| R1: 0.0| WTP: 0,0,0.173076923,4,0,0,0,0,0,-987226206.3,779488939,11124.28141,431012135.6,43101213.56,2,86449,3702,782,1848,1066,782,86449,1066,1848,187.1260163,3.048780488,7.321138211,37567.87805,1332.361789,10.51219512,98754.2439,0.378589474,0.013385038,0.000107523,0.576839827,0.021376765,36,4
D:0| T0: 0.17| T1: 4.00| R0: 0.0| R1: 0.0| WTP: 0,0,0.173076923,4,0,0,0,0,0,-1013971883,1449019578,11723.83538,427780114.3,42778011.43,2,86400,3547,942,1948,1006,942,86400,1006,1948,146.2307692,3.030100334,6.35451505,56163.301,1801.397993,9.491638796,99093.25418,0.563375908,0.018125313,9.72626E-05,0.516427105,0.022546296,42,4
D:0| T0: 0.17| T1: 4.00| R0: 0.0| R1: 0.0| WTP: 0,0,0.173076923,4,0,0,0,0,0,-843689383.9,351952211,8401.501056,423614331.1,42361433.11,2,72605,3392,932,1395,463,932,72605,463,1395,105.6423174,2.23929471,3.377833753,63458.67254,818.4156171,5.738035264,99334.82872,0.636737907,0.008222517,5.88721E-05,0.331899642,0.019214082,57,4
D:0| T0: 0.17| T1: 4.00| R0: 0.0| R1: 0.0| WTP: 0,0,0.173076923,4,0,0,0,0,0,-950868720.8,486595046,10444.99089,428619176.5,42861917.65,2,83765,3629,1038,1735,697,1038,83765,697,1735,115.6640625,2.598958333,4.372395833,60612.15104,1803.708333,7.078125,99251.77865,0.607651081,0.018146261,7.26554E-05,0.401729107,0.020712708,53,4
D:0| T0: 0.17| T1: 4.00| R0: 0.0| R1: 0.0| WTP: 0,0,0.173076923,4,0,0,0,0,0,-1012801739,296745624,11552.12272,435195603.5,43519560.35,2,88726,3935,1046,1919,873,1046,88726,873,1919,181.093985,3.823308271,7.037593985,42878.85714,1626.725564,10.96616541,98840.93985,0.43146095,0.016362259,0.000112125,0.45492444,0.021628384,38,4
D:0| T0: 0.17| T1: 4.00| R0: 0.0| R1: 0.0| WTP: 0,0,0.173076923,4,0,0,0,0,0,-914016089.3,1671484194,9682.679972,429882090.7,42988209.07,2,78859,3617,914,1608,694,914,78859,694,1608,150.3234323,2.877887789,5.115511551,60525.0462,1336.310231,8.151815182,99256.78218,0.607274151,0.013424623,8.36214E-05,0.43186061,0.020378143,44,4
D:0| T0: 0.17| T1: 4.00| R0: 0.0| R1: 0.0| WTP: 0,0,0.173076923,4,0,0,0,0,0,-1037828491,422157396,11873.09871,444173556,44417355.6,2,98341,4370,475,1972,1497,475,98341,1497,1972,339.025,2.9,12.21875,29014.1125,2293.53125,15.1875,98703.1625,0.291851708,0.023000808,0.00015347,0.759127789,0.020052674,23,4
D:0| T0: 0.17| T1: 4.00| R0: 0.0| R1: 0.0| WTP: 0,0,0.173076923,4,0,0,0,0,0,-1086958403,1916599091,12822.50832,445832986.9,44583298.69,2,98431,4258,448,2130,1682,448,98431,1682,2130,318.8265896,2.514450867,12.19075145,25379.6763,1980.855491,14.78612717,98508.15029,0.255614797,0.019879544,0.000149721,0.789671362,0.021639524,25,4
D:0| T0: 0.17| T1: 4.00| R0: 0.0| R1: 0.0| WTP: 0,0,0.173076923,4,0,0,0,0,0,-1057211901,1005953941,12216.17019,446403392.1,44640339.21,2,98346,4311,495,2029,1534,495,98346,1534,2029,349.5031447,3.062893082,12.65408805,28937.51572,2504.45283,15.75471698,98674.20755,0.291107942,0.02511484,0.000159329,0.756037457,0.020631241,23,4
D:0| T0: 0.17| T1: 4.00| R0: 0.0| R1: 0.0| WTP: 0,0,0.173076923,4,0,0,0,0,0,-1049854539,1422765615,12314.28229,434140424.5,43414042.45,2,89432,3817,560,2046,1486,560,89432,1486,2046,234.9705882,2.637254902,9.867647059,33518.62255,1519.696078,12.65196078,98589.76471,0.337936587,0.01526938,0.000128418,0.72629521,0.022877717,30,4
D:0| T0: 0.17| T1: 4.00| R0: 0.0| R1: 0.0| WTP: 0,0,0.173076923,4,0,0,0,0,0,-876740474.6,699740192,9251.312223,414174863.5,41417486.35,2,67563,2819,1155,1537,382,1155,67563,382,1537,79.08628319,2.440265487,3.254424779,65405.4292,891.5154867,5.811946903,99258.00885,0.656863249,0.0089646,5.9884E-05,0.248536109,0.022749138,65,4
D:0| T0: 0.17| T1: 4.00| R0: 0.0| R1: 0.0| WTP: 0,0,0.173076923,4,0,0,0,0,0,-864370923.2,240885764,8934.122944,417664776,41766477.6,2,70748,3063,1104,1484,380,1104,70748,380,1484,81.70322581,2.268817204,3.049462366,66638.37634,927.2602151,5.412903226,99344.44731,0.668586157,0.009321159,5.59484E-05,0.25606469,0.020975858,67,4
D:0| T0: 0.17| T1: 4.00| R0: 0.0| R1: 0.0| WTP: 0,0,0.173076923,4,0,0,0,0,0,-912680618.6,2023806564,9652.701648,430045536.3,43004553.63,2,82365,3708,936,1603,667,936,82365,667,1603,170.752809,3.344569288,5.812734082,39907.95506,1292.816479,9.310861423,98908.59925,0.402268619,0.012979587,9.5546E-05,0.416094822,0.01946215,39,4
D:0| T0: 0.17| T1: 4.00| R0: 0.0| R1: 0.0| WTP: 0,0,0.173076923,4,0,0,0,0,0,-909909911.6,1907493879,9752.3164,422294091.6,42229409.16,2,77183,3324,1028,1620,592,1028,77183,592,1620,118.0086957,2.852173913,4.515942029,63782.13333,1397.385507,7.495652174,99296.50725,0.639792167,0.014047338,7.71514E-05,0.365432099,0.020989078,49,4
D:0| T0: 0.17| T1: 4.00| R0: 0.0| R1: 0.0| WTP: 0,0,0.173076923,4,0,0,0,0,0,-1074519439,1565815291,12712.30245,438904316.3,43890431.63,2,93113,4054,878,2112,1234,878,93113,1234,2112,186.6777778,3.140740741,7.662962963,48664.08889,2772.644444,10.91481481,98948.68148,0.488001712,0.027902627,0.000111472,0.584280303,0.022682117,39,4
D:0| T0: 0.17| T1: 4.00| R0: 0.0| R1: 0.0| WTP: 0,0,0.173076923,4,0,0,0,0,0,-827510729.9,784442364,8189.535279,418033966,41803396.6,2,70323,3156,1040,1360,320,1040,70323,320,1360,101.6931217,2.613756614,3.428571429,63428.20899,986.2063492,6.17989418,99346.73016,0.636626915,0.009900207,6.37511E-05,0.235294118,0.019339334,53,4
D:0| T0: 0.17| T1: 4.00| R0: 0.0| R1: 0.0| WTP: 0,0,0.173076923,4,0,0,0,0,0,-938416249.9,206369745,10115.87456,432622522.2,43262252.22,2,84366,3758,696,1680,984,696,84366,984,1680,188.6772908,2.653386454,6.529880478,37386.5498,1403.960159,9.298804781,98825.92829,0.376859019,0.014096871,9.51143E-05,0.585714286,0.019913471,36,4
D:0| T0: 0.17| T1: 4.00| R0: 0.0| R1: 0.0| WTP: 0,0,0.173076923,4,0,0,0,0,0,-1028427796,2087235992,11775.5832,439648636.7,43964863.67,2,94726,4100,549,1956,1407,549,94726,1407,1956,288.9325843,3.011235955,10.84269663,32910.73034,2317.91573,13.92134831,98750.47753,0.33104594,0.023253746,0.000141307,0.719325153,0.02064903,26,4
D:0| T0: 0.17| T1: 4.00| R0: 0.0| R1: 0.0| WTP: 0,0,0.173076923,4,0,0,0,0,0,-1008399556,1019092536,11467.91078,435004016.6,43500401.66,2,90472,3928,870,1905,1035,870,90472,1035,1905,154.7628205,2.682692308,5.961538462,46233.23718,1599.842949,8.727564103,98951.37179,0.464011248,0.016093363,8.94941E-05,0.543307087,0.021056238,45,4
D:0| T0: 0.17| T1: 4.00| R0: 0.0| R1: 0.0| WTP: 0,0,0.173076923,4,0,0,0,0,0,-960561131.3,1885906113,10708.12693,425154784.8,42515478.48,2,80759,3440,1059,1779,720,1059,80759,720,1779,159.2037736,3.879245283,6.539622642,52273.13962,928.5358491,10.5245283,99024.04906,0.525575901,0.00933022,0.000107615,0.404721754,0.022028505,38,4
D:0| T0: 0.17| T1: 4.00| R0: 0.0| R1: 0.0| WTP: 0,0,0.173076923,4,0,0,0,0,0,-953744848.1,2028637200,10439.9561,431747043.2,43174704.32,2,83929,3824,940,1734,794,940,83929,794,1734,183.486166,3.57312253,6.675889328,58043.53755,1278.205534,10.37549407,99207.41897,0.582388175,0.012841247,0.00010616,0.457900807,0.02066032,37,4
D:0| T0: 0.17| T1: 4.00| R0: 0.0| R1: 0.0| WTP: 0,0,0.173076923,4,0,0,0,0,0,-974647152.7,181476086,10812.87974,434003165.7,43400316.57,2,88316,3898,554,1796,1242,554,88316,1242,1796,205.8247863,2.286324786,7.547008547,33204.98291,1768,9.923076923,98725.26496,0.33469162,0.017755559,0.000100907,0.691536748,0.020336066,34,4
D:0| T0: 0.17| T1: 4.00| R0: 0.0| R1: 0.0| WTP: 0,0,0.173076923,4,0,0,0,0,0,-993216200,2097578470,11126.15535,436908432.5,43690843.25,2,88059,3907,631,1848,1217,631,88059,1217,1848,232.9018692,2.841121495,8.481308411,35515.10748,2228.766355,11.43457944,98750.50467,0.357863776,0.02237663,0.000116381,0.658549784,0.02098593,31,4
D:0| T0: 0.17| T1: 4.00| R0: 0.0| R1: 0.0| WTP: 0,0,0.173076923,4,0,0,0,0,0,-1045322216,119646392,12212.51006,434696713.1,43469671.31,2,88263,3867,946,2029,1083,946,88263,1083,2029,157.4605263,2.986842105,6.493421053,51324.32566,1842.773026,9.608552632,98965.58224,0.515077777,0.018551631,9.85225E-05,0.533760473,0.022988115,44,4
D:0| T0: 0.17| T1: 4.00| R0: 0.0| R1: 0.0| WTP: 0,0,0.173076923,4,0,0,0,0,0,-1033700497,1298895859,11824.5335,442473821.7,44247382.17,2,95380,4196,512,1964,1452,512,95380,1452,1964,259.5853659,2.429268293,9.453658537,27017.29268,1936.531707,11.96097561,98598.47805,0.272199032,0.019446673,0.000121358,0.739307536,0.020591319,30,4
D:0| T0: 0.17| T1: 4.00| R0: 0.0| R1: 0.0| WTP: 0,0,0.173076923,4,0,0,0,0,0,-970509123.2,1489316290,10799.74351,430521947.5,43052194.75,2,83353,3714,558,1794,1236,558,83353,1236,1794,225.6666667,2.62745098,8.632352941,38953.57843,1422.357843,11.35294118,98776.2598,0.392726621,0.014271203,0.000115755,0.688963211,0.021522921,30,4
D:0| T0: 0.17| T1: 4.00| R0: 0.0| R1: 0.0| WTP: 0,0,0.173076923,4,0,0,0,0,0,-1139211173,855602142,14009.28097,438747124.3,43874712.43,2,96215,3954,472,2328,1856,472,96215,1856,2328,247.4460784,2.269607843,11.32843137,27540.69608,1680.97549,13.64215686,98357.41176,0.27735846,0.016906195,0.000138164,0.797250859,0.024195811,30,4
D:0| T0: 0.17| T1: 4.00| R0: 0.0| R1: 0.0| WTP: 0,0,0.173076923,4,0,0,0,0,0,-1012926002,1438649896,11481.27065,438862469.5,43886246.95,2,91085,4029,1066,1907,841,1066,91085,841,1907,185.4779412,3.801470588,6.841911765,46794.97426,1705.084559,10.74264706,98977.39706,0.469851227,0.017147128,0.000109911,0.441006817,0.020936488,38,4
D:0| T0: 0.17| T1: 4.00| R0: 0.0| R1: 0.0| WTP: 0,0,0.173076923,4,0,0,0,0,0,-971361174.9,952489126,10971.60647,422780851.3,42278085.13,2,78261,3254,1079,1823,744,1079,78261,744,1823,101.238806,2.57960199,4.393034826,61459.22139,1499.313433,7.064676617,99167.27363,0.616800909,0.015089724,7.26657E-05,0.408118486,0.02329385,58,4
D:0| T0: 0.17| T1: 4.00| R0: 0.0| R1: 0.0| WTP: 0,0,0.173076923,4,0,0,0,0,0,-1073822669,1550779155,12652.8018,441182578.9,44118257.89,2,99141,4210,405,2102,1697,405,99141,1697,2102,360.7931034,2.724137931,14.3862069,24054.22069,1912.144828,17.17931034,98516.76552,0.242599009,0.019168646,0.000173493,0.807326356,0.021202126,21,4
D:0| T0: 0.17| T1: 4.00| R0: 0.0| R1: 0.0| WTP: 0,0,0.173076923,4,0,0,0,0,0,-924022043.6,607323321,10040.46184,421998951.4,42199895.14,2,76801,3298,980,1668,688,980,76801,688,1668,115.4586895,2.658119658,4.58974359,63846.18803,1058.136752,7.393162393,99273.79772,0.640488465,0.01063925,7.58553E-05,0.412470024,0.021718467,51,4
D:0| T0: 0.17| T1: 4.00| R0: 0.0| R1: 0.0| WTP: 0,0,0.173076923,4,0,0,0,0,0,-888114875.6,2103646485,9331.69686,421530032.6,42153003.26,2,75712,3237,1004,1550,546,1004,75712,546,1550,150.6902985,3.563432836,5.589552239,48528.36567,855.3656716,9.332089552,98989.48507,0.489044654,0.008590124,9.57286E-05,0.352258065,0.020472316,39,4
D:0| T0: 0.17| T1: 4.00| R0: 0.0| R1: 0.0| WTP: 0,0,0.173076923,4,0,0,0,0,0,-1003026701,258120157,11146.92222,445680590.1,44568059.01,2,97713,4438,441,1851,1410,441,97713,1410,1851,350.5379747,2.715189873,11.58227848,26094.75949,1572.670886,14.38607595,98705.68987,0.2629706,0.015761445,0.00014547,0.761750405,0.018943232,23,4
D:0| T0: 0.17| T1: 4.00| R0: 0.0| R1: 0.0| WTP: 0,0,0.173076923,4,0,0,0,0,0,-948372728.8,1068951401,10237.28468,436508494.8,43650849.48,2,86611,3995,828,1700,872,828,86611,872,1700,193.5195313,3.1171875,6.47265625,57348.76563,1321.710938,9.7109375,99234.55078,0.574983846,0.013275282,9.91778E-05,0.512941176,0.019627992,37,4
D:0| T0: 0.17| T1: 4.00| R0: 0.0| R1: 0.0| WTP: 0,0,0.173076923,4,0,0,0,0,0,-1011307639,635956235,11581.16074,432249602.4,43224960.24,2,86378,3766,963,1924,961,963,86378,961,1924,134.715942,2.692753623,5.423188406,53813.81739,1899.295652,8.2,99049.03768,0.539929054,0.019117142,8.4245E-05,0.499480249,0.02227419,49,4
D:0| T0: 0.17| T1: 4.00| R0: 0.0| R1: 0.0| WTP: 0,0,0.173076923,4,0,0,0,0,0,-837384076.3,1346693470,8440.885624,415339795.1,41533979.51,2,67998,2971,989,1402,413,989,67998,413,1402,93.37817259,2.401015228,3.416243655,65090.50254,879.7360406,5.923857868,99320.77157,0.653447186,0.008837617,6.09564E-05,0.294789436,0.020603547,57,4
D:0| T0: 0.17| T1: 4.00| R0: 0.0| R1: 0.0| WTP: 0,0,0.173076923,4,0,0,0,0,0,-1089897643,847102011,12965.25669,441634808.2,44163480.82,2,98243,4209,473,2154,1681,473,98243,1681,2154,299.7428571,2.64,12.18285714,26520.21143,1916.177143,14.86857143,98518.59429,0.266991985,0.019242157,0.000150851,0.780408542,0.021925226,25,4
D:0| T0: 0.17| T1: 4.00| R0: 0.0| R1: 0.0| WTP: 0,0,0.173076923,4,0,0,0,0,0,-1117532571,812083272,13582.9312,438386010.9,43838601.09,2,95511,3948,889,2257,1368,889,95511,1368,2257,197.256917,3.391304348,8.739130435,45300.94862,2309.72332,12.29249012,98825.88538,0.454297251,0.023258984,0.000125219,0.606114311,0.023630786,37,4
D:0| T0: 0.17| T1: 4.00| R0: 0.0| R1: 0.0| WTP: 0,0,0.173076923,4,0,0,0,0,0,-1034346732,2146825809,11771.51154,445771154.8,44577115.48,2,98874,4500,465,1955,1490,465,98874,1490,1955,310.3202247,2.556179775,10.8988764,22618.65169,1755.179775,13.51123596,98579.26404,0.228024452,0.017605376,0.000136496,0.762148338,0.01977264,26,4
D:0| T0: 0.17| T1: 4.00| R0: 0.0| R1: 0.0| WTP: 0,0,0.173076923,4,0,0,0,0,0,-1085026284,226186520,12839.60822,443045872.7,44304587.27,2,97221,4230,466,2133,1667,466,97221,1667,2133,291.6721311,2.491803279,11.53551913,27166.39891,1549.251366,14.07650273,98509.78142,0.273549851,0.015561842,0.000142739,0.781528364,0.021939704,27,4
D:0| T0: 0.17| T1: 4.00| R0: 0.0| R1: 0.0| WTP: 0,0,0.173076923,4,0,0,0,0,0,-1064515001,1110225441,12466.81596,441174202.5,44117420.25,2,95813,4109,840,2071,1231,840,95813,1231,2071,175.3851351,2.743243243,6.864864865,42638.86486,2488.449324,9.695945946,98864.99324,0.427533434,0.025050329,9.90129E-05,0.594398841,0.021615021,43,4
D:0| T0: 0.17| T1: 4.00| R0: 0.0| R1: 0.0| WTP: 0,0,0.173076923,4,0,0,0,0,0,-957287618.1,1190767082,10316.973,441438968.1,44143896.81,2,94386,4289,899,1713,814,899,94386,814,1713,239.43379,3.98630137,7.639269406,49983.37443,2316.018265,11.7260274,99191.21918,0.50100858,0.0232443,0.000119701,0.475189726,0.018148878,32,4
D:0| T0: 0.17| T1: 4.00| R0: 0.0| R1: 0.0| WTP: 0,0,0.173076923,4,0,0,0,0,0,-969797881.1,2108234095,10906.04876,424495443,42449544.3,2,81744,3372,972,1812,840,972,81744,840,1812,135.9902597,3.019480519,5.685064935,57426.95455,1624.821429,8.853896104,99129.91883,0.576415391,0.0163374,9.09052E-05,0.463576159,0.022166765,44,4
D:0| T0: 0.17| T1: 4.00| R0: 0.0| R1: 0.0| WTP: 0,0,0.173076923,4,0,0,0,0,0,-1098506747,465621985,13044.83971,446264761.7,44626476.17,2,98739,4381,480,2167,1687,480,98739,1687,2167,341.308642,2.882716049,13.25308642,26570.87037,2096.54321,16.2037037,98529.21605,0.267514065,0.021043716,0.000164138,0.778495616,0.021946748,24,4
D:0| T0: 0.17| T1: 4.00| R0: 0.0| R1: 0.0| WTP: 0,0,0.173076923,4,0,0,0,0,0,-973483182.6,1487072553,10747.65314,436100525.5,43610052.55,2,85232,3908,902,1785,883,902,85232,883,1785,177.2924188,3.144404332,6.292418773,51823.3213,1107.303249,9.563176895,99064.12635,0.520342948,0.011128256,9.74964E-05,0.494677871,0.020942838,40,4
D:0| T0: 0.17| T1: 4.00| R0: 0.0| R1: 0.0| WTP: 0,0,0.173076923,4,0,0,0,0,0,-994393409.3,1213733847,11250.79783,431853517.7,43185351.77,2,86360,3712,1070,1869,799,1070,86360,799,1869,149.433657,3.385113269,5.902912621,41167.46278,1180.718447,9.378640777,98792.06472,0.41447978,0.011878789,9.56821E-05,0.427501338,0.021641964,45,4
D:0| T0: 0.17| T1: 4.00| R0: 0.0| R1: 0.0| WTP: 0,0,0.173076923,4,0,0,0,0,0,-1003698583,2003658337,11413.30692,433033237.2,43303323.72,2,88530,3767,1009,1896,887,1009,88530,887,1896,197.1428571,4.159663866,7.819327731,45464.13445,1505.605042,12.05882353,98910.93277,0.457185041,0.015134496,0.000122709,0.467827004,0.021416469,34,4
D:0| T0: 0.17| T1: 4.00| R0: 0.0| R1: 0.0| WTP: 0,0,0.173076923,4,0,0,0,0,0,-895541620.1,1170868072,9399.064171,425588411.6,42558841.16,2,76307,3413,983,1561,578,983,76307,578,1561,119.4874652,2.61281337,4.186629526,64202.12535,1229.532033,6.922005571,99322.75209,0.643932775,0.012356046,7.12178E-05,0.370275464,0.020456839,52,4
D:0| T0: 0.17| T1: 4.00| R0: 0.0| R1: 0.0| WTP: 0,0,0.173076923,4,0,0,0,0,0,-1042097178,569919592,11915.80294,446307031.2,44630703.12,2,99253,4499,426,1979,1553,426,99253,1553,1979,291.0471204,2.178010471,10.28272251,19861.66492,1353.65445,12.51308901,98501.8377,0.200403918,0.013586368,0.000126488,0.784739768,0.019938944,28,4
D:0| T0: 0.17| T1: 4.00| R0: 0.0| R1: 0.0| WTP: 0,0,0.173076923,4,0,0,0,0,0,-934910315.7,1833180623,9902.174476,439801591.9,43980159.19,2,86970,4006,1079,1644,565,1079,86970,565,1644,184.3082437,3.734767025,5.677419355,42320.22939,1444.523297,9.562724014,98985.3405,0.425744496,0.014509329,9.80547E-05,0.343673966,0.01890307,40,4
D:0| T0: 0.17| T1: 4.00| R0: 0.0| R1: 0.0| WTP: 0,0,0.173076923,4,0,0,0,0,0,-1111961312,1123666637,13415.53697,441184464.1,44118446.41,2,97052,4087,487,2229,1742,487,97052,1742,2229,292.7078652,2.657303371,12.38764045,26975.89888,1643.11236,15.11797753,98444.46629,0.27175684,0.016507485,0.000153409,0.781516375,0.022967069,26,4
D:0| T0: 0.17| T1: 4.00| R0: 0.0| R1: 0.0| WTP: 0,0,0.173076923,4,0,0,0,0,0,-1019405692,1682024981,11583.76172,440217606,44021760.6,2,93100,4049,941,1924,983,941,93100,983,1924,214.2333333,3.8125,7.8375,39715.85,3179.116667,11.7625,98866.675,0.399129438,0.031956623,0.000120072,0.510914761,0.020665951,34,4
D:0| T0: 0.17| T1: 4.00| R0: 0.0| R1: 0.0| WTP: 0,0,0.173076923,4,0,0,0,0,0,-1058988437,1687523543,12453.20606,436328134.5,43632813.45,2,92936,4022,831,2069,1238,831,92936,1238,2069,207.1398305,3.423728814,8.618644068,51931.97034,1504.741525,12.11440678,99032.47458,0.520588913,0.015134238,0.00012359,0.598356694,0.022262632,34,4
D:0| T0: 0.17| T1: 4.00| R0: 0.0| R1: 0.0| WTP: 0,0,0.173076923,4,0,0,0,0,0,-1046340656,178034412,12141.74833,439253239.2,43925323.92,2,94618,4091,473,2017,1544,473,94618,1544,2017,314.0490798,2.82208589,12.21472393,33320.15337,2041.895706,15.12269939,98700.55215,0.335256853,0.020483309,0.000153343,0.765493307,0.021317297,24,4
D:0| T0: 0.17| T1: 4.00| R0: 0.0| R1: 0.0| WTP: 0,0,0.173076923,4,0,0,0,0,0,-1001590500,739490003,11258.76556,438652221.6,43865222.16,2,93063,4071,473,1870,1397,473,93063,1397,1870,311.0792683,2.81097561,11.26219512,35063.88415,1584.506098,14.12804878,98803.62805,0.352765951,0.01588438,0.000143308,0.747058824,0.020093915,24,4
D:0| T0: 0.17| T1: 4.00| R0: 0.0| R1: 0.0| WTP: 0,0,0.173076923,4,0,0,0,0,0,-979954938.8,178482706,11080.64115,425922881.2,42592288.12,2,81999,3546,951,1841,890,951,81999,890,1841,149.2902098,3.178321678,6.255244755,39461.61189,1226.944056,9.56993007,98711.16783,0.398294406,0.012335895,9.82428E-05,0.483432917,0.022451767,41,4
D:0| T0: 0.17| T1: 4.00| R0: 0.0| R1: 0.0| WTP: 0,0,0.173076923,4,0,0,0,0,0,-1068942960,1919366370,12734.21762,432232078.6,43223207.86,2,91373,3740,995,2116,1121,995,91373,1121,2116,193.0502092,4.071129707,8.707112971,48528.71548,1322.125523,12.84937238,98903.44351,0.487251793,0.01330285,0.000130947,0.529773157,0.023157826,35,4
D:0| T0: 0.17| T1: 4.00| R0: 0.0| R1: 0.0| WTP: 0,0,0.173076923,4,0,0,0,0,0,-1017278223,1819796913,11429.22018,445817213.9,44581721.39,2,97464,4460,447,1898,1451,447,97464,1451,1898,339.7852761,2.687116564,11.52760736,30623.4908,2461.699387,14.25766871,98773.20859,0.307929717,0.024677021,0.000144329,0.764488936,0.019473857,24,4
D:0| T0: 0.17| T1: 4.00| R0: 0.0| R1: 0.0| WTP: 0,0,0.173076923,4,0,0,0,0,0,-1033855010,1866591913,11866.02324,440553848.1,44055384.81,2,96420,4214,788,1971,1183,788,96420,1183,1971,192.1784387,2.80669145,7.152416357,51573.24535,2960.527881,10.08921933,99128.49442,0.516331954,0.0297744,0.000103195,0.600202943,0.020441817,39,4
D:0| T0: 0.17| T1: 4.00| R0: 0.0| R1: 0.0| WTP: 0,0,0.173076923,4,0,0,0,0,0,-1065201035,1219425989,12401.84865,445108602.2,44510860.22,2,99237,4466,445,2060,1615,445,99237,1615,2060,367.2281879,2.899328859,13.69798658,25378.61074,1725.073826,16.67785235,98582.61074,0.255690659,0.017298075,0.000168699,0.783980583,0.020758386,22,4
D:0| T0: 0.17| T1: 4.00| R0: 0.0| R1: 0.0| WTP: 0,0,0.173076923,4,0,0,0,0,0,-1029400450,502409586,11734.49335,442675782.3,44267578.23,2,97446,4268,475,1949,1474,475,97446,1474,1949,301.5480226,2.610169492,10.89265537,27658.0452,2219.242938,13.59887006,98671.30508,0.278375652,0.022263094,0.000137493,0.756285274,0.020000821,26,4
D:0| T0: 0.17| T1: 4.00| R0: 0.0| R1: 0.0| WTP: 0,0,0.173076923,4,0,0,0,0,0,-923232141.3,1405887957,9927.771268,426843577.9,42684357.79,2,79175,3554,565,1649,1084,565,79175,1084,1649,200.7762557,2.456621005,7.374429224,41961.14155,1096.803653,9.945205479,98863.82648,0.423068632,0.011003092,0.000101474,0.657368102,0.020827281,32,4
D:0| T0: 0.17| T1: 4.00| R0: 0.0| R1: 0.0| WTP: 0,0,0.173076923,4,0,0,0,0,0,-1042824582,283033753,12282.4785,428700657.1,42870065.71,2,87561,3606,530,2041,1511,530,87561,1511,2041,270.2909091,3.127272727,12.22424242,39702.5697,1410.575758,15.43030303,98710.33939,0.399881768,0.014158018,0.000156441,0.740323371,0.02330973,24,4
D:0| T0: 0.17| T1: 4.00| R0: 0.0| R1: 0.0| WTP: 0,0,0.173076923,4,0,0,0,0,0,-1042417066,1083157068,12188.04253,433014939.2,43301493.92,2,89238,3757,1154,2025,871,1154,89238,871,2025,169.4145455,4.08,7.185454545,40523.66909,1646.909091,11.38909091,98752.99273,0.407973821,0.016570499,0.000116367,0.430123457,0.022692127,40,4
D:0| T0: 0.17| T1: 4.00| R0: 0.0| R1: 0.0| WTP: 0,0,0.173076923,4,0,0,0,0,0,-1014798216,1988704626,11759.61623,426817404.1,42681740.41,2,84085,3513,1086,1954,868,1086,84085,868,1954,179.6610879,4.410041841,7.983263598,54341.58577,904.6694561,12.53974895,99014.98326,0.546016766,0.009097412,0.000127862,0.444216991,0.02323839,35,4
D:0| T0: 0.17| T1: 4.00| R0: 0.0| R1: 0.0| WTP: 0,0,0.173076923,4,0,0,0,0,0,-1081717277,884761309,12743.97338,444518608.4,44451860.84,2,99069,4387,436,2117,1681,436,99069,1681,2117,369.3673469,2.911564626,14.29251701,24302.81633,1752.081633,17.2585034,98511.2381,0.245066138,0.017571463,0.00017431,0.794048181,0.021368945,21,4
D:0| T0: 0.17| T1: 4.00| R0: 0.0| R1: 0.0| WTP: 0,0,0.173076923,4,0,0,0,0,0,-902088325.4,533485933,9365.628382,433806906.3,43380690.63,2,83668,3891,832,1555,723,832,83668,723,1555,162.3918919,2.709459459,5.108108108,53801.16554,772.1722973,7.902027027,99198.18581,0.539894807,0.007753876,8.09786E-05,0.464951768,0.018585361,43,4
D:0| T0: 0.17| T1: 4.00| R0: 0.0| R1: 0.0| WTP: 0,0,0.173076923,4,0,0,0,0,0,-996675092.1,632196071,11322.35149,430557517.8,43055751.78,2,84825,3632,850,1881,1031,850,84825,1031,1881,165.9672727,2.974545455,6.683636364,54257.73818,795.0581818,9.785454545,99050.71636,0.544661772,0.007994674,9.98504E-05,0.548112706,0.022175066,40,4
D:0| T0: 0.17| T1: 4.00| R0: 0.0| R1: 0.0| WTP: 0,0,0.173076923,4,0,0,0,0,0,-1081068170,393400457,12796.96692,441219824.3,44121982.43,2,96349,4176,447,2126,1679,447,96349,1679,2126,343.875,2.875,13.875,34199.94737,1984.671053,16.78947368,98672.40132,0.343809853,0.019907816,0.000169925,0.789746002,0.022065616,22,4
D:0| T0: 0.17| T1: 4.00| R0: 0.0| R1: 0.0| WTP: 0,0,0.173076923,4,0,0,0,0,0,-971012349.4,398973227,10864.91277,427766710.9,42776671.09,2,83182,3579,559,1805,1246,559,83182,1246,1805,251.8409091,3.0625,10.07954545,42495.44886,1413.892045,13.22727273,98859.14205,0.428004624,0.01417484,0.000134754,0.690304709,0.021699406,26,4
D:0| T0: 0.17| T1: 4.00| R0: 0.0| R1: 0.0| WTP: 0,0,0.173076923,4,0,0,0,0,0,-1013366901,1402256491,11528.61926,436935938.1,43693593.81,2,93734,4025,933,1915,982,933,93734,982,1915,192.8671875,3.5234375,7.32421875,44513.70313,2325.863281,10.9765625,98961.65625,0.446628044,0.023387081,0.000111845,0.512793734,0.020430153,37,4
D:0| T0: 0.17| T1: 4.00| R0: 0.0| R1: 0.0| WTP: 0,0,0.173076923,4,0,0,0,0,0,-1046602428,2102527413,12136.11925,439796466,43979646.6,2,91254,4018,923,2016,1093,923,91254,1093,2016,210.9214876,3.719008264,8.190082645,35751.38017,2184.152893,11.99586777,98690.10744,0.36001878,0.021962423,0.000122237,0.542162698,0.022092424,35,4
D:0| T0: 0.17| T1: 4.00| R0: 0.0| R1: 0.0| WTP: 0,0,0.173076923,4,0,0,0,0,0,-1025811034,1748031099,11833.91891,434115087.9,43411508.79,2,88665,3748,712,1966,1254,712,88665,1254,1966,198.6804979,2.842323651,8.008298755,33814.3527,1989.738589,10.98340249,98628.78423,0.340931948,0.020005401,0.000111777,0.637843337,0.022173349,35,4
D:0| T0: 0.17| T1: 4.00| R0: 0.0| R1: 0.0| WTP: 0,0,0.173076923,4,0,0,0,0,0,-982313010,1946754629,10957.27636,434449191.8,43444919.18,2,87594,3828,828,1820,992,828,87594,992,1820,193.3052209,3.208835341,7.144578313,55556.59839,1348.714859,10.47389558,99157.08434,0.557148673,0.013549595,0.000106861,0.545054945,0.020777679,36,4
D:0| T0: 0.17| T1: 4.00| R0: 0.0| R1: 0.0| WTP: 0,0,0.173076923,4,0,0,0,0,0,-935781581.7,2097712204,9979.215454,436820809,43682080.9,2,86078,3913,932,1657,725,932,86078,725,1657,188.3068182,3.397727273,6.106060606,50341.55303,1013.856061,9.632575758,99105.8447,0.50548048,0.010182888,9.84771E-05,0.437537719,0.019249983,38,4
D:0| T0: 0.17| T1: 4.00| R0: 0.0| R1: 0.0| WTP: 0,0,0.173076923,4,0,0,0,0,0,-1006267300,1198827119,11514.53575,430540512.8,43054051.28,2,85092,3672,926,1913,987,926,85092,987,1913,146.7451613,2.870967742,6.009677419,59707.33871,1764.477419,8.990322581,99171.11613,0.598659359,0.01775314,9.21539E-05,0.515943544,0.022481549,45,4
D:0| T0: 0.17| T1: 4.00| R0: 0.0| R1: 0.0| WTP: 0,0,0.173076923,4,0,0,0,0,0,-850586408,109253198,8711.086129,415032101.6,41503210.16,2,66761,2939,1177,1447,270,1177,66761,270,1447,76.42016807,2.325630252,2.87394958,68316.35084,989.8214286,5.344537815,99354.53992,0.685652381,0.009950057,5.54082E-05,0.186592951,0.021674331,67,4
D:0| T0: 0.17| T1: 4.00| R0: 0.0| R1: 0.0| WTP: 0,0,0.173076923,4,0,0,0,0,0,-978590282,314481292,10973.81665,429899449.7,42989944.97,2,81316,3630,845,1823,978,845,81316,978,1823,164.7890909,2.952727273,6.458181818,59406.95273,879.7490909,9.52,99152.54545,0.596160104,0.008845223,9.75295E-05,0.536478332,0.022418712,40,4
D:0| T0: 0.17| T1: 8.00| R0: 0.0| R1: 0.0| WTP: 0,0,0.173076923,8,0,0,0,0,0,-1332191611,1178568022,11081.17809,778132706.5,77813270.65,2,82411,3563,960,1841,881,960,82411,881,1841,110.9060914,2.337563452,4.532994924,66225.05584,1076.213198,6.974619289,99305.13959,0.663637887,0.010831997,7.15583E-05,0.478544269,0.022339251,56,8
D:0| T0: 0.17| T1: 8.00| R0: 0.0| R1: 0.0| WTP: 0,0,0.173076923,8,0,0,0,0,0,-1380845440,2029998696,11746.57674,793516602.8,79351660.28,2,95758,4310,471,1951,1480,471,95758,1480,1951,347.4350649,2.993506494,12.55194805,34910.18182,2100.415584,15.5974026,98806.53896,0.350870521,0.021050573,0.000157761,0.758585341,0.020374277,22,8
D:0| T0: 0.17| T1: 8.00| R0: 0.0| R1: 0.0| WTP: 0,0,0.173076923,8,0,0,0,0,0,-1349825553,776062361,11423.61427,778644839.3,77864483.93,2,84642,3586,881,1898,1017,881,84642,1017,1898,124.3926554,2.36440678,5.203389831,34843.45198,1485.361582,7.694915254,98613.81921,0.351675079,0.014949834,7.90674E-05,0.535827187,0.022424121,50,8
D:0| T0: 0.17| T1: 8.00| R0: 0.0| R1: 0.0| WTP: 0,0,0.173076923,8,0,0,0,0,0,-1333533281,1813046880,11057.98868,780633847.6,78063384.76,2,82845,3603,961,1837,876,961,82845,876,1837,113.4285714,2.315789474,4.486215539,64034.47118,1316.882206,6.884711779,99268.9599,0.641819908,0.013252646,7.05908E-05,0.476864453,0.022173939,57,8
D:0| T0: 0.17| T1: 8.00| R0: 0.0| R1: 0.0| WTP: 0,0,0.173076923,8,0,0,0,0,0,-1301388628,2032407216,10344.50557,784163349.2,78416334.92,2,83310,3858,1052,1718,666,1052,83310,666,1718,154.1201299,3.269480519,5.38961039,58825.52273,946.737013,8.801948052,99208.54545,0.59056142,0.009519203,9.03852E-05,0.38766007,0.020621774,44,8
D:0| T0: 0.17| T1: 8.00| R0: 0.0| R1: 0.0| WTP: 0,0,0.173076923,8,0,0,0,0,0,-702179792.9,1507873352,18.03885983,701277849.9,70127784.99,2,54,5,3,3,0,3,54,0,3,0.314685315,0,0,99967.60839,3.167832168,0.020979021,99999.03497,0.999687009,3.33336E-05,4.16671E-07,0,0.055555556,20,8
D:0| T0: 0.17| T1: 8.00| R0: 0.0| R1: 0.0| WTP: 0,0,0.173076923,8,0,0,0,0,0,-1223761082,1855899401,9031.435447,772189309.8,77218930.98,2,73262,3293,1011,1500,489,1011,73262,489,1500,94.55373832,2.25,3.362149533,70583.94393,639.9275701,5.712616822,99438.83411,0.707513742,0.006433125,5.89696E-05,0.326,0.020474462,62,8
D:0| T0: 0.17| T1: 8.00| R0: 0.0| R1: 0.0| WTP: 0,0,0.173076923,8,0,0,0,0,0,-1236725016,1819459251,9336.854352,769882297.9,76988229.79,2,73294,3224,846,1551,705,846,73294,705,1551,70.05892857,1.366071429,2.607142857,38591.48571,469.475,4.128571429,98729.67857,0.390316365,0.004723435,4.308E-05,0.454545455,0.02116135,80,8
D:0| T0: 0.17| T1: 8.00| R0: 0.0| R1: 0.0| WTP: 0,0,0.173076923,8,0,0,0,0,0,-1251774541,909791748,9524.926033,775528239.4,77552823.94,2,76345,3364,854,1582,728,854,76345,728,1582,111.4947644,2.14921466,4.034031414,74035.9555,650.7565445,6.272251309,99507.26963,0.741503882,0.00654237,6.41041E-05,0.460176991,0.020721724,55,8
D:0| T0: 0.17| T1: 8.00| R0: 0.0| R1: 0.0| WTP: 0,0,0.173076923,8,0,0,0,0,0,-1311068545,1339092841,10761.40307,772998391.4,77299839.14,2,76373,3212,1335,1788,453,1335,76373,453,1788,134.5217391,4.304347826,5.782608696,54157.35786,920.7926421,10.24749164,98979.41472,0.545515295,0.00926122,0.000105064,0.253355705,0.023411722,43,8
D:0| T0: 0.17| T1: 8.00| R0: 0.0| R1: 0.0| WTP: 0,0,0.173076923,8,0,0,0,0,0,-1417086740,1365866345,12461.37307,794018086.5,79401808.65,2,97539,4342,473,2070,1597,473,97539,1597,2070,350.6535948,3.013071895,13.37908497,32479.7451,1994.620915,16.47712418,98707.03268,0.326486897,0.020006657,0.000166821,0.771497585,0.02122228,22,8
D:0| T0: 0.17| T1: 8.00| R0: 0.0| R1: 0.0| WTP: 0,0,0.173076923,8,0,0,0,0,0,-1315650400,825453433,10567.75497,787262650.9,78726265.09,2,88644,4074,1201,1755,554,1201,88644,554,1755,159.4837662,3.743506494,5.506493506,47539.67208,1465.36039,9.435064935,99038.95455,0.477647409,0.014731499,9.64771E-05,0.315669516,0.019798294,44,8
D:0| T0: 0.17| T1: 8.00| R0: 0.0| R1: 0.0| WTP: 0,0,0.173076923,8,0,0,0,0,0,-1425484796,939711378,12599.97694,795485948.7,79548594.87,2,97565,4337,449,2093,1644,449,97565,1644,2093,352.1225806,2.806451613,13.36129032,32566.96774,2472.883871,16.23870968,98693.54839,0.327314107,0.024802877,0.000164638,0.785475394,0.021452365,23,8
D:0| T0: 0.17| T1: 8.00| R0: 0.0| R1: 0.0| WTP: 0,0,0.173076923,8,0,0,0,0,0,-1364330191,638950699,11481.49601,790255390.8,79025539.08,2,91483,4120,1038,1907,869,1038,91483,869,1907,160.2861635,3.125786164,5.830188679,52022.80503,1823.603774,9.08490566,99071.86792,0.521826572,0.01835494,9.31689E-05,0.455689565,0.020845403,46,8
D:0| T0: 0.17| T1: 8.00| R0: 0.0| R1: 0.0| WTP: 0,0,0.173076923,8,0,0,0,0,0,-1300619663,938699148,10279.23272,786658026.7,78665802.67,2,84965,3834,924,1707,783,924,84965,783,1707,161.3770492,2.891803279,5.413114754,61965.91475,941.9606557,8.459016393,99292.6459,0.621253727,0.009469211,8.66954E-05,0.458699473,0.020090626,44,8
D:0| T0: 0.17| T1: 8.00| R0: 0.0| R1: 0.0| WTP: 0,0,0.173076923,8,0,0,0,0,0,-1284482960,121790188,10049.54088,782005915.9,78200591.59,2,81232,3707,1013,1669,656,1013,81232,656,1669,109.1226415,2.294811321,3.806603774,67101.38208,1389.365566,6.193396226,99380.56132,0.672330759,0.013975525,6.36329E-05,0.39304973,0.02054609,60,8
D:0| T0: 0.17| T1: 8.00| R0: 0.0| R1: 0.0| WTP: 0,0,0.173076923,8,0,0,0,0,0,-1326392363,1331335240,10866.61539,783061593.6,78306159.36,2,85678,3733,1013,1805,792,1013,85678,792,1805,133.5485714,2.771428571,4.997142857,34688.01429,1612.117143,7.897142857,98698.72571,0.350005922,0.016216768,8.10587E-05,0.438781163,0.021067252,50,8
D:0| T0: 0.17| T1: 8.00| R0: 0.0| R1: 0.0| WTP: 0,0,0.173076923,8,0,0,0,0,0,-1462535892,470935411,13362.35035,794418374.7,79441837.47,2,98775,4173,475,2220,1745,475,98775,1745,2220,312.5,2.697674419,12.81395349,24473.4186,1485.94186,15.54651163,98426.86628,0.246574405,0.014924275,0.000157498,0.786036036,0.022475323,25,8
D:0| T0: 0.17| T1: 8.00| R0: 0.0| R1: 0.0| WTP: 0,0,0.173076923,8,0,0,0,0,0,-1394548461,823434397,12253.41926,781877498.6,78187749.86,2,90168,3741,918,2036,1118,918,90168,1118,2036,153.6208054,2.946308725,6.647651007,56487.46644,1543.409396,9.731543624,99098.26174,0.566328409,0.015536116,9.97738E-05,0.549115914,0.022580073,43,8
D:0| T0: 0.17| T1: 8.00| R0: 0.0| R1: 0.0| WTP: 0,0,0.173076923,8,0,0,0,0,0,-1252071604,493045351,9501.361687,777003519.8,77700351.98,2,78372,3480,840,1578,738,840,78372,738,1578,116.04,2.138666667,4.08,69128.408,531.944,6.304,99424.99733,0.692633667,0.005347445,6.48112E-05,0.467680608,0.020134999,54,8
D:0| T0: 0.17| T1: 8.00| R0: 0.0| R1: 0.0| WTP: 0,0,0.173076923,8,0,0,0,0,0,-1307202057,1700216563,10375.82571,788410771.1,78841077.11,2,87689,4074,838,1723,885,838,87689,885,1723,153.3567073,2.448170732,5.106707317,56404.1128,1444.551829,7.667682927,99204.35671,0.565397338,0.014523133,7.85049E-05,0.513639002,0.019648987,47,8
D:0| T0: 0.17| T1: 8.00| R0: 0.0| R1: 0.0| WTP: 0,0,0.173076923,8,0,0,0,0,0,-1204578858,1744119059,8582.155341,775471090.8,77547109.08,2,74575,3474,1180,1425,245,1180,74575,245,1425,120.4403409,3.181818182,3.863636364,55095.71875,583.9630682,7.221590909,99188.59943,0.554300981,0.0058654,7.43314E-05,0.171929825,0.019108536,51,8
D:0| T0: 0.17| T1: 8.00| R0: 0.0| R1: 0.0| WTP: 0,0,0.173076923,8,0,0,0,0,0,-1324607571,2036906360,10889.6766,780123741.2,78012374.12,2,84545,3630,1032,1809,777,1032,84545,777,1809,107.9663462,2.360576923,4.1875,60036.78846,1420.004808,6.670673077,99212.42067,0.601904305,0.014290265,6.87477E-05,0.429519071,0.021396889,59,8
D:0| T0: 0.17| T1: 8.00| R0: 0.0| R1: 0.0| WTP: 0,0,0.173076923,8,0,0,0,0,0,-1305049563,809704121,10345.63305,787767910,78776791,2,89324,4022,938,1718,780,938,89324,780,1718,161.7207792,2.918831169,5.409090909,56376,1501.769481,8.467532468,99221.39935,0.565182101,0.015098043,8.6669E-05,0.454016298,0.019233353,43,8
D:0| T0: 0.17| T1: 8.00| R0: 0.0| R1: 0.0| WTP: 0,0,0.173076923,8,0,0,0,0,0,-1305226081,1219866412,10381.18216,786166972.6,78616697.26,2,85367,3812,997,1724,727,997,85367,727,1724,99.26422764,1.906504065,3.367886179,28644.04065,1423.51626,5.392276423,98616.37195,0.289530803,0.014324326,5.57002E-05,0.421693735,0.020195157,71,8
D:0| T0: 0.17| T1: 8.00| R0: 0.0| R1: 0.0| WTP: 0,0,0.173076923,8,0,0,0,0,0,-705235558.7,843498920,72.19551623,701625782.9,70162578.29,2,649,29,12,12,0,12,649,0,12,1.850746269,0.014925373,0.014925373,99620.91045,22.28358209,0.126865672,99993.50746,0.996279485,0.00022357,1.77787E-06,0,0.018489985,20,8
D:0| T0: 0.17| T1: 8.00| R0: 0.0| R1: 0.0| WTP: 0,0,0.173076923,8,0,0,0,0,0,-1476174424,107351963,13839.66636,784191106.4,78419110.64,2,92287,3694,1028,2300,1272,1028,92287,1272,2300,148.8980892,3.162420382,7.159235669,54722.98408,2039.929936,10.41401274,98976.48408,0.548698784,0.020563005,0.000106838,0.553043478,0.024922523,45,8
D:0| T0: 0.17| T1: 8.00| R0: 0.0| R1: 0.0| WTP: 0,0,0.173076923,8,0,0,0,0,0,-1381413055,773789021,11776.46011,792590049,79259004.9,2,92191,4211,905,1956,1051,905,92191,1051,1956,165.1320755,2.704402516,5.965408805,53073.08176,1971.767296,8.830188679,99095.55346,0.531966229,0.019838232,9.05496E-05,0.537321063,0.021216822,46,8
D:0| T0: 0.17| T1: 8.00| R0: 0.0| R1: 0.0| WTP: 0,0,0.173076923,8,0,0,0,0,0,-1394531801,850936611,12271.19667,780971967.8,78097196.78,2,88968,3682,1052,2039,987,1052,88968,987,2039,138.2668712,3.085889571,6.073619632,51224.06135,1440.825153,9.337423313,98951.2546,0.514324171,0.014508933,9.54496E-05,0.484060814,0.022918353,47,8
D:0| T0: 0.17| T1: 8.00| R0: 0.0| R1: 0.0| WTP: 0,0,0.173076923,8,0,0,0,0,0,-1277075416,1701318364,10059.05511,774122660.4,77412266.04,2,77595,3312,1194,1671,477,1194,77595,477,1671,112.1331522,3.0625,4.336956522,46005.25815,894.0706522,7.586956522,98886.49185,0.464167869,0.008991579,7.83366E-05,0.28545781,0.021535725,53,8
D:0| T0: 0.17| T1: 8.00| R0: 0.0| R1: 0.0| WTP: 0,0,0.173076923,8,0,0,0,0,0,-1270692779,778708269,9921.092345,774638161.9,77463816.19,2,77523,3263,1111,1648,537,1111,77523,537,1648,84.94704684,2.16293279,3.226069246,66172.29735,1214.578411,5.474541752,99330.29735,0.663477138,0.012220709,5.65369E-05,0.325849515,0.021258207,71,8
D:0| T0: 0.17| T1: 8.00| R0: 0.0| R1: 0.0| WTP: 0,0,0.173076923,8,0,0,0,0,0,-1348429776,1391938506,11470.52582,774903485.4,77490348.54,2,80164,3371,1077,1906,829,1077,80164,829,1906,136.5921053,3.371710526,6.052631579,64169.38487,946.8421053,9.608552632,99214.69408,0.644112699,0.009527713,9.86993E-05,0.434942288,0.023776259,44,8
D:0| T0: 0.17| T1: 8.00| R0: 0.0| R1: 0.0| WTP: 0,0,0.173076923,8,0,0,0,0,0,-1207799077,43418681,8819.555708,766821291.2,76682129.12,2,69406,2944,1071,1465,394,1071,69406,394,1465,80.46753247,2.222943723,3.045454545,71713.86147,849.6017316,5.363636364,99445.98268,0.719022234,0.008540269,5.51764E-05,0.26894198,0.021107685,66,8
D:0| T0: 0.17| T1: 8.00| R0: 0.0| R1: 0.0| WTP: 0,0,0.173076923,8,0,0,0,0,0,-1442781536,817384966,13042.80165,790641453,79064145.3,2,97822,4117,441,2167,1726,441,97822,1726,2167,235.1506849,1.96803653,9.808219178,20561.99087,1216.515982,11.82648402,98330.76712,0.207488953,0.012227703,0.000119801,0.796492847,0.022152481,32,8
D:0| T0: 0.17| T1: 8.00| R0: 0.0| R1: 0.0| WTP: 0,0,0.173076923,8,0,0,0,0,0,-1408009214,762053968,12269.39796,794539315.7,79453931.57,2,95458,4290,497,2038,1541,497,95458,1541,2038,339.6918239,3.062893082,12.68553459,32651.35849,1878.163522,15.80503145,98698.81761,0.328496954,0.018836603,0.000160036,0.756133464,0.021349704,23,8
D:0| T0: 0.17| T1: 8.00| R0: 0.0| R1: 0.0| WTP: 0,0,0.173076923,8,0,0,0,0,0,-1313831474,1692506311,10519.80978,787840984.3,78784098.43,2,90028,4019,938,1747,809,938,90028,809,1747,154.2600619,2.770897833,5.235294118,58414.6161,1854.28483,8.13003096,99275.15789,0.585247159,0.018641788,8.35832E-05,0.463079565,0.019405074,46,8
D:0| T0: 0.17| T1: 8.00| R0: 0.0| R1: 0.0| WTP: 0,0,0.173076923,8,0,0,0,0,0,-615459852.2,1037620300,36.0634779,613656678.3,61365667.83,1,189,3,6,6,0,6,189,0,6,0.5625,0,0,99899.99107,6.258928571,0.0625,99997.875,0.999023061,6.41604E-05,1.06197E-06,0,0.031746032,16,7
D:0| T0: 0.17| T1: 8.00| R0: 0.0| R1: 0.0| WTP: 0,0,0.173076923,8,0,0,0,0,0,-1306828362,301400999,10511.67737,781244493.2,78124449.32,2,82256,3711,967,1746,779,967,82256,779,1746,140.303681,2.831288344,5.18404908,64542.19325,1044.846626,8.141104294,99310.90798,0.647068663,0.01050593,8.36798E-05,0.446162658,0.021226673,47,8
D:0| T0: 0.17| T1: 8.00| R0: 0.0| R1: 0.0| WTP: 0,0,0.173076923,8,0,0,0,0,0,-1288085174,1868336855,10204.27459,777871444.7,77787144.47,2,79854,3439,880,1695,815,880,79854,815,1695,104.6142857,1.930952381,3.847619048,35918.11667,740.0952381,5.966666667,98686.73333,0.363020583,0.007445255,6.17163E-05,0.480825959,0.021226238,60,8
D:0| T0: 0.17| T1: 8.00| R0: 0.0| R1: 0.0| WTP: 0,0,0.173076923,8,0,0,0,0,0,-1310553208,1868498144,10684.26572,776339921.6,77633992.16,2,80531,3468,1044,1775,731,1044,80531,731,1775,98.90023202,2.285382831,3.96287703,36522.80742,778.2157773,6.368909513,98653.93735,0.369171446,0.007832492,6.5878E-05,0.411830986,0.022041202,62,8
D:0| T0: 0.17| T1: 8.00| R0: 0.0| R1: 0.0| WTP: 0,0,0.173076923,8,0,0,0,0,0,-1281355194,2101566889,10083.96462,777156963.2,77715696.32,2,79611,3511,966,1675,709,966,79611,709,1675,104.453012,2.204819277,3.877108434,61352.36145,1089.756627,6.195180723,99241.66024,0.615408358,0.010959902,6.40164E-05,0.423283582,0.021039806,60,8
D:0| T0: 0.17| T1: 8.00| R0: 0.0| R1: 0.0| WTP: 0,0,0.173076923,8,0,0,0,0,0,-1442515471,1665097450,13001.34028,792448456.7,79244845.67,2,98303,4245,438,2160,1722,438,98303,1722,2160,335.0573248,2.732484076,13.63694268,28653.10191,2147.821656,16.41401274,98558.82803,0.28833457,0.021555904,0.000166186,0.797222222,0.02197288,23,8
D:0| T0: 0.17| T1: 8.00| R0: 0.0| R1: 0.0| WTP: 0,0,0.173076923,8,0,0,0,0,0,-1357724810,1716179948,11242.80387,795584616.5,79558461.65,2,98040,4376,478,1867,1389,478,98040,1389,1867,349.6815287,2.98089172,11.75159236,31126.16561,2151.77707,14.78343949,98819.96815,0.312876334,0.021562003,0.000149784,0.74397429,0.019043248,23,8
D:0| T0: 0.17| T1: 8.00| R0: 0.0| R1: 0.0| WTP: 0,0,0.173076923,8,0,0,0,0,0,-1370143249,1560278715,11967.93992,771746253.2,77174625.32,2,75979,3099,992,1989,997,992,75979,997,1989,105.9144385,2.518716578,5.152406417,66821.8262,696.0909091,7.810160428,99187.87968,0.670559741,0.007010285,8.02754E-05,0.501509054,0.026165125,53,8
D:0| T0: 0.17| T1: 8.00| R0: 0.0| R1: 0.0| WTP: 0,0,0.173076923,8,0,0,0,0,0,-1316871856,991019385,10810.26325,776358694.1,77635869.41,2,80325,3384,724,1796,1072,724,80325,1072,1796,90.98308668,1.399577167,3.642706131,31456.36786,1006.794926,5.162790698,98520.80761,0.318415849,0.010132297,5.36631E-05,0.59688196,0.022359166,68,8
D:0| T0: 0.17| T1: 8.00| R0: 0.0| R1: 0.0| WTP: 0,0,0.173076923,8,0,0,0,0,0,-1400717655,118052103,12261.44261,787645524.3,78764552.43,2,92442,3919,1218,2037,819,1218,92442,819,2037,186.980916,4.519083969,7.572519084,49402.46565,1774.240458,12.24427481,98995.37786,0.495860096,0.017848311,0.000124975,0.402061856,0.022035438,38,8
D:0| T0: 0.17| T1: 8.00| R0: 0.0| R1: 0.0| WTP: 0,0,0.173076923,8,0,0,0,0,0,-1404632074,1209758844,12486.99001,780282573.3,78028257.33,2,88208,3609,528,2075,1547,528,88208,1547,2075,272.0783133,3.120481928,12.37349398,40039.6506,1558.945783,15.53012048,98703.66867,0.403120394,0.015650845,0.000157474,0.745542169,0.023523943,24,8
D:0| T0: 0.17| T1: 8.00| R0: 0.0| R1: 0.0| WTP: 0,0,0.173076923,8,0,0,0,0,0,-1308765855,70671723,10648.23917,776353896.1,77635389.61,2,79698,3471,1033,1769,736,1033,79698,736,1769,103.4927184,2.390776699,4.138349515,65979.31553,1189.274272,6.648058252,99299.8665,0.661496004,0.011968729,6.84424E-05,0.416054268,0.022196291,59,8
D:0| T0: 0.17| T1: 8.00| R0: 0.0| R1: 0.0| WTP: 0,0,0.173076923,8,0,0,0,0,0,-615724590.1,1722612191,42.05585974,613621797.1,61362179.71,1,154,7,7,7,0,7,154,0,7,0.339130435,0,0,99925.90435,6.269565217,0.069565217,99997.8,0.999282038,6.45706E-05,1.20693E-06,0,0.045454545,16,7
D:0| T0: 0.17| T1: 8.00| R0: 0.0| R1: 0.0| WTP: 0,0,0.173076923,8,0,0,0,0,0,-1204074828,1968291596,8635.106701,772319493.2,77231949.32,2,72334,3316,951,1434,483,951,72334,483,1434,100.6930693,2.25990099,3.433168317,70675.56683,716.7153465,5.777227723,99461.35149,0.708376578,0.007201101,5.93104E-05,0.336820084,0.019824702,58,8
D:0| T0: 0.17| T1: 8.00| R0: 0.0| R1: 0.0| WTP: 0,0,0.173076923,8,0,0,0,0,0,-1467700364,1877569084,13494.00386,793000171.2,79300017.12,2,98396,4145,476,2242,1766,476,98396,1766,2242,326.0802469,2.895061728,13.75308642,28298.09259,1940.851852,16.66666667,98508.96296,0.284748422,0.019488655,0.000168597,0.787689563,0.022785479,24,8
D:0| T0: 0.17| T1: 8.00| R0: 0.0| R1: 0.0| WTP: 0,0,0.173076923,8,0,0,0,0,0,-1455020439,1726322189,13306.75095,789682891.1,78968289.11,2,96304,4112,524,2211,1687,524,96304,1687,2211,307.5030303,3.109090909,13.26060606,31480.65455,1982.472727,16.44848485,98571.98788,0.316751669,0.019905308,0.000166567,0.763003166,0.022958548,24,8
D:0| T0: 0.17| T1: 8.00| R0: 0.0| R1: 0.0| WTP: 0,0,0.173076923,8,0,0,0,0,0,-1361209646,307848836,11498.03075,786308108.4,78630810.84,2,90244,3972,507,1910,1403,507,90244,1403,1910,283.8034682,2.849710983,10.90751445,37481.25434,1840.208092,13.83815029,98791.09827,0.37716136,0.018457259,0.000140222,0.734554974,0.021164842,25,8
D:0| T0: 0.17| T1: 8.00| R0: 0.0| R1: 0.0| WTP: 0,0,0.173076923,8,0,0,0,0,0,-1397726647,1154000220,12035.59302,795946996.1,79594699.61,2,98939,4480,439,1999,1560,439,98939,1560,1999,356.8766234,2.753246753,12.83766234,25431.02597,1673.532468,15.72077922,98620.52597,0.256197708,0.016774105,0.000158844,0.780390195,0.020204368,22,8
D:0| T0: 0.17| T1: 8.00| R0: 0.0| R1: 0.0| WTP: 0,0,0.173076923,8,0,0,0,0,0,-1273146785,2028661055,9957.273251,775283122.7,77528312.27,2,75814,3332,981,1654,673,981,75814,673,1654,114.4552846,2.528455285,4.317073171,70600.82927,1079.769648,6.98102981,99411.73171,0.707595703,0.010856334,7.18049E-05,0.406892382,0.021817127,53,8
D:0| T0: 0.17| T1: 8.00| R0: 0.0| R1: 0.0| WTP: 0,0,0.173076923,8,0,0,0,0,0,-1370229877,1629114640,11566.16335,791921709.4,79192170.94,2,92811,4161,1137,1921,784,1137,92811,784,1921,177.6130137,3.76369863,6.400684932,49791.81849,1973.565068,10.29794521,99058.84932,0.499619394,0.019851949,0.000105327,0.40812077,0.020698201,42,8
D:0| T0: 0.17| T1: 8.00| R0: 0.0| R1: 0.0| WTP: 0,0,0.173076923,8,0,0,0,0,0,-1438499592,1439048174,12952.82559,790858312,79085831.2,2,97220,4091,501,2152,1651,501,97220,1651,2152,337.1960784,3.209150327,13.96078431,33054.60784,2706.379085,17.24183007,98667.66667,0.332285716,0.02716118,0.000174111,0.767193309,0.022135363,22,8
D:0| T0: 0.17| T1: 8.00| R0: 0.0| R1: 0.0| WTP: 0,0,0.173076923,8,0,0,0,0,0,-1466741342,865227006,13487.76317,792353183.4,79235318.34,2,99171,4141,440,2241,1801,440,99171,1801,2241,253.4975845,2.062801932,10.73429952,18111.4058,1287.507246,12.87439614,98252.28502,0.182903911,0.012941058,0.000130328,0.803659081,0.022597332,30,8
D:0| T0: 0.17| T1: 8.00| R0: 0.0| R1: 0.0| WTP: 0,0,0.173076923,8,0,0,0,0,0,-1355994596,890479738,11408.03074,785593059.5,78559305.95,2,89573,3864,1276,1895,619,1276,89573,619,1895,145.8567073,3.783536585,5.612804878,37337.94817,1956.009146,9.493902439,98761.57927,0.376077592,0.019682629,9.73382E-05,0.326649077,0.021155929,47,8
D:0| T0: 0.17| T1: 8.00| R0: 0.0| R1: 0.0| WTP: 0,0,0.173076923,8,0,0,0,0,0,-1281536134,1017049163,10095.79192,776746537.7,77674653.77,2,81831,3553,844,1677,833,844,81831,833,1677,135.8018868,2.537735849,5.110062893,64799.10063,916.754717,7.751572327,99330.33962,0.649561419,0.009214766,7.96763E-05,0.496720334,0.020493456,46,8
D:0| T0: 0.17| T1: 8.00| R0: 0.0| R1: 0.0| WTP: 0,0,0.173076923,8,0,0,0,0,0,-1258263801,1707305064,9645.237466,776001928.1,77600192.81,2,76281,3371,1001,1602,601,1001,76281,601,1602,103.9294404,2.328467153,3.754257908,69584.79319,974.5206813,6.167883212,99411.80292,0.697391457,0.009799355,6.36827E-05,0.375156055,0.021001298,59,8
D:0| T0: 0.17| T1: 8.00| R0: 0.0| R1: 0.0| WTP: 0,0,0.173076923,8,0,0,0,0,0,-1467311703,400145663,13458.37785,794392810,79439281,2,99063,4296,416,2236,1820,416,99063,1820,2236,305.3125,2.301136364,12.61363636,21244.23864,1511.471591,14.97727273,98336.77273,0.214354435,0.015179205,0.000151496,0.813953488,0.022571495,26,8
D:0| T0: 0.17| T1: 8.00| R0: 0.0| R1: 0.0| WTP: 0,0,0.173076923,8,0,0,0,0,0,-1321905783,1662654181,10811.90602,781310481.7,78131048.17,2,85478,3671,787,1796,1009,787,85478,1009,1796,133.5174419,2.174418605,5.078488372,63786.90116,1015.668605,7.375,99302.13081,0.639013053,0.010214874,7.55378E-05,0.561804009,0.021011254,50,8
D:0| T0: 0.17| T1: 8.00| R0: 0.0| R1: 0.0| WTP: 0,0,0.173076923,8,0,0,0,0,0,-1415232563,182136456,12413.50839,794557144.2,79455714.42,2,98235,4374,473,2062,1589,473,98235,1589,2062,333.2037037,2.87037037,12.62345679,28120.00617,2101.364198,15.5308642,98623.17284,0.282984097,0.021080113,0.000157104,0.770611057,0.020990482,24,8
D:0| T0: 0.17| T1: 8.00| R0: 0.0| R1: 0.0| WTP: 0,0,0.173076923,8,0,0,0,0,0,-1223717592,979575387,9001.92276,773621453.8,77362145.38,2,73154,3263,1083,1495,412,1083,73154,412,1495,90.18995633,2.262008734,3.128820961,65802.30786,1077.613537,5.497816594,99346.83188,0.660059846,0.010833207,5.65843E-05,0.275585284,0.02043634,66,8
D:0| T0: 0.17| T1: 8.00| R0: 0.0| R1: 0.0| WTP: 0,0,0.173076923,8,0,0,0,0,0,-1329631409,2142525414,11062.5119,776505814.6,77650581.46,2,81897,3447,601,1838,1237,601,81897,1237,1838,194.1576577,2.612612613,8.135135135,40490.31982,1445.671171,10.84684685,98757.80631,0.408219224,0.014518166,0.000110388,0.673014146,0.022443099,32,8
D:0| T0: 0.17| T1: 8.00| R0: 0.0| R1: 0.0| WTP: 0,0,0.173076923,8,0,0,0,0,0,-1352146833,1464057597,11294.50799,787421434,78742143.4,2,89475,3907,1227,1876,649,1227,89475,649,1876,177.7934783,4.307971014,6.597826087,49204.73551,1212.467391,11.07971014,99015.89493,0.494209255,0.012193811,0.000113033,0.345948827,0.02096675,40,8
D:0| T0: 0.17| T1: 8.00| R0: 0.0| R1: 0.0| WTP: 0,0,0.173076923,8,0,0,0,0,0,-1360928152,364562610,11580.68706,781893799.1,78189379.91,2,87962,3757,530,1924,1394,530,87962,1394,1924,243.8894737,2.715789474,10.01578947,36854.39474,1565.394737,12.82105263,98723.11579,0.371271348,0.015708572,0.00012971,0.724532225,0.021873082,28,8
D:0| T0: 0.17| T1: 8.00| R0: 0.0| R1: 0.0| WTP: 0,0,0.173076923,8,0,0,0,0,0,-1300328126,40350784,10527.21896,773967177.7,77396717.77,2,78005,3309,626,1749,1123,626,78005,1123,1749,183.5242291,2.629955947,7.533039648,43539.64317,1327.722467,10.30396476,98818.79295,0.439029758,0.013327977,0.000105097,0.642081189,0.022421927,33,8
D:0| T0: 0.17| T1: 8.00| R0: 0.0| R1: 0.0| WTP: 0,0,0.173076923,8,0,0,0,0,0,-1285237621,804064356,9890.016702,790736785.6,79073678.56,2,89269,4117,438,1642,1204,438,89269,1204,1642,318.847561,2.597560976,9.902439024,39256.78049,1576.256098,12.56097561,98977.29878,0.394780323,0.015784575,0.000127077,0.733252132,0.018393843,24,8
D:0| T0: 0.17| T1: 8.00| R0: 0.0| R1: 0.0| WTP: 0,0,0.173076923,8,0,0,0,0,0,-1285476462,2125493986,10221.30143,774411390.7,77441139.07,2,75847,3264,1175,1698,523,1175,75847,523,1698,104.6565657,2.805555556,4.108585859,51155.92677,605.3888889,7.060606061,98932.44192,0.515947292,0.006092234,7.30203E-05,0.308009423,0.022387174,57,8
D:0| T0: 0.17| T1: 8.00| R0: 0.0| R1: 0.0| WTP: 0,0,0.173076923,8,0,0,0,0,0,-1147989340,23154253,7529.708658,771503907.3,77150390.73,2,69512,3168,524,1250,726,524,69512,726,1250,132.579288,1.601941748,3.928802589,43963.26537,599.3656958,5.644012945,99031.87055,0.443400658,0.00601021,5.7582E-05,0.5808,0.017982507,45,8
D:0| T0: 0.17| T1: 8.00| R0: 0.0| R1: 0.0| WTP: 0,0,0.173076923,8,0,0,0,0,0,-1254652328,1391367689,9661.74226,771565214.6,77156521.46,2,74785,3245,899,1605,706,899,74785,706,1605,120.4414414,2.51951952,4.603603604,69673.25526,755.957958,7.321321321,99396.58258,0.698518094,0.007598144,7.55643E-05,0.439875389,0.021461523,48,8
D:0| T0: 0.17| T1: 8.00| R0: 0.0| R1: 0.0| WTP: 0,0,0.173076923,8,0,0,0,0,0,-1352799910,574142276,11353.73073,785113372.9,78511337.29,2,88116,3841,1036,1886,850,1036,88116,850,1886,158.4072848,3.314569536,6.092715232,53896.24834,1344.877483,9.513245033,99080.76821,0.54094159,0.013528524,9.73002E-05,0.45068929,0.021403604,44,8
D:0| T0: 0.17| T1: 8.00| R0: 0.0| R1: 0.0| WTP: 0,0,0.173076923,8,0,0,0,0,0,-701611202.7,898736779,6.039854375,701309210,70130921,1,92,4,1,1,0,1,92,0,1,0.578947368,0,0,99953.01754,5.789473684,0.00877193,99999.17544,0.999539648,5.9218E-05,1.73913E-07,0,0.010869565,17,8
D:0| T0: 0.17| T1: 8.00| R0: 0.0| R1: 0.0| WTP: 0,0,0.173076923,8,0,0,0,0,0,-1294636217,346473503,9922.846768,798493878.3,79849387.83,2,92602,4401,1152,1647,495,1152,92602,495,1647,188.8791946,3.744966443,5.359060403,43141.42953,1769.020134,9.224832215,99065.12416,0.43337036,0.017772404,9.43722E-05,0.300546448,0.017785793,43,8
D:0| T0: 0.17| T1: 8.00| R0: 0.0| R1: 0.0| WTP: 0,0,0.173076923,8,0,0,0,0,0,-1366275169,445552282,11553.13799,788618269.3,78861826.93,2,89382,4050,1299,1919,620,1299,89382,620,1919,162.1862745,4.120915033,6.08496732,49453.1732,1664.392157,10.34313725,98988.75163,0.496973386,0.016749037,0.000105813,0.32308494,0.021469647,43,8
D:0| T0: 0.17| T1: 8.00| R0: 0.0| R1: 0.0| WTP: 0,0,0.173076923,8,0,0,0,0,0,-1395412573,911758476,11946.23269,798100938.1,79810093.81,2,99146,4479,437,1984,1547,437,99146,1547,1984,396.7676056,2.985915493,13.83098592,27636.58451,1954.535211,16.9084507,98686.9507,0.278200211,0.019581078,0.000170959,0.779737903,0.020010893,21,8
D:0| T0: 0.17| T1: 8.00| R0: 0.0| R1: 0.0| WTP: 0,0,0.173076923,8,0,0,0,0,0,-1352925258,1464197940,11111.30681,797359917.5,79735991.75,2,94007,4383,552,1845,1293,552,94007,1293,1845,294.5578947,2.831578947,9.6,31993.01579,2886.889474,12.47894737,98781.97368,0.321905698,0.028964417,0.00012665,0.700813008,0.019626198,28,8
D:0| T0: 0.17| T1: 8.00| R0: 0.0| R1: 0.0| WTP: 0,0,0.173076923,8,0,0,0,0,0,-1340658739,500405854,11196.21985,780847746.2,78084774.62,2,84278,3589,1076,1860,784,1076,84278,784,1860,146.0096774,3.3,5.8,58641.93226,1105.054839,9.3,99150.59355,0.588683565,0.011116078,9.52457E-05,0.421505376,0.022069817,45,8
D:0| T0: 0.17| T1: 8.00| R0: 0.0| R1: 0.0| WTP: 0,0,0.173076923,8,0,0,0,0,0,-1390873145,772037341,12110.26047,785360121.3,78536012.13,2,92766,3897,464,2012,1548,464,92766,1548,2012,293.5333333,2.739393939,12.06666667,35320.81818,1842.612121,14.87272727,98710.27879,0.355418127,0.018482671,0.000150624,0.769383698,0.021688981,24,8
D:0| T0: 0.17| T1: 8.00| R0: 0.0| R1: 0.0| WTP: 0,0,0.173076923,8,0,0,0,0,0,-1207508025,1543158763,8772.146442,768900703.2,76890070.32,2,68849,3102,1010,1457,447,1010,68849,447,1457,93.95609756,2.343902439,3.409756098,72175.26098,814.4512195,5.865853659,99445.15122,0.723685997,0.008186669,6.04608E-05,0.306794784,0.021162254,59,8
D:0| T0: 0.17| T1: 8.00| R0: 0.0| R1: 0.0| WTP: 0,0,0.173076923,8,0,0,0,0,0,-1482120642,1604932531,13782.2358,793008851.5,79300885.15,2,98721,4189,442,2290,1848,442,98721,1848,2290,361.6438356,2.938356164,15.55479452,28998.41781,1995.582192,18.5890411,98497.54795,0.291808024,0.020024328,0.000187945,0.8069869,0.023196686,21,8
D:0| T0: 0.17| T1: 8.00| R0: 0.0| R1: 0.0| WTP: 0,0,0.173076923,8,0,0,0,0,0,-1328616654,539051477,10908.61226,783186040.8,78318604.08,2,82722,3663,795,1812,1017,795,82722,1017,1812,115.7542998,1.832923833,4.302211302,31671.62899,1166.963145,6.255528256,98562.24816,0.320242906,0.011743525,6.45067E-05,0.561258278,0.021904693,59,8
D:0| T0: 0.17| T1: 8.00| R0: 0.0| R1: 0.0| WTP: 0,0,0.173076923,8,0,0,0,0,0,-709144767.1,1743124675,144.3604116,701926746.5,70192674.65,2,733,30,24,24,0,24,733,0,24,2.662420382,0.057324841,0.057324841,99529.2293,15.29299363,0.21656051,99986.01911,0.99543861,0.000153751,3.03832E-06,0,0.032742156,23,8
D:0| T0: 0.17| T1: 8.00| R0: 0.0| R1: 0.0| WTP: 0,0,0.173076923,8,0,0,0,0,0,-1383877944,1965983789,11978.20491,784967698.7,78496769.87,2,89069,3788,953,1990,1037,953,89069,1037,1990,144.2537764,2.740181269,5.836858006,54168.83988,1573.193353,8.725075529,99050.32326,0.543286087,0.015840214,8.95135E-05,0.521105528,0.022342229,48,8
D:0| T0: 0.17| T1: 8.00| R0: 0.0| R1: 0.0| WTP: 0,0,0.173076923,8,0,0,0,0,0,-1337355118,516774280,11094.64714,782622760.9,78262276.09,2,86406,3769,983,1843,860,983,86406,860,1843,125.8726287,2.531165312,4.826558266,57298.73171,1515.802168,7.501355014,99156.31165,0.57467639,0.015253022,7.70686E-05,0.466630494,0.021329784,52,8
D:0| T0: 0.17| T1: 8.00| R0: 0.0| R1: 0.0| WTP: 0,0,0.173076923,8,0,0,0,0,0,-1420212964,86603142,12497.83911,795321008.9,79532100.89,2,98877,4264,422,2076,1654,422,98877,1654,2076,296.4565217,2.239130435,11.19565217,20627.42391,1394.456522,13.48913043,98429.9837,0.20817992,0.013998365,0.000136404,0.79672447,0.020995783,27,8
D:0| T0: 0.17| T1: 8.00| R0: 0.0| R1: 0.0| WTP: 0,0,0.173076923,8,0,0,0,0,0,-1290300844,1431870609,10163.64362,782118663.6,78211866.36,2,83171,3776,955,1688,733,955,83171,733,1688,119.4664948,2.358247423,4.216494845,65646.53608,1497.381443,6.670103093,99366.78608,0.657667578,0.015057595,6.85168E-05,0.434241706,0.020295536,56,8
D:0| T0: 0.17| T1: 8.00| R0: 0.0| R1: 0.0| WTP: 0,0,0.173076923,8,0,0,0,0,0,-1303355104,1592383984,10439.79067,781365570.4,78136557.04,2,82655,3664,1256,1734,478,1256,82655,478,1734,164.2166065,4.400722022,6.083032491,53024.00722,875.400722,10.59927798,99082.23105,0.533187823,0.008798828,0.000108487,0.275663206,0.020979275,40,8
D:0| T0: 0.17| T1: 8.00| R0: 0.0| R1: 0.0| WTP: 0,0,0.173076923,8,0,0,0,0,0,-1299269098,1440183867,10202.01299,789168448.2,78916844.82,2,87156,3997,1024,1694,670,1024,87156,670,1694,165.4771242,3.215686275,5.369281046,54992,1377.408497,8.68627451,99192.92157,0.551723961,0.013843758,8.92592E-05,0.395513577,0.019436413,44,8
D:0| T0: 0.17| T1: 8.00| R0: 0.0| R1: 0.0| WTP: 0,0,0.173076923,8,0,0,0,0,0,-1363459608,1696510588,11581.5758,784380817.6,78438081.76,2,90898,3885,794,1924,1130,794,90898,1130,1924,156.5953947,2.486842105,6.161184211,57941.17434,1410.325658,8.773026316,99185.43421,0.580448652,0.01418616,8.99629E-05,0.587318087,0.021166582,44,8
D:0| T0: 0.17| T1: 8.00| R0: 0.0| R1: 0.0| WTP: 0,0,0.173076923,8,0,0,0,0,0,-1336223415,895039877,11076.44251,782401290,78240129,2,85214,3679,589,1840,1251,589,85214,1251,1840,209.6143498,2.573991031,8.125560538,36252.93274,2003.757848,10.74887892,98731.07175,0.365521443,0.020116393,0.000109439,0.679891304,0.021592696,32,8
D:0| T0: 0.17| T1: 8.00| R0: 0.0| R1: 0.0| WTP: 0,0,0.173076923,8,0,0,0,0,0,-1399856571,129565953,12272.96916,786208112.7,78620811.27,2,89241,3819,1175,2039,864,1175,89241,864,2039,135.7295775,3.185915493,5.58028169,51291.94085,1772.923944,8.878873239,98964.94648,0.514937571,0.017858738,9.11742E-05,0.423737126,0.022848242,50,8
D:0| T0: 0.17| T1: 8.00| R0: 0.0| R1: 0.0| WTP: 0,0,0.173076923,8,0,0,0,0,0,-1303003109,1902565669,10362.63271,784871473.6,78487147.36,2,87504,3926,769,1721,952,769,87504,952,1721,159.6357616,2.420529801,5.533112583,61354.76821,1113.129139,8.069536424,99302.46689,0.614670569,0.011187176,8.28718E-05,0.553166764,0.019667672,44,8
D:0| T0: 0.17| T1: 8.00| R0: 0.0| R1: 0.0| WTP: 0,0,0.173076923,8,0,0,0,0,0,-1352031490,1984179288,11430.28246,780517367.3,78051736.73,2,84443,3695,1060,1899,839,1060,84443,839,1899,117.7879581,2.62565445,4.777486911,62376.14921,1662.332461,7.581151832,99225.00262,0.625326321,0.01673662,7.79879E-05,0.44181148,0.022488543,55,8
D:0| T0: 0.17| T1: 8.00| R0: 0.0| R1: 0.0| WTP: 0,0,0.173076923,8,0,0,0,0,0,-1380976967,677377223,11847.43703,788605115.2,78860511.52,2,92236,3896,1325,1968,643,1325,92236,643,1968,166.956229,4.316498316,6.437710438,47155.88215,2524.356902,10.91582492,98971.18182,0.47350995,0.025406528,0.000111565,0.326727642,0.021336571,42,8
D:0| T0: 0.17| T1: 8.00| R0: 0.0| R1: 0.0| WTP: 0,0,0.173076923,8,0,0,0,0,0,-1382033265,973583301,11723.50486,795858022.6,79585802.26,2,94902,4346,964,1947,983,964,94902,983,1947,175.6677419,2.983870968,6.106451613,47630.49355,2489.164516,9.216129032,99017.84194,0.477502975,0.025045356,9.44847E-05,0.504879301,0.020515901,45,8
D:0| T0: 0.17| T1: 8.00| R0: 0.0| R1: 0.0| WTP: 0,0,0.173076923,8,0,0,0,0,0,-1285382540,781062938,9860.71543,792346768.8,79234676.88,2,88843,4185,1012,1637,625,1012,88843,625,1637,180.4452055,3.29109589,5.400684932,56172.63356,1407.684932,8.883561644,99264.76027,0.563347087,0.014141213,9.11213E-05,0.381795968,0.018425762,42,8
D:0| T0: 0.17| T1: 8.00| R0: 0.0| R1: 0.0| WTP: 0,0,0.173076923,8,0,0,0,0,0,-1382448059,338783425,11753.16574,794789771.4,79478977.14,2,94944,4259,906,1952,1046,906,94944,1046,1952,179.0166113,2.870431894,6.295681063,55124.78738,2575.651163,9.292358804,99181.51495,0.551996151,0.025915573,9.5555E-05,0.535860656,0.020559488,43,8
D:0| T0: 0.17| T1: 8.00| R0: 0.0| R1: 0.0| WTP: 0,0,0.173076923,8,0,0,0,0,0,-1323803077,1027579040,10800.75985,783765084.5,78376508.45,2,84406,3909,1021,1794,773,1021,84406,773,1794,106.6085973,2.221719457,3.929864253,59754.9457,1437.294118,6.233031674,99202.35973,0.599118125,0.014467756,6.41133E-05,0.430880713,0.021254413,63,8
D:0| T0: 0.17| T1: 8.00| R0: 0.0| R1: 0.0| WTP: 0,0,0.173076923,8,0,0,0,0,0,-1399438537,764973813,12166.42,791117536.7,79111753.67,2,92263,4073,1073,2021,948,1073,92263,948,2021,171.6789298,3.451505017,6.578595318,53702.99666,2099.535117,10.1638796,99074.09365,0.538577316,0.021134459,0.000104128,0.469074715,0.021904772,42,8
D:0| T0: 0.17| T1: 8.00| R0: 0.0| R1: 0.0| WTP: 0,0,0.173076923,8,0,0,0,0,0,-1409390338,1245753446,12311.49312,793815681.7,79381568.17,2,94453,4174,1210,2045,835,1210,94453,835,2045,187.8505338,4.185053381,7.113879004,45922.72242,2297.996441,11.40569395,98926.95374,0.461250833,0.023130537,0.00011658,0.408312958,0.02165098,41,8
D:0| T0: 0.17| T1: 8.00| R0: 0.0| R1: 0.0| WTP: 0,0,0.173076923,8,0,0,0,0,0,-1356838324,1013177794,11449.65007,784355820.3,78435582.03,2,85438,3711,1203,1902,699,1203,85438,699,1902,163.9236111,4.024305556,6.402777778,55762.80556,1241.746528,10.59375,99088.27778,0.560248127,0.01249051,0.000108432,0.367507886,0.022261757,42,8
D:0| T0: 0.17| T1: 8.00| R0: 0.0| R1: 0.0| WTP: 0,0,0.173076923,8,0,0,0,0,0,-1244872239,1395089249,9493.256766,770209400.9,77020940.09,2,71780,3054,1060,1577,517,1060,71780,517,1577,92.97624703,2.403800475,3.600950119,71139.27078,892.1852732,6.123515439,99417.98812,0.713235499,0.008970599,6.29796E-05,0.327837666,0.021969908,61,8
D:0| T0: 0.17| T1: 8.00| R0: 0.0| R1: 0.0| WTP: 0,0,0.173076923,8,0,0,0,0,0,-438852878.3,1339545835,12.01008238,438252374.2,43825237.42,1,66,0,2,2,0,2,66,0,2,0,0,0,99962.31579,4.557894737,0.021052632,99998.72632,0.99963791,4.76049E-05,4.16669E-07,0,0.03030303,14,5
D:0| T0: 0.17| T1: 8.00| R0: 0.0| R1: 0.0| WTP: 0,0,0.173076923,8,0,0,0,0,0,-1365557299,219139554,11410.78146,795018226,79501822.6,2,95408,4273,467,1895,1428,467,95408,1428,1895,366.147651,3.060402685,12.57718121,32898,1681.52349,15.7114094,98779.59732,0.331041421,0.016848896,0.000158928,0.753562005,0.019862066,22,8
D:0| T0: 0.17| T1: 8.00| R0: 0.0| R1: 0.0| WTP: 0,0,0.173076923,8,0,0,0,0,0,-1292850258,1336508942,10329.8913,776355692.3,77635569.23,2,81305,3493,876,1716,840,876,81305,840,1716,130.7347561,2.533536585,5.06402439,63258.68902,1002.939024,7.74695122,99286.24085,0.634248085,0.010082003,7.94563E-05,0.48951049,0.021105713,47,8
D:0| T0: 0.17| T1: 8.00| R0: 0.0| R1: 0.0| WTP: 0,0,0.173076923,8,0,0,0,0,0,-703999557.1,448559423,54.07595311,701295759.4,70129575.94,1,162,4,9,9,0,9,162,0,9,0.434782609,0.017391304,0.017391304,99910.31304,10.29565217,0.095652174,99997.29565,0.999132373,0.000104226,1.55178E-06,0,0.055555556,17,8
D:0| T0: 0.17| T1: 8.00| R0: 0.0| R1: 0.0| WTP: 0,0,0.173076923,8,0,0,0,0,0,-1339448470,2110028840,10988.9281,790002064.4,79000206.44,2,90927,4088,922,1825,903,922,90927,903,1825,161.1324921,2.769716088,5.58044164,54667.26183,1403.425868,8.488958991,99163.29338,0.548035135,0.014113669,8.71512E-05,0.494794521,0.020071046,46,8
D:0| T0: 0.17| T1: 8.00| R0: 0.0| R1: 0.0| WTP: 0,0,0.173076923,8,0,0,0,0,0,-1453196870,1982030155,13412.72908,782560416.3,78256041.63,2,91711,3645,986,2229,1243,986,91711,1243,2229,150.003268,3.091503268,7.098039216,55054.84314,1984.660131,10.32679739,99001.21569,0.551971728,0.019999785,0.000105869,0.55764917,0.024304609,44,8
D:0| T0: 0.17| T1: 8.00| R0: 0.0| R1: 0.0| WTP: 0,0,0.173076923,8,0,0,0,0,0,-1392362472,696219407,12205.53409,782085767.7,78208576.77,2,86535,3658,1088,2028,940,1088,86535,940,2028,150,3.432786885,6.472131148,51356.44262,939.7016393,10.06229508,98922.07541,0.516040698,0.00946103,0.000102807,0.463510848,0.023435604,44,8
D:0| T0: 0.17| T1: 8.00| R0: 0.0| R1: 0.0| WTP: 0,0,0.173076923,8,0,0,0,0,0,-1291397020,1402539442,10134.32199,784680920.2,78468092.02,2,84757,3795,554,1683,1129,554,84757,1129,1683,194.3975904,2.148594378,6.65060241,34960.54618,1559.012048,8.859437751,98784.21687,0.352516388,0.015650055,9.02421E-05,0.670825906,0.019856767,36,8
D:0| T0: 0.17| T1: 8.00| R0: 0.0| R1: 0.0| WTP: 0,0,0.173076923,8,0,0,0,0,0,-1301622567,1319833493,10415.337,780855716.6,78085571.66,2,83152,3726,633,1730,1097,633,83152,1097,1730,157.6254296,2.082474227,5.824742268,33990.50172,1929.247423,7.996563574,98703.57045,0.343130311,0.019384757,8.16358E-05,0.634104046,0.020805522,42,8
D:0| T0: 0.17| T1: 8.00| R0: 0.0| R1: 0.0| WTP: 0,0,0.173076923,8,0,0,0,0,0,-1351006078,663608076,11317.64441,785123857.8,78512385.78,2,87657,3854,935,1880,945,935,87657,945,1880,147.2331288,2.733128834,5.573619632,58159.63804,1614.733129,8.432515337,99175.96626,0.583114143,0.016244332,8.68813E-05,0.502927089,0.021435824,47,8
D:0| T0: 0.17| T1: 8.00| R0: 0.0| R1: 0.0| WTP: 0,0,0.173076923,8,0,0,0,0,0,-1303875964,414696500,10528.48706,777451611.1,77745161.11,2,80996,3538,1007,1749,742,1007,80996,742,1749,104.6763285,2.347826087,4.106280193,63733.07971,1347.905797,6.528985507,99267.95894,0.638991747,0.013565806,6.69878E-05,0.424242424,0.021593659,59,8
D:0| T0: 0.17| T1: 8.00| R0: 0.0| R1: 0.0| WTP: 0,0,0.173076923,8,0,0,0,0,0,-1282232603,1249738535,10249.78607,769743299.6,76974329.96,2,71375,3037,1084,1703,619,1084,71375,619,1703,91.83135392,2.451306413,3.888361045,67682.50594,676.8171021,6.448931116,99275.76722,0.679238809,0.006810595,6.66057E-05,0.363476218,0.023859895,61,8
D:0| T0: 0.17| T1: 8.00| R0: 0.0| R1: 0.0| WTP: 0,0,0.173076923,8,0,0,0,0,0,-1332176570,614415382,11128.47722,775752708.9,77575270.89,2,81026,3374,1008,1849,841,1008,81026,841,1849,118.2464986,2.691876751,5,63161.92437,1439.036415,7.840336134,99223.85434,0.633432357,0.014482644,8.05393E-05,0.454840454,0.022819836,51,8
D:0| T0: 0.17| T1: 8.00| R0: 0.0| R1: 0.0| WTP: 0,0,0.173076923,8,0,0,0,0,0,-1167260485,524899953,7914.233538,771548807.8,77154880.78,2,73924,3224,998,1314,316,998,73924,316,1314,84.97473684,1.997894737,2.642105263,68739.51579,895.6252632,4.738947368,99480.65895,0.688912959,0.008997522,4.8888E-05,0.240487062,0.017775012,68,8
D:0| T0: 0.17| T1: 8.00| R0: 0.0| R1: 0.0| WTP: 0,0,0.173076923,8,0,0,0,0,0,-1430277334,1338977757,12660.58602,797248032.8,79724803.28,2,98967,4419,403,2103,1700,403,98967,1700,2103,361.6623377,2.545454545,13.53896104,26152.23377,1689.824675,16.16233766,98549.27273,0.263361216,0.016945494,0.000163349,0.808368997,0.021249507,22,8
D:0| T0: 0.17| T1: 8.00| R0: 0.0| R1: 0.0| WTP: 0,0,0.173076923,8,0,0,0,0,0,-1294922284,341384587,10377.73146,776035711.3,77603571.13,2,78976,3374,518,1724,1206,518,78976,1206,1724,174.388664,2.04048583,6.886639676,38125.87449,1083.40081,8.983805668,98719.35223,0.384997181,0.010875621,9.11684E-05,0.699535963,0.021829417,36,8
D:0| T0: 0.17| T1: 8.00| R0: 0.0| R1: 0.0| WTP: 0,0,0.173076923,8,0,0,0,0,0,-1397942621,2032000160,12219.09303,786987969.6,78698796.96,2,91020,3934,1014,2030,1016,1014,91020,1016,2030,156.5128205,3.121794872,6.326923077,51491.61859,1969.083333,9.570512821,99006.5641,0.516580975,0.01982221,9.82116E-05,0.500492611,0.022302791,45,8
D:0| T0: 0.17| T1: 8.00| R0: 0.0| R1: 0.0| WTP: 0,0,0.173076923,8,0,0,0,0,0,-1281808157,779488939,10107.61805,776427254.7,77642725.47,2,79127,3427,630,1679,1049,630,79127,1049,1679,100.5081206,1.3387471,3.742459397,33299.24362,697.0440835,5.204176334,98629.80974,0.336756016,0.00700993,5.39135E-05,0.624776653,0.021219321,62,8
D:0| T0: 0.17| T1: 8.00| R0: 0.0| R1: 0.0| WTP: 0,0,0.173076923,8,0,0,0,0,0,-1355504813,1449019578,11525.92121,779208752.1,77920875.21,2,86583,3631,979,1915,936,979,86583,936,1915,125.3342776,2.637393768,5.252124646,58618.6289,1531.223796,8.065155807,99148.08782,0.587813558,0.015415041,8.25231E-05,0.488772846,0.022117506,50,8
D:0| T0: 0.17| T1: 8.00| R0: 0.0| R1: 0.0| WTP: 0,0,0.173076923,8,0,0,0,0,0,-1178346545,351952211,8083.214491,774185820.5,77418582.05,2,71025,3361,944,1342,398,944,71025,398,1342,98.36299766,2.103044496,3.004683841,72081.44262,736.6112412,5.229508197,99507.57845,0.722361531,0.007399556,5.37659E-05,0.29657228,0.018894755,61,8
D:0| T0: 0.17| T1: 8.00| R0: 0.0| R1: 0.0| WTP: 0,0,0.173076923,8,0,0,0,0,0,-1316484334,486595046,10662.56048,783356310.1,78335631.01,2,83542,3722,1084,1771,687,1084,83542,687,1771,105.1591928,2.329596413,3.83632287,63218.64126,1548.46861,6.282511211,99280.34978,0.633628631,0.015586947,6.44337E-05,0.387916431,0.021198918,62,8
D:0| T0: 0.17| T1: 8.00| R0: 0.0| R1: 0.0| WTP: 0,0,0.173076923,8,0,0,0,0,0,-1337085653,296745624,11065.10981,783830162.2,78383016.22,2,87154,3774,1204,1838,634,1204,87154,634,1838,151.9773463,3.731391586,5.721682848,47582.15534,1387.090615,9.631067961,98959.30421,0.478882135,0.013954119,9.90546E-05,0.344940152,0.021089107,45,8
D:0| T0: 0.17| T1: 8.00| R0: 0.0| R1: 0.0| WTP: 0,0,0.173076923,8,0,0,0,0,0,-1289594416,1671484194,10198.88747,779650042.9,77965004.29,2,79250,3534,939,1694,755,939,79250,755,1694,124.7555556,2.475,4.541666667,62385.60278,1134.436111,7.15,99255.93889,0.625792004,0.011404659,7.35464E-05,0.445690673,0.021375394,52,8
D:0| T0: 0.17| T1: 8.00| R0: 0.0| R1: 0.0| WTP: 0,0,0.173076923,8,0,0,0,0,0,-1388978732,422157396,11879.18551,795019456.5,79501945.65,2,98334,4369,476,1973,1497,476,98334,1497,1973,303.9050279,2.592178771,10.92178771,26113.46927,2049.960894,13.58100559,98631.15642,0.262861855,0.020571472,0.000137384,0.758743031,0.020064271,26,8
D:0| T0: 0.17| T1: 8.00| R0: 0.0| R1: 0.0| WTP: 0,0,0.173076923,8,0,0,0,0,0,-1437521991,1916599091,12816.58979,796692501.8,79669250.18,2,98431,4258,447,2129,1682,447,98431,1682,2129,350.1329114,2.753164557,13.34810127,27640.51899,2168.949367,16.1835443,98569.12025,0.278220405,0.021755487,0.000163717,0.790042273,0.021629365,23,8
D:0| T0: 0.17| T1: 8.00| R0: 0.0| R1: 0.0| WTP: 0,0,0.173076923,8,0,0,0,0,0,-1408062500,1005953941,12216.25195,797249902.8,79724990.28,2,98343,4312,495,2029,1534,495,98343,1534,2029,371.5066667,3.246666667,13.41333333,30575.94,2654.64,16.7,98716.4,0.307466832,0.026611075,0.000168826,0.756037457,0.02063187,22,8
D:0| T0: 0.17| T1: 8.00| R0: 0.0| R1: 0.0| WTP: 0,0,0.173076923,8,0,0,0,0,0,-1396432747,1422765615,12247.99163,784033165.9,78403316.59,2,88893,3790,549,2035,1486,549,88893,1486,2035,276.255814,3.087209302,11.6627907,38007.40116,1792.55814,14.89534884,98711.13372,0.382723033,0.017993531,0.000150874,0.73022113,0.022892949,25,8
D:0| T0: 0.17| T1: 8.00| R0: 0.0| R1: 0.0| WTP: 0,0,0.173076923,8,0,0,0,0,0,-1222054247,699740192,9125.516578,765778417.8,76577841.78,2,67729,2899,1152,1516,364,1152,67729,364,1516,72.62075848,2.19760479,2.892215569,70339.46307,808.5988024,5.189620758,99374.96208,0.705679632,0.008132393,5.35504E-05,0.240105541,0.022383322,72,8
D:0| T0: 0.17| T1: 8.00| R0: 0.0| R1: 0.0| WTP: 0,0,0.173076923,8,0,0,0,0,0,-1205115166,240885764,8700.515624,770089384.9,77008938.49,2,70016,3111,1082,1445,363,1082,70016,363,1445,76.97642436,2.047151277,2.740667976,72291.48723,835.3791749,4.860510806,99466.73281,0.7246547,0.008397786,4.99043E-05,0.251211073,0.020638435,73,8
D:0| T0: 0.17| T1: 8.00| R0: 0.0| R1: 0.0| WTP: 0,0,0.173076923,8,0,0,0,0,0,-1215900674,2023806564,8827.883085,774506519.8,77450651.98,2,75828,3422,804,1466,662,804,75828,662,1466,74.25834798,1.267135325,2.416520211,35392.92794,559.3655536,3.820738137,98787.71705,0.357820265,0.005624929,4.0131E-05,0.451568895,0.019333228,82,8
D:0| T0: 0.17| T1: 8.00| R0: 0.0| R1: 0.0| WTP: 0,0,0.173076923,8,0,0,0,0,0,-1234015382,1907493879,9241.539611,771938401.8,77193840.18,2,76829,3225,998,1535,537,998,76829,537,1535,97.63196126,2.283292978,3.544794189,66257.91283,1157.878935,5.958837772,99369.62228,0.664300116,0.011640234,6.16516E-05,0.349837134,0.019979435,58,8
D:0| T0: 0.17| T1: 8.00| R0: 0.0| R1: 0.0| WTP: 0,0,0.173076923,8,0,0,0,0,0,-1421881260,1565815291,12729.04605,785428957.5,78542895.75,2,92542,3849,1008,2115,1107,1008,92542,1107,2115,155.5798046,3.149837134,6.726384365,51738.52769,2426.889251,10.00651466,98998.21824,0.518792096,0.02443782,0.000102446,0.523404255,0.022854488,44,8
D:0| T0: 0.17| T1: 8.00| R0: 0.0| R1: 0.0| WTP: 0,0,0.173076923,8,0,0,0,0,0,-1185146411,784442364,8309.977317,769647545.1,76964754.51,2,71001,3171,1064,1380,316,1064,71001,316,1380,96.16502463,2.460591133,3.219211823,68374.92611,930.3054187,5.834975369,99423.04187,0.685769848,0.009345757,6.04585E-05,0.228985507,0.019436346,57,8
D:0| T0: 0.17| T1: 8.00| R0: 0.0| R1: 0.0| WTP: 0,0,0.173076923,8,0,0,0,0,0,-1240325421,206369745,9278.8521,776382816.5,77638281.65,2,77652,3471,559,1541,982,559,77652,982,1541,154.7580071,1.896797153,5.359430605,39124.01779,1152.871886,7.355871886,98850.92883,0.394759414,0.0115727,7.50489E-05,0.63724854,0.019844949,41,8
D:0| T0: 0.17| T1: 8.00| R0: 0.0| R1: 0.0| WTP: 0,0,0.173076923,8,0,0,0,0,0,-1381108805,2087235992,11811.711,790523254.7,79052325.47,2,94452,4082,555,1962,1407,555,94452,1407,1962,281.9617486,2.950819672,10.56830601,32277.26776,2247.103825,13.6010929,98728.57923,0.324754691,0.022545695,0.000138132,0.717125382,0.020772456,27,8
D:0| T0: 0.17| T1: 8.00| R0: 0.0| R1: 0.0| WTP: 0,0,0.173076923,8,0,0,0,0,0,-1354948889,1019092536,11330.72731,788412523.4,78841252.34,2,89966,4026,929,1882,953,929,89966,953,1882,161.7799353,2.893203883,5.938511327,56880.94175,1596.977346,8.902912621,99181.77346,0.570134643,0.016064211,9.15141E-05,0.506376196,0.020919014,45,8
D:0| T0: 0.17| T1: 8.00| R0: 0.0| R1: 0.0| WTP: 0,0,0.173076923,8,0,0,0,0,0,-1300942204,1885906113,10509.92438,775445984.8,77544598.48,2,78521,3363,1231,1746,515,1231,78521,515,1746,146.451049,4.160839161,5.905594406,59175.58042,839.6048951,10.19230769,99159.88811,0.594676182,0.008440123,0.000104611,0.294959908,0.022236939,41,8
D:0| T0: 0.17| T1: 8.00| R0: 0.0| R1: 0.0| WTP: 0,0,0.173076923,8,0,0,0,0,0,-1270996370,2028637200,9755.631205,783214809.6,78321480.96,2,83264,3834,971,1620,649,971,83264,649,1620,148.172956,2.899371069,4.902515723,62562.69182,1009.084906,7.93081761,99326.27673,0.62744151,0.01014041,8.18581E-05,0.400617284,0.019456188,46,8
D:0| T0: 0.17| T1: 8.00| R0: 0.0| R1: 0.0| WTP: 0,0,0.173076923,8,0,0,0,0,0,-1318102914,181476086,10727.84923,781710452.3,78171045.23,2,86838,3828,540,1782,1242,540,86838,1242,1782,189.3510204,2.134693878,7.159183673,33079.46531,1661.204082,9.367346939,98709.01633,0.333592584,0.016683779,9.52359E-05,0.696969697,0.02052097,35,8
D:0| T0: 0.17| T1: 8.00| R0: 0.0| R1: 0.0| WTP: 0,0,0.173076923,8,0,0,0,0,0,-1327015625,2097578470,10843.02562,784864344,78486434.4,2,85777,3818,584,1801,1217,584,85777,1217,1801,188.703125,2.21875,6.93359375,32977.40234,1814.421875,9.203125,98677.24219,0.332766289,0.018226151,9.36363E-05,0.675735702,0.020996304,37,8
D:0| T0: 0.17| T1: 8.00| R0: 0.0| R1: 0.0| WTP: 0,0,0.173076923,8,0,0,0,0,0,-1386262652,119646392,12079.41915,782291694.2,78229169.42,2,87823,3738,946,2007,1061,946,87823,1061,2007,138.6686747,2.740963855,5.897590361,56128.70482,1679.322289,8.722891566,99068.00904,0.562947307,0.016911366,8.95465E-05,0.528649726,0.022852783,48,8
D:0| T0: 0.17| T1: 8.00| R0: 0.0| R1: 0.0| WTP: 0,0,0.173076923,8,0,0,0,0,0,-1384017742,1298895859,11824.44223,792795630.4,79279563.04,2,95331,4196,512,1964,1452,512,95331,1452,1964,353.56,3.333333333,12.93333333,35246.99333,2644.933333,16.35333333,98804.68,0.354356787,0.026513078,0.000165562,0.739307536,0.020601903,22,8
D:0| T0: 0.17| T1: 8.00| R0: 0.0| R1: 0.0| WTP: 0,0,0.173076923,8,0,0,0,0,0,-1311083873,1489316290,10631.06342,779530701.8,77953070.18,2,82545,3668,530,1766,1236,530,82545,1236,1766,237.4210526,2.694736842,9.142105263,40931.03684,1511.573684,11.93157895,98828.62632,0.412471032,0.01515873,0.000121254,0.69988675,0.021394391,28,8
D:0| T0: 0.17| T1: 8.00| R0: 0.0| R1: 0.0| WTP: 0,0,0.173076923,8,0,0,0,0,0,-1490460276,855602142,14009.49354,789985599,78998559.9,2,96194,3955,472,2328,1856,472,96194,1856,2328,236.6604651,2.153488372,10.74883721,26336.70233,1594.795349,12.94418605,98322.34419,0.265324005,0.016043383,0.000131127,0.797250859,0.024201094,31,8
D:0| T0: 0.17| T1: 8.00| R0: 0.0| R1: 0.0| WTP: 0,0,0.173076923,8,0,0,0,0,0,-1355494614,1438649896,11425.56967,784216130.7,78421613.07,2,89954,3859,1237,1898,661,1237,89954,661,1898,142.9179331,3.6443769,5.598784195,49801.17933,1391.759878,9.331306991,99012.00912,0.500259749,0.014007291,9.58728E-05,0.348261328,0.021099673,46,8
D:0| T0: 0.17| T1: 8.00| R0: 0.0| R1: 0.0| WTP: 0,0,0.173076923,8,0,0,0,0,0,-1335986943,952489126,11307.00455,770636715.5,77063671.55,2,78241,3201,1112,1879,767,1112,78241,767,1879,91.93853428,2.498817967,4.283687943,66554.83215,1426.706856,6.929078014,99267.3948,0.667402872,0.014361597,7.12084E-05,0.408195849,0.024015542,61,8
D:0| T0: 0.17| T1: 8.00| R0: 0.0| R1: 0.0| WTP: 0,0,0.173076923,8,0,0,0,0,0,-1424537680,1550779155,12652.83926,791895717.5,79189571.75,2,99140,4210,405,2102,1697,405,99140,1697,2102,388.0444444,2.925925926,15.45185185,25772.78519,2053.718519,18.45185185,98562.6,0.259796048,0.020577355,0.00018625,0.807326356,0.02120234,20,8
D:0| T0: 0.17| T1: 8.00| R0: 0.0| R1: 0.0| WTP: 0,0,0.173076923,8,0,0,0,0,0,-1265961774,607323321,9824.96404,774713571.9,77471357.19,2,76790,3366,987,1632,645,987,76790,645,1632,108.7688312,2.449350649,4.088311688,67287.21558,963.025974,6.644155844,99354.34026,0.67461325,0.009684241,6.83986E-05,0.395220588,0.021252767,55,8
D:0| T0: 0.17| T1: 8.00| R0: 0.0| R1: 0.0| WTP: 0,0,0.173076923,8,0,0,0,0,0,-1227114783,2103646485,9150.680298,769580768.5,76958076.85,2,71386,3117,988,1520,532,988,71386,532,1520,94.26150121,2.220338983,3.493946731,47747.58596,521.9636804,5.881355932,98916.09443,0.481971959,0.005247833,6.10717E-05,0.35,0.02129269,59,8
D:0| T0: 0.17| T1: 8.00| R0: 0.0| R1: 0.0| WTP: 0,0,0.173076923,8,0,0,0,0,0,-1353799560,258120157,11146.97866,796450626.6,79645062.66,2,97711,4438,441,1851,1410,441,97711,1410,1851,336.3151515,2.6,11.09090909,25085.55152,1505.909091,13.77575758,98682.07273,0.25287235,0.015096437,0.000139335,0.761750405,0.018943619,24,8
D:0| T0: 0.17| T1: 8.00| R0: 0.0| R1: 0.0| WTP: 0,0,0.173076923,8,0,0,0,0,0,-1303980882,1068951401,10333.44127,787308818.8,78730881.88,2,86774,3953,838,1716,878,838,86774,878,1716,156.1918239,2.512578616,5.232704403,61153.13836,1067.628931,7.883647799,99297.7327,0.612862697,0.010731892,8.07349E-05,0.511655012,0.019775509,46,8
D:0| T0: 0.17| T1: 8.00| R0: 0.0| R1: 0.0| WTP: 0,0,0.173076923,8,0,0,0,0,0,-1348928968,635956235,11358.37027,781010454.4,78101045.44,2,86416,3721,1011,1887,876,1011,86416,876,1887,119.007874,2.535433071,4.800524934,58546.30971,1723.167979,7.454068241,99167.50394,0.586969466,0.017344434,7.6577E-05,0.464228935,0.021836234,54,8
D:0| T0: 0.17| T1: 8.00| R0: 0.0| R1: 0.0| WTP: 0,0,0.173076923,8,0,0,0,0,0,-1199470038,1346693470,8675.046643,765717706.3,76571770.63,2,67797,2942,1055,1441,386,1055,67797,386,1441,89.56862745,2.465686275,3.37254902,73815.31618,848.7941176,5.955882353,99484.41422,0.739993941,0.008529341,6.14633E-05,0.267869535,0.021254941,59,8
D:0| T0: 0.17| T1: 8.00| R0: 0.0| R1: 0.0| WTP: 0,0,0.173076923,8,0,0,0,0,0,-1440092423,847102011,12959.21789,792131528.4,79213152.84,2,98233,4205,472,2153,1681,472,98233,1681,2153,319.4573171,2.817073171,13,28185.04878,2044.310976,15.8597561,98563.80488,0.283633893,0.020520756,0.000160784,0.780771017,0.021917278,24,8
D:0| T0: 0.17| T1: 8.00| R0: 0.0| R1: 0.0| WTP: 0,0,0.173076923,8,0,0,0,0,0,-1453630470,812083272,13312.46804,788007068.3,78800706.83,2,94028,3916,1145,2212,1067,1145,94028,1067,2212,181.7518519,4.096296296,7.985185185,50970.21852,2121.674074,12.24814815,98954.38519,0.51122978,0.021369782,0.000125184,0.482368897,0.023524907,39,8
D:0| T0: 0.17| T1: 8.00| R0: 0.0| R1: 0.0| WTP: 0,0,0.173076923,8,0,0,0,0,0,-1384947655,2146825809,11771.51154,796372077.9,79637207.79,2,98874,4500,465,1955,1490,465,98874,1490,1955,310.3202247,2.556179775,10.8988764,22618.65169,1755.179775,13.51123596,98579.26404,0.228024452,0.017605376,0.000136496,0.762148338,0.01977264,26,8
D:0| T0: 0.17| T1: 8.00| R0: 0.0| R1: 0.0| WTP: 0,0,0.173076923,8,0,0,0,0,0,-1435574676,226186520,12851.40519,793004416.4,79300441.64,2,97214,4231,468,2135,1667,468,97214,1667,2135,315.2619048,2.726190476,12.57738095,29346.85714,1687.755952,15.35714286,98566.32143,0.29534006,0.016944885,0.00015565,0.780796253,0.021961857,24,8
D:0| T0: 0.17| T1: 8.00| R0: 0.0| R1: 0.0| WTP: 0,0,0.173076923,8,0,0,0,0,0,-1415279222,1110225441,12419.62312,794298066.7,79429806.67,2,95370,4200,932,2063,1131,932,95370,1131,2063,182.8869863,3.058219178,6.883561644,50877.33904,2522.308219,10.07876712,99052.37329,0.509763857,0.025383888,0.00010325,0.548230732,0.02163154,42,8
D:0| T0: 0.17| T1: 8.00| R0: 0.0| R1: 0.0| WTP: 0,0,0.173076923,8,0,0,0,0,0,-1292895852,1190767082,10052.2319,790284256.8,79028425.68,2,92928,4168,1050,1669,619,1050,92928,619,1669,177.3979239,3.519031142,5.60899654,48804.86505,1719.955017,9.221453287,99151.83391,0.489653772,0.017281356,9.45025E-05,0.370880767,0.017960141,42,8
D:0| T0: 0.17| T1: 8.00| R0: 0.0| R1: 0.0| WTP: 0,0,0.173076923,8,0,0,0,0,0,-1306339595,2108234095,10523.36724,780171233.5,78017123.35,2,81550,3543,1019,1748,729,1019,81550,729,1748,128.1306818,2.721590909,4.744318182,62216.50284,1421.923295,7.664772727,99250.19886,0.624012867,0.01430015,7.90582E-05,0.417048055,0.021434703,51,8
D:0| T0: 0.17| T1: 8.00| R0: 0.0| R1: 0.0| WTP: 0,0,0.173076923,8,0,0,0,0,0,-1448955017,465621985,13044.7896,796715537.3,79671553.73,2,98735,4381,480,2167,1687,480,98735,1687,2167,334.5272727,2.83030303,13.01212121,26112.41818,2058.369697,15.90909091,98516.55758,0.262930085,0.020662792,0.000161171,0.778495616,0.021947638,24,8
D:0| T0: 0.17| T1: 8.00| R0: 0.0| R1: 0.0| WTP: 0,0,0.173076923,8,0,0,0,0,0,-1258137343,1487072553,9503.321058,782971290.6,78297129.06,2,83962,3779,912,1578,666,912,83962,666,1578,156.4518272,2.903654485,5.073089701,60574.56146,1002.910299,8.093023256,99313.8505,0.607448535,0.010074499,8.30786E-05,0.422053232,0.018794216,43,8
D:0| T0: 0.17| T1: 8.00| R0: 0.0| R1: 0.0| WTP: 0,0,0.173076923,8,0,0,0,0,0,-1325562660,1213733847,10937.39959,778692681.1,77869268.11,2,83365,3481,1326,1817,491,1326,83365,491,1817,130.8143713,3.835329341,5.251497006,47293.61976,1055.48503,9.209580838,98914.34431,0.476157357,0.010619625,9.46781E-05,0.270225647,0.021796241,48,8
D:0| T0: 0.17| T1: 8.00| R0: 0.0| R1: 0.0| WTP: 0,0,0.173076923,8,0,0,0,0,0,-1351969021,2003658337,11430.37407,780450317.2,78045031.72,2,85087,3664,1277,1899,622,1277,85087,622,1899,148.8866667,4.116666667,6.15,47100.27667,1145.626667,10.41666667,98890.87667,0.474324709,0.011525905,0.000106553,0.327540811,0.022318595,43,8
D:0| T0: 0.17| T1: 8.00| R0: 0.0| R1: 0.0| WTP: 0,0,0.173076923,8,0,0,0,0,0,-1260377043,1170868072,9651.815414,777786272.1,77778627.21,2,76906,3428,975,1603,628,975,76906,628,1603,111.3020305,2.360406091,3.918781726,67918.19036,1141.068528,6.385786802,99382.85787,0.68080433,0.01147285,6.57917E-05,0.39176544,0.020843627,57,8
D:0| T0: 0.17| T1: 8.00| R0: 0.0| R1: 0.0| WTP: 0,0,0.173076923,8,0,0,0,0,0,-1392698101,569919592,11915.80294,796907954.3,79690795.43,2,99253,4499,426,1979,1553,426,99253,1553,1979,291.0471204,2.178010471,10.28272251,19861.66492,1353.65445,12.51308901,98501.8377,0.200403918,0.013586368,0.000126488,0.784739768,0.019938944,28,8
D:0| T0: 0.17| T1: 8.00| R0: 0.0| R1: 0.0| WTP: 0,0,0.173076923,8,0,0,0,0,0,-1268476031,1833180623,9554.037035,790774179.6,79077417.96,2,84567,3972,1217,1586,369,1217,84567,369,1586,144.1955307,3.240223464,4.226256983,44208.96089,1094.907821,7.631284916,99020.39106,0.445031332,0.011003025,7.87117E-05,0.232660782,0.01875436,52,8
D:0| T0: 0.17| T1: 8.00| R0: 0.0| R1: 0.0| WTP: 0,0,0.173076923,8,0,0,0,0,0,-1461575962,1123666637,13397.49232,791701346.6,79170134.66,2,97045,4088,484,2226,1742,484,97045,1742,2226,292.4382022,2.646067416,12.37640449,26979.19101,1643.123596,15.08988764,98445.79213,0.271790086,0.016507599,0.000153066,0.782569632,0.022937812,26,8
D:0| T0: 0.17| T1: 8.00| R0: 0.0| R1: 0.0| WTP: 0,0,0.173076923,8,0,0,0,0,0,-1315810552,1682024981,10597.3134,785944881.9,78594488.19,2,86228,3785,995,1760,765,995,86228,765,1760,133.2630137,2.597260274,4.652054795,35271.13973,1937.030137,7.367123288,98741.2411,0.355685468,0.019485823,7.5982E-05,0.434659091,0.020411003,52,8
D:0| T0: 0.17| T1: 8.00| R0: 0.0| R1: 0.0| WTP: 0,0,0.173076923,8,0,0,0,0,0,-1379416355,1687523543,11829.04361,787964174.4,78796417.44,2,91943,3993,962,1965,1003,962,91943,1003,1965,175.1342756,3.282685512,6.77385159,54406.0636,1235.342756,10.16254417,99106.40636,0.545462094,0.012429221,0.000104035,0.51043257,0.021371937,41,8
D:0| T0: 0.17| T1: 8.00| R0: 0.0| R1: 0.0| WTP: 0,0,0.173076923,8,0,0,0,0,0,-1397315980,178034412,12141.87123,790222418.8,79022241.88,2,94595,4091,473,2017,1544,473,94595,1544,2017,302.4882353,2.705882353,11.71176471,32179.84706,1957.470588,14.5,98671.00588,0.323884412,0.01964123,0.000147066,0.765493307,0.02132248,25,8
D:0| T0: 0.17| T1: 8.00| R0: 0.0| R1: 0.0| WTP: 0,0,0.173076923,8,0,0,0,0,0,-1352082457,739490003,11252.82697,789441108.4,78944110.84,2,93005,4063,472,1869,1397,472,93005,1397,1869,258.2575758,2.338383838,9.338383838,30261.86869,1311.525253,11.70707071,98688.23737,0.304855896,0.013160992,0.000118721,0.747458534,0.020095694,29,8
D:0| T0: 0.17| T1: 8.00| R0: 0.0| R1: 0.0| WTP: 0,0,0.173076923,8,0,0,0,0,0,-1299548561,178482706,10550.61847,772017637.9,77201763.79,2,77779,3392,879,1753,874,879,77779,874,1753,61.1337386,1.194528875,2.507598784,33503.29787,505.7948328,3.844984802,98534,0.3393981,0.005094362,4.03131E-05,0.498573873,0.022538217,94,8
D:0| T0: 0.17| T1: 8.00| R0: 0.0| R1: 0.0| WTP: 0,0,0.173076923,8,0,0,0,0,0,-1398017264,1919366370,12266.45519,784694504.7,78469450.47,2,89902,3781,1135,2038,903,1135,89902,903,2038,164.15625,3.8125,6.892361111,52182.02431,1078.701389,10.83680556,98994.97569,0.524093523,0.010858444,0.000110874,0.443081452,0.022669129,42,8
D:0| T0: 0.17| T1: 8.00| R0: 0.0| R1: 0.0| WTP: 0,0,0.173076923,8,0,0,0,0,0,-1367935387,1819796913,11429.23864,796473454.4,79647345.44,2,97451,4460,447,1898,1451,447,97451,1451,1898,331.8562874,2.622754491,11.25149701,29956.10778,2402.502994,13.91616766,98757.13174,0.301268217,0.024087167,0.000140892,0.764488936,0.019476455,24,8
D:0| T0: 0.17| T1: 8.00| R0: 0.0| R1: 0.0| WTP: 0,0,0.173076923,8,0,0,0,0,0,-1408616335,1866591913,12358.3587,790698399.3,79069839.93,2,96079,4088,842,2053,1211,842,96079,1211,2053,153.984985,2.435435435,6.018018018,50238.4985,2365.492492,8.552552553,99039.76276,0.503094415,0.023812105,8.75651E-05,0.589868485,0.021367833,48,8
D:0| T0: 0.17| T1: 8.00| R0: 0.0| R1: 0.0| WTP: 0,0,0.173076923,8,0,0,0,0,0,-1415801958,1219425989,12401.84865,795709525.3,79570952.53,2,99237,4466,445,2060,1615,445,99237,1615,2060,367.2281879,2.899328859,13.69798658,25378.61074,1725.073826,16.67785235,98582.61074,0.255690659,0.017298075,0.000168699,0.783980583,0.020758386,22,8
D:0| T0: 0.17| T1: 8.00| R0: 0.0| R1: 0.0| WTP: 0,0,0.173076923,8,0,0,0,0,0,-1379799903,502409586,11734.42741,793078532.7,79307853.27,2,97438,4267,475,1949,1474,475,97438,1474,1949,306.0287356,2.655172414,11.08045977,28094.3908,2257.413793,13.83333333,98682,0.282737,0.022643698,0.00013985,0.756285274,0.020002463,25,8
D:0| T0: 0.17| T1: 8.00| R0: 0.0| R1: 0.0| WTP: 0,0,0.173076923,8,0,0,0,0,0,-1255474134,1405887957,9608.695695,775039349.1,77503934.91,2,76595,3445,512,1596,1084,512,76595,1084,1596,179.7510549,2.097046414,6.641350211,41723.33333,980.5822785,8.789029536,98850.48101,0.420923848,0.009838088,8.92723E-05,0.679197995,0.020837141,34,8
D:0| T0: 0.17| T1: 8.00| R0: 0.0| R1: 0.0| WTP: 0,0,0.173076923,8,0,0,0,0,0,-1393218156,283033753,12288.32318,778801996.8,77880199.68,2,87277,3583,531,2042,1511,531,87277,1511,2042,255.9884393,2.994219653,11.67052023,38554.0578,1341.491329,14.74566474,98675.24855,0.388482073,0.013467474,0.000149366,0.739960823,0.023396771,25,8
D:0| T0: 0.17| T1: 8.00| R0: 0.0| R1: 0.0| WTP: 0,0,0.173076923,8,0,0,0,0,0,-1376451252,1083157068,11857.81085,783560709.8,78356070.98,2,86336,3684,1371,1970,599,1371,86336,599,1970,129.7597765,3.670391061,5.293296089,41952.48603,1232.421788,9.148044693,98754.83799,0.422934308,0.012409595,9.40139E-05,0.304060914,0.022817828,52,8
D:0| T0: 0.17| T1: 8.00| R0: 0.0| R1: 0.0| WTP: 0,0,0.173076923,8,0,0,0,0,0,-1358046141,1988704626,11550.50927,780520677.9,78052067.79,2,82893,3533,1228,1919,691,1228,82893,691,1919,125.4761905,3.324929972,5.212885154,50075.7507,599.092437,8.647058824,98892.80672,0.503904493,0.006032464,8.87183E-05,0.360083377,0.023150326,51,8
D:0| T0: 0.17| T1: 8.00| R0: 0.0| R1: 0.0| WTP: 0,0,0.173076923,8,0,0,0,0,0,-1432318200,884761309,12743.97338,795119531.5,79511953.15,2,99069,4387,436,2117,1681,436,99069,1681,2117,369.3673469,2.911564626,14.29251701,24302.81633,1752.081633,17.2585034,98511.2381,0.245066138,0.017571463,0.00017431,0.794048181,0.021368945,21,8
D:0| T0: 0.17| T1: 8.00| R0: 0.0| R1: 0.0| WTP: 0,0,0.173076923,8,0,0,0,0,0,-1257484296,533485933,9455.813181,784693636.8,78469363.68,2,82925,3816,838,1570,732,838,82925,732,1570,140.7317784,2.32361516,4.428571429,60198.17201,657.0728863,6.874635569,99292.31195,0.603663828,0.0066037,7.05375E-05,0.466242038,0.018932771,49,8
D:0| T0: 0.17| T1: 8.00| R0: 0.0| R1: 0.0| WTP: 0,0,0.173076923,8,0,0,0,0,0,-1343933493,632196071,11185.36497,784665244.3,78466524.43,2,84428,3755,832,1858,1026,832,84428,1026,1858,144.1807229,2.406626506,5.463855422,58496.73494,652.8042169,7.975903614,99137.52711,0.58689358,0.006568849,8.15071E-05,0.552206674,0.022006917,48,8
D:0| T0: 0.17| T1: 8.00| R0: 0.0| R1: 0.0| WTP: 0,0,0.173076923,8,0,0,0,0,0,-1431793819,393400457,12797.00807,791943416.2,79194341.62,2,96342,4175,447,2126,1679,447,96342,1679,2126,304.3430233,2.540697674,12.26162791,30650.72093,1753.767442,14.8372093,98579.56395,0.30840584,0.017605094,0.000150281,0.789746002,0.022067219,25,8
D:0| T0: 0.17| T1: 8.00| R0: 0.0| R1: 0.0| WTP: 0,0,0.173076923,8,0,0,0,0,0,-1315900848,398973227,10756.71924,778064886,77806488.6,2,82419,3550,541,1787,1246,541,82419,1246,1787,232.5105263,2.773684211,9.273684211,40937.91579,1297.626316,12.11052632,98816.44211,0.412583517,0.013013073,0.000122958,0.697257974,0.021681894,28,8
D:0| T0: 0.17| T1: 8.00| R0: 0.0| R1: 0.0| WTP: 0,0,0.173076923,8,0,0,0,0,0,-1362082158,1402256491,11463.1449,788924912.7,78892491.27,2,91640,3974,1212,1904,692,1212,91640,692,1904,185.0555556,4.359259259,6.874074074,50586.53333,2153.055556,11.37777778,99069.55926,0.507638931,0.021650414,0.000116028,0.363445378,0.020776953,39,8
D:0| T0: 0.17| T1: 8.00| R0: 0.0| R1: 0.0| WTP: 0,0,0.173076923,8,0,0,0,0,0,-1337509705,2102527413,11088.73856,783072776.8,78307277.68,2,83019,3682,844,1842,998,844,83019,998,1842,98.4591195,1.631027254,3.708595388,30124.30608,1006.708595,5.486373166,98502.50314,0.304840593,0.010135055,5.67401E-05,0.541802389,0.022187692,69,8
D:0| T0: 0.17| T1: 8.00| R0: 0.0| R1: 0.0| WTP: 0,0,0.173076923,8,0,0,0,0,0,-1351449844,1748031099,11394.53852,781722918,78172291.8,2,85225,3586,639,1893,1254,639,85225,1254,1893,190.2139918,2.551440329,7.674897119,35569.5679,1893.353909,10.2962963,98659.73251,0.358808745,0.019029427,0.00010476,0.662440571,0.022211792,35,8
D:0| T0: 0.17| T1: 8.00| R0: 0.0| R1: 0.0| WTP: 0,0,0.173076923,8,0,0,0,0,0,-1345704173,1946754629,11233.21895,784043226.1,78404322.61,2,86914,3761,899,1866,967,899,86914,967,1866,161.2210884,2.921768707,6.163265306,59493.46939,1130.401361,9.221088435,99198.09524,0.596540469,0.011368561,9.45737E-05,0.518220793,0.021469499,42,8
D:0| T0: 0.17| T1: 8.00| R0: 0.0| R1: 0.0| WTP: 0,0,0.173076923,8,0,0,0,0,0,-1324656897,2097712204,10848.31545,782241123.9,78224112.39,2,85293,3773,1007,1802,795,1007,85293,795,1802,161.6013986,3.367132867,6.111888112,57848.59091,931.3881119,9.632867133,99180.91259,0.580576293,0.009362737,9.87107E-05,0.441176471,0.021127173,41,8
D:0| T0: 0.17| T1: 8.00| R0: 0.0| R1: 0.0| WTP: 0,0,0.173076923,8,0,0,0,0,0,-1356357280,1198827119,11555.70818,778571871.1,77857187.11,2,85196,3620,898,1920,1022,898,85196,1022,1920,131.505988,2.568862275,5.571856287,63826.39222,1641.931138,8.269461078,99258.04491,0.639568404,0.01652376,8.49235E-05,0.532569046,0.022524532,48,8
D:0| T0: 0.17| T1: 8.00| R0: 0.0| R1: 0.0| WTP: 0,0,0.173076923,8,0,0,0,0,0,-1212703286,109253198,8933.445359,766031017.6,76603101.76,2,66905,2961,1221,1484,263,1221,66905,263,1484,69.88888889,2.235632184,2.718390805,71522.15709,905.059387,5.045977011,99410.28352,0.717430991,0.009100531,5.21041E-05,0.17722372,0.022180704,74,8
D:0| T0: 0.17| T1: 8.00| R0: 0.0| R1: 0.0| WTP: 0,0,0.173076923,8,0,0,0,0,0,-1296441710,314481292,10348.75991,779003714.2,77900371.42,2,81157,3616,855,1719,864,855,81157,864,1719,135.7408537,2.484756098,5.076219512,63523.52744,738.3018293,7.679878049,99274.81402,0.637011857,0.00742434,7.88934E-05,0.502617801,0.021181167,47,8
D:0| T0: 0.17| T1: 12.00| R0: 0.0| R1: 0.0| WTP: 0,0,0.173076923,12,0,0,0,0,0,-1658660279,1178568022,10588.88894,1129215832,112921583.2,2,81979,3580,941,1759,818,941,81979,818,1759,101.9168591,2.083140878,3.939953811,68568.98383,973.3233256,6.103926097,99377.89376,0.686898549,0.009795169,6.27571E-05,0.465036953,0.021456715,61,12
D:0| T0: 0.17| T1: 12.00| R0: 0.0| R1: 0.0| WTP: 0,0,0.173076923,12,0,0,0,0,0,-1731411012,2029998696,11746.56513,1144082755,114408275.5,2,95757,4310,471,1951,1480,471,95757,1480,1951,338.5,2.917721519,12.23417722,34133.97468,2047.259494,15.20253165,98787.36076,0.343134047,0.020521127,0.000153792,0.758585341,0.02037449,23,12
D:0| T0: 0.17| T1: 12.00| R0: 0.0| R1: 0.0| WTP: 0,0,0.173076923,12,0,0,0,0,0,-1664874360,776062361,10803.52957,1124697881,112469788.1,2,79864,3404,778,1795,1017,778,79864,1017,1795,78.625,1.373106061,3.276515152,31922.36553,938.9034091,4.748106061,98517.88636,0.322994164,0.009454269,4.90931E-05,0.566573816,0.02247599,75,12
D:0| T0: 0.17| T1: 12.00| R0: 0.0| R1: 0.0| WTP: 0,0,0.173076923,12,0,0,0,0,0,-1688345097,1813046880,11171.6181,1129764192,112976419.2,2,82922,3531,976,1856,880,976,82922,880,1856,101.409611,2.148741419,4.128146453,68783.07323,1201.78032,6.363844394,99358.35011,0.689044413,0.012100471,6.52573E-05,0.474137931,0.02238248,63,12
D:0| T0: 0.17| T1: 12.00| R0: 0.0| R1: 0.0| WTP: 0,0,0.173076923,12,0,0,0,0,0,-1603311089,2032407216,9466.155352,1130003321,113000332.1,2,82993,3754,1068,1572,504,1068,82993,504,1572,111.735,2.545,3.765,59682.3475,725.5275,6.445,99273.7325,0.599130804,0.00729462,6.63368E-05,0.320610687,0.018941356,58,12
D:0| T0: 0.17| T1: 12.00| R0: 0.0| R1: 0.0| WTP: 0,0,0.173076923,12,0,0,0,0,0,-789830023.7,1507873352,18.03885983,788928080.7,78892808.07,1,53,5,3,3,0,3,53,0,3,0.346153846,0,0,99969.92308,3.353846154,0.023076923,99999.23846,0.999708164,3.52674E-05,4.5802E-07,0,0.056603774,18,9
D:0| T0: 0.17| T1: 12.00| R0: 0.0| R1: 0.0| WTP: 0,0,0.173076923,12,0,0,0,0,0,-968754026.9,1855899401,78.28915632,964839569,96483956.9,1,825,38,13,13,0,13,825,0,13,2.927536232,0.036231884,0.036231884,99516.06522,21.85507246,0.115942029,99992.72464,0.995239322,0.000219585,1.87061E-06,0,0.015757576,20,11
D:0| T0: 0.17| T1: 12.00| R0: 0.0| R1: 0.0| WTP: 0,0,0.173076923,12,0,0,0,0,0,-1586956842,1819459251,9342.646849,1119824500,111982450,2,73026,3164,847,1552,705,847,73026,705,1552,63.89802632,1.25,2.393092105,40837.32401,431.6825658,3.78125,98771.69243,0.412964724,0.004344129,3.97179E-05,0.454252577,0.021252996,87,12
D:0| T0: 0.17| T1: 12.00| R0: 0.0| R1: 0.0| WTP: 0,0,0.173076923,12,0,0,0,0,0,-879717430.9,909791748,48.30141192,877302360.3,87730236.03,1,712,35,8,8,0,8,712,0,8,3.715384615,0.023076923,0.023076923,99597.11538,18.2,0.092307692,99996.43846,0.996011817,0.000183516,1.22141E-06,0,0.011235955,19,10
D:0| T0: 0.17| T1: 12.00| R0: 0.0| R1: 0.0| WTP: 0,0,0.173076923,12,0,0,0,0,0,-1649645270,1339092841,10527.09373,1123290584,112329058.4,2,74852,3161,1369,1749,380,1369,74852,380,1749,102.8461538,3.330769231,4.271794872,53807.90513,688.6025641,7.8,98952.67179,0.542471213,0.006931495,8.04742E-05,0.21726701,0.023366421,56,12
D:0| T0: 0.17| T1: 12.00| R0: 0.0| R1: 0.0| WTP: 0,0,0.173076923,12,0,0,0,0,0,-1767779255,1365866345,12461.40314,1144709098,114470909.8,2,97538,4342,473,2070,1597,473,97538,1597,2070,323.5361446,2.777108434,12.3313253,30129.07229,1838.403614,15.18674699,98646.18072,0.303029949,0.018449069,0.000153835,0.771497585,0.021222498,24,12
D:0| T0: 0.17| T1: 12.00| R0: 0.0| R1: 0.0| WTP: 0,0,0.173076923,12,0,0,0,0,0,-1641213639,825453433,10057.52791,1138337243,113833724.3,2,86905,3942,1320,1670,350,1320,86905,350,1670,141.3171429,3.614285714,4.585714286,50173.00857,1261.965714,8.38,99102.96571,0.504258179,0.012688573,8.5883E-05,0.209580838,0.019216386,50,12
D:0| T0: 0.17| T1: 12.00| R0: 0.0| R1: 0.0| WTP: 0,0,0.173076923,12,0,0,0,0,0,-1776085719,939711378,12599.97694,1146086872,114608687.2,2,97565,4337,449,2093,1644,449,97565,1644,2093,352.1225806,2.806451613,13.36129032,32566.96774,2472.883871,16.23870968,98693.54839,0.327314107,0.024802877,0.000164638,0.785475394,0.021452365,23,12
D:0| T0: 0.17| T1: 12.00| R0: 0.0| R1: 0.0| WTP: 0,0,0.173076923,12,0,0,0,0,0,-1703484008,638950699,11182.3934,1144364338,114436433.8,2,90903,4174,1082,1857,775,1082,90903,775,1857,155.1428571,3,5.209912536,57297.41691,1679.137026,8.364431487,99192.81633,0.574544417,0.016898906,8.62015E-05,0.417339795,0.020428369,49,12
D:0| T0: 0.17| T1: 12.00| R0: 0.0| R1: 0.0| WTP: 0,0,0.173076923,12,0,0,0,0,0,-1660333213,938699148,10512.57219,1134704604,113470460.4,2,85163,3834,902,1746,844,902,85163,844,1746,125.5804749,2.245382586,4.437994723,60716.99736,758.5329815,6.823218997,99243.42216,0.608889158,0.007631075,7.02768E-05,0.483390607,0.020501861,55,12
D:0| T0: 0.17| T1: 12.00| R0: 0.0| R1: 0.0| WTP: 0,0,0.173076923,12,0,0,0,0,0,-1630265091,121790188,9965.269902,1132001596,113200159.6,2,80892,3674,1017,1655,638,1017,80892,638,1655,90.92673267,1.928712871,3.164356436,67091.9703,1155.467327,5.174257426,99371.34653,0.672269934,0.011628542,5.32456E-05,0.385498489,0.020459378,72,12
D:0| T0: 0.17| T1: 12.00| R0: 0.0| R1: 0.0| WTP: 0,0,0.173076923,12,0,0,0,0,0,-1642029748,1331335240,10282.1491,1127922292,112792229.2,2,80691,3516,916,1708,792,916,80691,792,1708,65.84568835,1.266263238,2.444780635,29968.26172,804.1043873,3.829046899,98555.70953,0.303362137,0.008096518,3.99956E-05,0.463700234,0.021167169,95,12
D:0| T0: 0.17| T1: 12.00| R0: 0.0| R1: 0.0| WTP: 0,0,0.173076923,12,0,0,0,0,0,-1813136815,470935411,13362.35035,1145019298,114501929.8,2,98775,4173,475,2220,1745,475,98775,1745,2220,312.5,2.697674419,12.81395349,24473.4186,1485.94186,15.54651163,98426.86628,0.246574405,0.014924275,0.000157498,0.786036036,0.022475323,25,12
D:0| T0: 0.17| T1: 12.00| R0: 0.0| R1: 0.0| WTP: 0,0,0.173076923,12,0,0,0,0,0,-1758302203,823434397,12505.83126,1133010640,113301064,2,90048,3733,948,2078,1130,948,90048,1130,2078,133.8284884,2.619186047,5.869186047,59031.05814,1336.197674,8.639534884,99128.56686,0.591779869,0.013458673,8.85935E-05,0.543792108,0.023076581,50,12
D:0| T0: 0.17| T1: 12.00| R0: 0.0| R1: 0.0| WTP: 0,0,0.173076923,12,0,0,0,0,0,-1059593265,493045351,132.4932633,1052968602,105296860.2,2,1358,62,22,22,0,22,1358,0,22,4.570469799,0.073825503,0.073825503,99178.86577,23.2147651,0.228187919,99988.9396,0.99190858,0.000233087,2.93363E-06,0,0.016212233,22,12
D:0| T0: 0.17| T1: 12.00| R0: 0.0| R1: 0.0| WTP: 0,0,0.173076923,12,0,0,0,0,0,-1635687604,1700216563,9978.747864,1136750211,113675021.1,2,87258,3915,834,1657,823,834,87258,823,1657,137.7191011,2.241573034,4.52247191,60269.35955,1317.792135,6.853932584,99296.95225,0.603889759,0.013249311,7.03429E-05,0.496680748,0.018989663,51,12
D:0| T0: 0.17| T1: 12.00| R0: 0.0| R1: 0.0| WTP: 0,0,0.173076923,12,0,0,0,0,0,-1571829480,1744119059,8900.703488,1126794305,112679430.5,2,74972,3379,1218,1478,260,1218,74972,260,1478,96.1752809,2.575280899,3.143820225,55505.03596,466.2426966,5.885393258,99170.2764,0.558560173,0.004686991,6.09033E-05,0.175913396,0.019714027,64,12
D:0| T0: 0.17| T1: 12.00| R0: 0.0| R1: 0.0| WTP: 0,0,0.173076923,12,0,0,0,0,0,-1671669246,2036906360,10788.09781,1132264356,113226435.6,2,84655,3663,1033,1792,759,1033,84655,759,1792,110.0407674,2.366906475,4.151079137,66415.39568,1416.513189,6.621103118,99353.60911,0.665318381,0.014254588,6.81862E-05,0.423549107,0.021168271,59,12
D:0| T0: 0.17| T1: 12.00| R0: 0.0| R1: 0.0| WTP: 0,0,0.173076923,12,0,0,0,0,0,-1688113195,809704121,10982.41606,1138992392,113899239.2,2,88905,4008,976,1824,848,976,88905,848,1824,146.3333333,2.701754386,5.143274854,59545.46199,1340.576023,8.014619883,99233.74854,0.596951823,0.013486625,8.23515E-05,0.464912281,0.020516281,48,12
D:0| T0: 0.17| T1: 12.00| R0: 0.0| R1: 0.0| WTP: 0,0,0.173076923,12,0,0,0,0,0,-1628685215,1219866412,9929.233323,1132223548,113222354.8,2,81988,3657,922,1649,727,922,81988,727,1649,85.71666667,1.538888889,2.87037037,31391.54074,1248.1,4.588888889,98669.63519,0.317435709,0.01255752,4.79383E-05,0.440873257,0.020112699,78,12
D:0| T0: 0.17| T1: 12.00| R0: 0.0| R1: 0.0| WTP: 0,0,0.173076923,12,0,0,0,0,0,-880548875.2,843498920,72.19973601,876938888.4,87693888.84,1,647,29,12,12,0,12,647,0,12,1.92481203,0.015037594,0.015037594,99623.25564,22.4887218,0.127819549,99993.54887,0.996302547,0.000225537,1.79114E-06,0,0.018547141,19,10
D:0| T0: 0.17| T1: 12.00| R0: 0.0| R1: 0.0| WTP: 0,0,0.173076923,12,0,0,0,0,0,-1817135287,107351963,13635.63915,1135353330,113535333,2,92410,3774,1012,2266,1254,1012,92410,1254,2266,139.9614243,2.863501484,6.545994065,61213.64985,1921.744807,9.53115727,99139.79822,0.61344064,0.019376761,9.80449E-05,0.553398058,0.024521156,49,12
D:0| T0: 0.17| T1: 12.00| R0: 0.0| R1: 0.0| WTP: 0,0,0.173076923,12,0,0,0,0,0,-1728155272,773789021,11763.41713,1139984416,113998441.6,2,91840,4102,957,1954,997,957,91840,997,1954,134.6133333,2.413333333,5.037333333,53952.95733,1663.669333,7.610666667,99092.11467,0.540849662,0.016752373,7.81591E-05,0.510235415,0.021276132,54,12
D:0| T0: 0.17| T1: 12.00| R0: 0.0| R1: 0.0| WTP: 0,0,0.173076923,12,0,0,0,0,0,-1761439305,850936611,12589.63711,1131957449,113195744.9,2,88529,3638,1132,2092,960,1132,88529,960,2092,134.9253731,3.194029851,6.023880597,58666.9194,1395.728358,9.441791045,99097.55522,0.588699827,0.014058644,9.69152E-05,0.458891013,0.023630675,48,12
D:0| T0: 0.17| T1: 12.00| R0: 0.0| R1: 0.0| WTP: 0,0,0.173076923,12,0,0,0,0,0,-1623549152,1701318364,9980.88477,1124504913,112450491.3,2,77081,3349,1174,1658,484,1174,77081,484,1658,82.861167,2.201207243,3.160965795,44198.28169,659.2655936,5.52917505,98827.3501,0.446344526,0.006635384,5.73711E-05,0.291917973,0.02150984,71,12
D:0| T0: 0.17| T1: 12.00| R0: 0.0| R1: 0.0| WTP: 0,0,0.173076923,12,0,0,0,0,0,-1052548176,778708269,12.05544501,1051945404,105194540.4,2,160,9,2,2,0,2,160,0,2,0.577181208,0,0,99907.56376,7.577181208,0.013422819,99999.52349,0.999082926,7.74669E-05,2.66668E-07,0,0.012578616,22,12
D:0| T0: 0.17| T1: 12.00| R0: 0.0| R1: 0.0| WTP: 0,0,0.173076923,12,0,0,0,0,0,-1666849118,1391938506,10833.81829,1125158203,112515820.3,2,80027,3422,1057,1800,743,1057,80027,743,1800,106.0537084,2.560102302,4.41943734,64055.73402,734.4117647,7.143222506,99238.13811,0.643006926,0.007391613,7.35129E-05,0.412777778,0.022492409,56,12
D:0| T0: 0.17| T1: 12.00| R0: 0.0| R1: 0.0| WTP: 0,0,0.173076923,12,0,0,0,0,0,-966359998.7,43418681,36.15789548,964552103.9,96455210.39,1,448,22,6,6,0,6,448,0,6,1.766423358,0,0,99738.22628,18.38686131,0.04379562,99996.93431,0.997417343,0.000185078,8.69587E-07,0,0.013392857,20,11
D:0| T0: 0.17| T1: 12.00| R0: 0.0| R1: 0.0| WTP: 0,0,0.173076923,12,0,0,0,0,0,-1793382459,817384966,13042.80165,1141242376,114124237.6,2,97822,4117,441,2167,1726,441,97822,1726,2167,235.1506849,1.96803653,9.808219178,20561.99087,1216.515982,11.82648402,98330.76712,0.207488953,0.012227703,0.000119801,0.796492847,0.022152481,32,12
D:0| T0: 0.17| T1: 12.00| R0: 0.0| R1: 0.0| WTP: 0,0,0.173076923,12,0,0,0,0,0,-1758610137,762053968,12269.39796,1145140239,114514023.9,2,95458,4290,497,2038,1541,497,95458,1541,2038,339.6918239,3.062893082,12.68553459,32651.35849,1878.163522,15.80503145,98698.81761,0.328496954,0.018836603,0.000160036,0.756133464,0.021349704,23,12
D:0| T0: 0.17| T1: 12.00| R0: 0.0| R1: 0.0| WTP: 0,0,0.173076923,12,0,0,0,0,0,-1658887428,1692506311,10376.22324,1140076266,114007626.6,2,90178,3994,931,1723,792,931,90178,792,1723,136.157754,2.36631016,4.435828877,60289.12032,1595.729947,6.917112299,99311.64706,0.603931399,0.016047455,7.13734E-05,0.459663378,0.019106656,53,12
D:0| T0: 0.17| T1: 12.00| R0: 0.0| R1: 0.0| WTP: 0,0,0.173076923,12,0,0,0,0,0,-615459852.2,1037620300,36.0634779,613656678.3,61365667.83,1,189,3,6,6,0,6,189,0,6,0.5625,0,0,99899.99107,6.258928571,0.0625,99997.875,0.999023061,6.41604E-05,1.06197E-06,0,0.031746032,16,7
D:0| T0: 0.17| T1: 12.00| R0: 0.0| R1: 0.0| WTP: 0,0,0.173076923,12,0,0,0,0,0,-1652383349,301400999,10433.24537,1130721081,113072108.1,2,81861,3578,949,1733,784,949,81861,784,1733,108.7566265,2.163855422,4.024096386,69089.46265,816.0506024,6.303614458,99392.86265,0.692394485,0.008211932,6.50189E-05,0.452394691,0.021170032,60,12
D:0| T0: 0.17| T1: 12.00| R0: 0.0| R1: 0.0| WTP: 0,0,0.173076923,12,0,0,0,0,0,-1625768516,1868336855,9969.644715,1127286280,112728628,2,78126,3393,841,1656,815,841,78126,815,1656,70.48455285,1.224390244,2.533333333,35174.02114,494.6455285,3.897560976,98659.21626,0.355930501,0.004979726,4.08918E-05,0.49244713,0.021184271,88,12
D:0| T0: 0.17| T1: 12.00| R0: 0.0| R1: 0.0| WTP: 0,0,0.173076923,12,0,0,0,0,0,-1652932665,1868498144,10539.78265,1125943532,112594353.2,2,78671,3390,1020,1751,731,1020,78671,731,1751,78.34758364,1.732342007,3.076208178,36958.7119,606.5037175,4.962825279,98645.6487,0.373873561,0.006106468,5.18939E-05,0.417475728,0.022257249,77,12
D:0| T0: 0.17| T1: 12.00| R0: 0.0| R1: 0.0| WTP: 0,0,0.173076923,12,0,0,0,0,0,-1630784878,2101566889,10113.14263,1125127747,112512774.7,2,79071,3415,986,1680,694,986,79071,694,1680,96.94883721,2.174418605,3.758139535,69264.12558,1038.251163,6.048837209,99391.07674,0.694121869,0.010446478,6.23689E-05,0.413095238,0.021246728,62,12
D:0| T0: 0.17| T1: 12.00| R0: 0.0| R1: 0.0| WTP: 0,0,0.173076923,12,0,0,0,0,0,-1793116394,1665097450,13001.34028,1143049380,114304938,2,98303,4245,438,2160,1722,438,98303,1722,2160,335.0573248,2.732484076,13.63694268,28653.10191,2147.821656,16.41401274,98558.82803,0.28833457,0.021555904,0.000166186,0.797222222,0.02197288,23,12
D:0| T0: 0.17| T1: 12.00| R0: 0.0| R1: 0.0| WTP: 0,0,0.173076923,12,0,0,0,0,0,-1708325733,1716179948,11242.80387,1146185540,114618554,2,98040,4376,478,1867,1389,478,98040,1389,1867,349.6815287,2.98089172,11.75159236,31126.16561,2151.77707,14.78343949,98819.96815,0.312876334,0.021562003,0.000149784,0.74397429,0.019043248,23,12
D:0| T0: 0.17| T1: 12.00| R0: 0.0| R1: 0.0| WTP: 0,0,0.173076923,12,0,0,0,0,0,-1073426766,1560278715,391.0284409,1053875344,105387534.4,2,2287,99,65,65,0,65,2287,0,65,7.272151899,0.284810127,0.284810127,98698.39241,47.56962025,0.696202532,99967.28481,0.987315344,0.000475487,8.17863E-06,0,0.028421513,22,12
D:0| T0: 0.17| T1: 12.00| R0: 0.0| R1: 0.0| WTP: 0,0,0.173076923,12,0,0,0,0,0,-1634001445,991019385,10208.61699,1123570596,112357059.6,2,76282,3228,624,1696,1072,624,76282,1072,1696,75.2047532,1.087751371,3.027422303,32480.39671,826.4223035,4.168190128,98536.78062,0.328968869,0.008315572,4.27022E-05,0.632075472,0.022233292,79,12
D:0| T0: 0.17| T1: 12.00| R0: 0.0| R1: 0.0| WTP: 0,0,0.173076923,12,0,0,0,0,0,-1721410832,118052103,11666.96536,1138062564,113806256.4,2,89969,3795,1466,1938,472,1466,89969,472,1938,145.6507463,4.229850746,5.582089552,46702.92537,1355.979104,9.991044776,98933.4,0.469498758,0.013649441,0.00010227,0.243550052,0.021540753,48,12
D:0| T0: 0.17| T1: 12.00| R0: 0.0| R1: 0.0| WTP: 0,0,0.173076923,12,0,0,0,0,0,-1755292451,1209758844,12487.00953,1130941975,113094197.5,2,88204,3609,528,2075,1547,528,88204,1547,2075,273.9515152,3.139393939,12.44848485,40211.76364,1568.357576,15.62424242,98708.38788,0.404832705,0.015744512,0.000158423,0.745542169,0.02352501,24,12
D:0| T0: 0.17| T1: 12.00| R0: 0.0| R1: 0.0| WTP: 0,0,0.173076923,12,0,0,0,0,0,-971295411.4,70671723,132.287538,964681034.5,96468103.45,1,879,37,22,22,0,22,879,0,22,2.096296296,0.096296296,0.096296296,99502.6,40.9037037,0.251851852,99989.91111,0.995132145,0.000408641,3.23562E-06,0,0.025028441,20,11
D:0| T0: 0.17| T1: 12.00| R0: 0.0| R1: 0.0| WTP: 0,0,0.173076923,12,0,0,0,0,0,-615724590.1,1722612191,42.05585974,613621797.1,61362179.71,1,154,7,7,7,0,7,154,0,7,0.339130435,0,0,99925.90435,6.269565217,0.069565217,99997.8,0.999282038,6.45706E-05,1.20693E-06,0,0.045454545,16,7
D:0| T0: 0.17| T1: 12.00| R0: 0.0| R1: 0.0| WTP: 0,0,0.173076923,12,0,0,0,0,0,-1544653067,1968291596,8430.98135,1123104000,112310400,2,72124,3281,947,1400,453,947,72124,453,1400,98.04076739,2.163069544,3.213429257,72927.55875,690.0047962,5.486810552,99519.74101,0.730674124,0.006930708,5.65397E-05,0.323571429,0.019411014,60,12
D:0| T0: 0.17| T1: 12.00| R0: 0.0| R1: 0.0| WTP: 0,0,0.173076923,12,0,0,0,0,0,-1818301287,1877569084,13494.00386,1143601094,114360109.4,2,98396,4145,476,2242,1766,476,98396,1766,2242,326.0802469,2.895061728,13.75308642,28298.09259,1940.851852,16.66666667,98508.96296,0.284748422,0.019488655,0.000168597,0.787689563,0.022785479,24,12
D:0| T0: 0.17| T1: 12.00| R0: 0.0| R1: 0.0| WTP: 0,0,0.173076923,12,0,0,0,0,0,-1805621362,1726322189,13306.75095,1140283814,114028381.4,2,96304,4112,524,2211,1687,524,96304,1687,2211,307.5030303,3.109090909,13.26060606,31480.65455,1982.472727,16.44848485,98571.98788,0.316751669,0.019905308,0.000166567,0.763003166,0.022958548,24,12
D:0| T0: 0.17| T1: 12.00| R0: 0.0| R1: 0.0| WTP: 0,0,0.173076923,12,0,0,0,0,0,-1711603282,307848836,11497.9627,1136705147,113670514.7,2,90240,3972,507,1910,1403,507,90240,1403,1910,304.1552795,3.062111801,11.72049689,39548.54658,1977.285714,14.86956522,98843.35404,0.397740099,0.019823457,0.000150608,0.734554974,0.02116578,23,12
D:0| T0: 0.17| T1: 12.00| R0: 0.0| R1: 0.0| WTP: 0,0,0.173076923,12,0,0,0,0,0,-1748327570,1154000220,12035.59302,1146547919,114654791.9,2,98939,4480,439,1999,1560,439,98939,1560,1999,356.8766234,2.753246753,12.83766234,25431.02597,1673.532468,15.72077922,98620.52597,0.256197708,0.016774105,0.000158844,0.780390195,0.020204368,22,12
D:0| T0: 0.17| T1: 12.00| R0: 0.0| R1: 0.0| WTP: 0,0,0.173076923,12,0,0,0,0,0,-1617345925,2028661055,9837.023227,1125494764,112549476.4,2,75962,3374,995,1634,639,995,75962,639,1634,87.87656904,1.964435146,3.263598326,68590.71548,833.6213389,5.347280335,99359.60669,0.687668239,0.008387533,5.53303E-05,0.391064871,0.021510755,69,12
D:0| T0: 0.17| T1: 12.00| R0: 0.0| R1: 0.0| WTP: 0,0,0.173076923,12,0,0,0,0,0,-1707281831,1629114640,11278.22038,1143370812,114337081.2,2,91899,4152,1246,1873,627,1246,91899,627,1873,149.6457143,3.405714286,5.151428571,50548.00571,1619.368571,8.725714286,99072.34571,0.507443193,0.016296196,8.96608E-05,0.334757074,0.020381071,50,12
D:0| T0: 0.17| T1: 12.00| R0: 0.0| R1: 0.0| WTP: 0,0,0.173076923,12,0,0,0,0,0,-1789156755,1439048174,12952.84406,1141514553,114151455.3,2,97218,4091,501,2152,1651,501,97218,1651,2152,320.6583851,3.049689441,13.26708075,31550.6646,2571.826087,16.38509317,98626.93789,0.317283489,0.025819004,0.000165513,0.767193309,0.022135818,23,12
D:0| T0: 0.17| T1: 12.00| R0: 0.0| R1: 0.0| WTP: 0,0,0.173076923,12,0,0,0,0,0,-1817342265,865227006,13487.76317,1142954106,114295410.6,2,99171,4141,440,2241,1801,440,99171,1801,2241,253.4975845,2.062801932,10.73429952,18111.4058,1287.507246,12.87439614,98252.28502,0.182903911,0.012941058,0.000130328,0.803659081,0.022597332,30,12
D:0| T0: 0.17| T1: 12.00| R0: 0.0| R1: 0.0| WTP: 0,0,0.173076923,12,0,0,0,0,0,-1661418970,890479738,10560.35419,1133401260,113340126,2,84819,3643,1246,1754,508,1246,84819,508,1754,95.95247934,2.448347107,3.473140496,34067.52686,1251.450413,6.033057851,98689.05992,0.343961648,0.012598693,6.24311E-05,0.289623717,0.020679329,70,12
D:0| T0: 0.17| T1: 12.00| R0: 0.0| R1: 0.0| WTP: 0,0,0.173076923,12,0,0,0,0,0,-1634614113,1017049163,10120.21562,1128603332,112860333.2,2,81720,3606,854,1681,827,854,81720,827,1681,116.3121693,2.12962963,4.283068783,67439.57672,772.9417989,6.558201058,99376.78042,0.675859682,0.007773029,6.74377E-05,0.491969066,0.02057024,54,12
D:0| T0: 0.17| T1: 12.00| R0: 0.0| R1: 0.0| WTP: 0,0,0.173076923,12,0,0,0,0,0,-1603876553,1707305064,9566.822711,1125535418,112553541.8,2,76046,3369,1022,1589,567,1022,76046,567,1589,91.5664488,2.132897603,3.339869281,69727.63181,871.795207,5.566448802,99417.1634,0.698801745,0.008766445,5.7211E-05,0.356828194,0.020895248,66,12
D:0| T0: 0.17| T1: 12.00| R0: 0.0| R1: 0.0| WTP: 0,0,0.173076923,12,0,0,0,0,0,-1817912626,400145663,13458.37785,1144993733,114499373.3,2,99063,4296,416,2236,1820,416,99063,1820,2236,305.3125,2.301136364,12.61363636,21244.23864,1511.471591,14.97727273,98336.77273,0.214354435,0.015179205,0.000151496,0.813953488,0.022571495,26,12
D:0| T0: 0.17| T1: 12.00| R0: 0.0| R1: 0.0| WTP: 0,0,0.173076923,12,0,0,0,0,0,-1059190518,1662654181,120.5449117,1053163273,105316327.3,2,1480,66,20,20,0,20,1480,0,20,5.328947368,0.052631579,0.052631579,99122.46053,39.46710526,0.171052632,99990.11842,0.99133241,0.000394407,2.61462E-06,0,0.01352265,22,12
D:0| T0: 0.17| T1: 12.00| R0: 0.0| R1: 0.0| WTP: 0,0,0.173076923,12,0,0,0,0,0,-1765833487,182136456,12413.50839,1145158067,114515806.7,2,98235,4374,473,2062,1589,473,98235,1589,2062,333.2037037,2.87037037,12.62345679,28120.00617,2101.364198,15.5308642,98623.17284,0.282984097,0.021080113,0.000157104,0.770611057,0.020990482,24,12
D:0| T0: 0.17| T1: 12.00| R0: 0.0| R1: 0.0| WTP: 0,0,0.173076923,12,0,0,0,0,0,-1552986590,979575387,8599.165932,1123028293,112302829.3,2,72352,3193,1054,1428,374,1054,72352,374,1428,78.13819578,1.925143954,2.623800384,69790.55854,935.5950096,4.637236084,99443.13052,0.699620369,0.009404702,4.78869E-05,0.261904762,0.019736842,75,12
D:0| T0: 0.17| T1: 12.00| R0: 0.0| R1: 0.0| WTP: 0,0,0.173076923,12,0,0,0,0,0,-1676568691,2142525414,10990.42981,1127047201,112704720.1,2,81408,3435,589,1826,1237,589,81408,1237,1826,242.0786517,3.219101124,10.10674157,46116.13483,1792.342697,13.41573034,98906.19101,0.464172963,0.017977844,0.000136157,0.677808219,0.022417944,26,12
D:0| T0: 0.17| T1: 12.00| R0: 0.0| R1: 0.0| WTP: 0,0,0.173076923,12,0,0,0,0,0,-1675579083,1464057597,10801.34008,1135512079,113551207.9,2,86250,3716,1418,1794,376,1418,86250,376,1794,139.5970588,4.026470588,5.088235294,48485.47353,950.2235294,9.282352941,98993.74412,0.487600572,0.00956003,9.50225E-05,0.209587514,0.0208,49,12
D:0| T0: 0.17| T1: 12.00| R0: 0.0| R1: 0.0| WTP: 0,0,0.173076923,12,0,0,0,0,0,-1711532289,364562610,11580.68812,1132497883,113249788.3,2,87956,3757,530,1924,1394,530,87956,1394,1924,266.3275862,2.965517241,10.93678161,39138.09195,1709.189655,14,98782.65517,0.394011626,0.017143152,0.000141569,0.724532225,0.021874574,25,12
D:0| T0: 0.17| T1: 12.00| R0: 0.0| R1: 0.0| WTP: 0,0,0.173076923,12,0,0,0,0,0,-1645035126,40350784,10413.06363,1124381944,112438194.4,2,77157,3269,607,1730,1123,607,77157,1123,1730,191.6451613,2.705069124,7.834101382,44806.46083,1375.115207,10.62672811,98849.58986,0.451683664,0.013799356,0.000108144,0.649132948,0.022421815,31,12
D:0| T0: 0.17| T1: 12.00| R0: 0.0| R1: 0.0| WTP: 0,0,0.173076923,12,0,0,0,0,0,-1635858823,804064356,9890.023559,1141357645,114135764.5,2,89264,4116,438,1642,1204,438,89264,1204,1642,292.2011173,2.379888268,9.072625698,36867.4581,1444.03352,11.50837989,98925.40223,0.370984933,0.014467612,0.000116487,0.733252132,0.018394874,26,12
D:0| T0: 0.17| T1: 12.00| R0: 0.0| R1: 0.0| WTP: 0,0,0.173076923,12,0,0,0,0,0,-1365242836,2125493986,5507.44031,1089870820,108987082,2,39739,1695,465,915,450,465,39739,450,915,129.6526946,2.670658683,5.335329341,74161.20958,747.3473054,8.089820359,99457.41317,0.745322662,0.007461525,8.25139E-05,0.491803279,0.02302524,24,12
D:0| T0: 0.17| T1: 12.00| R0: 0.0| R1: 0.0| WTP: 0,0,0.173076923,12,0,0,0,0,0,-1496629615,23154253,7505.444268,1121357402,112135740.2,2,69089,3151,520,1246,726,520,69089,726,1246,206.6326531,2.530612245,6.198979592,51807.43878,939.2806122,8.887755102,99194.58673,0.521410498,0.009399503,9.02E-05,0.582664526,0.018034709,28,12
D:0| T0: 0.17| T1: 12.00| R0: 0.0| R1: 0.0| WTP: 0,0,0.173076923,12,0,0,0,0,0,-1598779373,1391367689,9511.975406,1123180603,112318060.3,2,74362,3181,933,1580,647,933,74362,647,1580,92.85649203,1.993166287,3.437357631,66125.69932,570.1047836,5.564920273,99314.83144,0.663362776,0.005734196,5.75578E-05,0.409493671,0.021247411,63,12
D:0| T0: 0.17| T1: 12.00| R0: 0.0| R1: 0.0| WTP: 0,0,0.173076923,12,0,0,0,0,0,-1700299025,574142276,11317.28692,1134434679,113443467.9,2,87624,3793,1083,1880,797,1083,87624,797,1880,144.7169231,3.175384615,5.6,59431.62154,1240.824615,8.941538462,99191.63385,0.596286134,0.012485862,9.17053E-05,0.42393617,0.021455309,47,12
D:0| T0: 0.17| T1: 12.00| R0: 0.0| R1: 0.0| WTP: 0,0,0.173076923,12,0,0,0,0,0,-701611202.7,898736779,6.039854375,701309210,70130921,1,92,4,1,1,0,1,92,0,1,0.578947368,0,0,99953.01754,5.789473684,0.00877193,99999.17544,0.999539648,5.9218E-05,1.73913E-07,0,0.010869565,17,8
D:0| T0: 0.17| T1: 12.00| R0: 0.0| R1: 0.0| WTP: 0,0,0.173076923,12,0,0,0,0,0,-1644252016,346473503,9987.560531,1144873990,114487399,2,91324,4306,1278,1658,380,1278,91324,380,1658,147.8038674,3.41160221,4.41160221,43122.97514,1438.51105,7.936464088,99036.71271,0.43355156,0.01446199,8.15528E-05,0.229191797,0.01815514,52,12
D:0| T0: 0.17| T1: 12.00| R0: 0.0| R1: 0.0| WTP: 0,0,0.173076923,12,0,0,0,0,0,-1693457587,445552282,11161.5398,1135380597,113538059.7,2,88825,3895,1333,1854,521,1333,88825,521,1854,131.1468144,3.537396122,4.941828255,50271.73684,1409.085873,8.650969529,99012.10803,0.505443839,0.014185395,8.88447E-05,0.281014024,0.020872502,51,12
D:0| T0: 0.17| T1: 12.00| R0: 0.0| R1: 0.0| WTP: 0,0,0.173076923,12,0,0,0,0,0,-1746013496,911758476,11946.23269,1148701861,114870186.1,1,99146,4479,437,1984,1547,437,99146,1547,1984,396.7676056,2.985915493,13.83098592,27636.58451,1954.535211,16.9084507,98686.9507,0.278200211,0.019581078,0.000170959,0.779737903,0.020010893,21,12
D:0| T0: 0.17| T1: 12.00| R0: 0.0| R1: 0.0| WTP: 0,0,0.173076923,12,0,0,0,0,0,-1703228299,1464197940,11111.20923,1147667838,114766783.8,2,93996,4382,552,1845,1293,552,93996,1293,1845,311.6256983,3.005586592,10.18994413,33594.05028,3063.877095,13.24581006,98820.50279,0.337879763,0.03073005,0.000134389,0.700813008,0.019628495,26,12
D:0| T0: 0.17| T1: 12.00| R0: 0.0| R1: 0.0| WTP: 0,0,0.173076923,12,0,0,0,0,0,-1676428441,500405854,10848.7236,1133992261,113399226.1,2,84101,3736,1080,1802,722,1080,84101,722,1802,125.7479893,2.742627346,4.643431635,60810.86595,916.3726542,7.54155496,99204.80429,0.610394465,0.009222743,7.77263E-05,0.400665927,0.021426618,54,12
D:0| T0: 0.17| T1: 12.00| R0: 0.0| R1: 0.0| WTP: 0,0,0.173076923,12,0,0,0,0,0,-1741474068,772037341,12110.26047,1135961044,113596104.4,2,92766,3897,464,2012,1548,464,92766,1548,2012,293.5333333,2.739393939,12.06666667,35320.81818,1842.612121,14.87272727,98710.27879,0.355418127,0.018482671,0.000150624,0.769383698,0.021688981,24,12
D:0| T0: 0.17| T1: 12.00| R0: 0.0| R1: 0.0| WTP: 0,0,0.173076923,12,0,0,0,0,0,-967790505.6,1543158763,66.16145856,964482432.7,96448243.27,1,464,23,11,11,0,11,464,0,11,1.379562044,0.02189781,0.02189781,99731.39416,15.99270073,0.102189781,99993.85401,0.997379249,0.000161025,1.59428E-06,0,0.023706897,20,11
D:0| T0: 0.17| T1: 12.00| R0: 0.0| R1: 0.0| WTP: 0,0,0.173076923,12,0,0,0,0,0,-1832721565,1604932531,13782.2358,1143609775,114360977.5,1,98721,4189,442,2290,1848,442,98721,1848,2290,361.6438356,2.938356164,15.55479452,28998.41781,1995.582192,18.5890411,98497.54795,0.291808024,0.020024328,0.000187945,0.8069869,0.023196686,21,12
D:0| T0: 0.17| T1: 12.00| R0: 0.0| R1: 0.0| WTP: 0,0,0.173076923,12,0,0,0,0,0,-1649480078,539051477,10402.6954,1129345308,112934530.8,2,78175,3463,711,1728,1017,711,78175,1017,1728,78.61022928,1.186948854,2.959435626,30824.64374,790.3686067,4.216931217,98515.45326,0.312189221,0.00795567,4.33248E-05,0.588541667,0.022104253,81,12
D:0| T0: 0.17| T1: 12.00| R0: 0.0| R1: 0.0| WTP: 0,0,0.173076923,12,0,0,0,0,0,-1059745690,1743124675,144.3604116,1052527670,105252767,2,733,30,24,24,0,24,733,0,24,2.662420382,0.057324841,0.057324841,99529.2293,15.29299363,0.21656051,99986.01911,0.99543861,0.000153751,3.03832E-06,0,0.032742156,23,12
D:0| T0: 0.17| T1: 12.00| R0: 0.0| R1: 0.0| WTP: 0,0,0.173076923,12,0,0,0,0,0,-1732094690,1965983789,11930.17036,1135586172,113558617.2,2,89075,3804,985,1982,997,985,89075,997,1982,141.2514793,2.75739645,5.665680473,60911.41716,1544.130178,8.603550296,99201.06509,0.61046959,0.015549621,8.83746E-05,0.503027245,0.022250912,49,12
D:0| T0: 0.17| T1: 12.00| R0: 0.0| R1: 0.0| WTP: 0,0,0.173076923,12,0,0,0,0,0,-1696394724,516774280,11268.74514,1132957467,113295746.7,2,86090,3702,1038,1872,834,1038,86090,834,1872,114.0987654,2.432098765,4.451851852,62231.0963,1368.925926,7.014814815,99236.15556,0.62388913,0.01378434,7.23375E-05,0.445512821,0.021744938,57,12
D:0| T0: 0.17| T1: 12.00| R0: 0.0| R1: 0.0| WTP: 0,0,0.173076923,12,0,0,0,0,0,-1770813887,86603142,12497.83911,1145921932,114592193.2,2,98877,4264,422,2076,1654,422,98877,1654,2076,296.4565217,2.239130435,11.19565217,20627.42391,1394.456522,13.48913043,98429.9837,0.20817992,0.013998365,0.000136404,0.79672447,0.020995783,27,12
D:0| T0: 0.17| T1: 12.00| R0: 0.0| R1: 0.0| WTP: 0,0,0.173076923,12,0,0,0,0,0,-965989593.7,1431870609,30.13122792,964483032.3,96448303.23,1,447,16,5,5,0,5,447,0,5,1.467153285,0,0,99737.33577,22.10948905,0.03649635,99997.13139,0.997406558,0.000221746,7.24652E-07,0,0.011185682,20,11
D:0| T0: 0.17| T1: 12.00| R0: 0.0| R1: 0.0| WTP: 0,0,0.173076923,12,0,0,0,0,0,-1639338713,1592383984,10163.3193,1131172748,113117274.8,2,81073,3556,1343,1688,345,1343,81073,345,1688,124.7368421,3.559556787,4.490304709,51333.62604,657.5069252,8.202216066,99036.44044,0.516734709,0.006613525,8.44467E-05,0.204383886,0.020820999,52,12
D:0| T0: 0.17| T1: 12.00| R0: 0.0| R1: 0.0| WTP: 0,0,0.173076923,12,0,0,0,0,0,-1648492627,1440183867,10219.29127,1137528064,113752806.4,2,86452,3915,1030,1697,667,1030,86452,667,1697,147.041791,2.928358209,4.88358209,60052.47164,1245.856716,7.913432836,99282.93134,0.602294539,0.012524322,8.18251E-05,0.393046553,0.019629617,48,12
D:0| T0: 0.17| T1: 12.00| R0: 0.0| R1: 0.0| WTP: 0,0,0.173076923,12,0,0,0,0,0,-1719779776,1696510588,11666.13852,1136472850,113647285,2,90820,3896,779,1938,1159,779,90820,1159,1938,148.4587156,2.262996942,5.764525994,63928.76147,1310.122324,8.137614679,99303.37309,0.640084246,0.013180839,8.36204E-05,0.598039216,0.021338912,47,12
D:0| T0: 0.17| T1: 12.00| R0: 0.0| R1: 0.0| WTP: 0,0,0.173076923,12,0,0,0,0,0,-1685307170,895039877,11052.31845,1132691247,113269124.7,2,84960,3665,585,1836,1251,585,84960,1251,1836,258.6833333,3.166666667,10.04444444,41431.86111,2474.083333,13.27777778,98867.96111,0.417092038,0.024810047,0.000134988,0.681372549,0.021610169,26,12
D:0| T0: 0.17| T1: 12.00| R0: 0.0| R1: 0.0| WTP: 0,0,0.173076923,12,0,0,0,0,0,-1763722586,129565953,12549.05312,1136269930,113626993,2,89039,3811,1237,2085,848,1237,89039,848,2085,120.5353535,2.984848485,5.090909091,54491.65657,1583.646465,8.204545455,99007.63384,0.5469955,0.015959647,8.45237E-05,0.406714628,0.023416705,56,12
D:0| T0: 0.17| T1: 12.00| R0: 0.0| R1: 0.0| WTP: 0,0,0.173076923,12,0,0,0,0,0,-1648089778,1902565669,10260.40099,1135069728,113506972.8,2,87291,3926,752,1704,952,752,87291,952,1704,135.5847458,2.019774011,4.675141243,63550.12429,943.8700565,6.788135593,99343.29661,0.636555486,0.009489532,6.97592E-05,0.558685446,0.019520913,51,12
D:0| T0: 0.17| T1: 12.00| R0: 0.0| R1: 0.0| WTP: 0,0,0.173076923,12,0,0,0,0,0,-1693659105,1984179288,11226.50524,1132333843,113233384.3,2,84548,3649,1015,1865,850,1015,84548,850,1865,100.5745614,2.122807018,3.947368421,62463.66447,1401.41886,6.168859649,99238.92544,0.626098478,0.014108717,6.36088E-05,0.455764075,0.022058476,66,12
D:0| T0: 0.17| T1: 12.00| R0: 0.0| R1: 0.0| WTP: 0,0,0.173076923,12,0,0,0,0,0,-1713596464,677377223,11564.04183,1135394373,113539437.3,2,89539,3701,1569,1921,352,1569,89539,352,1921,117.3391521,3.765586035,4.620947631,42707.4788,1810.274314,8.543640898,98840.13466,0.429664527,0.018234122,8.76453E-05,0.183237897,0.021454338,57,12
D:0| T0: 0.17| T1: 12.00| R0: 0.0| R1: 0.0| WTP: 0,0,0.173076923,12,0,0,0,0,0,-1714321935,973583301,11416.32396,1143505737,114350573.7,2,94041,4211,1099,1896,797,1099,94041,797,1896,155.0560472,3.100294985,5.421828909,50809.74336,2254.182891,8.663716814,99086.99705,0.50944613,0.022686541,8.8889E-05,0.42035865,0.020161419,49,12
D:0| T0: 0.17| T1: 12.00| R0: 0.0| R1: 0.0| WTP: 0,0,0.173076923,12,0,0,0,0,0,-1629639748,781062938,9764.147834,1141432356,114143235.6,2,88265,4158,1063,1621,558,1063,88265,558,1621,149.0172911,2.910662824,4.4870317,58584.42075,1171.682997,7.553314121,99298.43516,0.587579181,0.011777023,7.77294E-05,0.344231956,0.01836515,50,12
D:0| T0: 0.17| T1: 12.00| R0: 0.0| R1: 0.0| WTP: 0,0,0.173076923,12,0,0,0,0,0,-1713004809,338783425,11392.18827,1143395396,114339539.6,2,94722,4208,919,1892,973,919,94722,973,1892,144.0491803,2.379781421,4.99726776,53680.56557,2110.191257,7.505464481,99155.15301,0.537663389,0.021239652,7.73037E-05,0.514270613,0.01997424,53,12
D:0| T0: 0.17| T1: 12.00| R0: 0.0| R1: 0.0| WTP: 0,0,0.173076923,12,0,0,0,0,0,-1645062991,1027579040,10188.64055,1135630963,113563096.3,2,84501,3827,1005,1692,687,1005,84501,687,1692,107.9035874,2.150224215,3.659192825,67372.70628,1437.020179,5.912556054,99401.07175,0.674789546,0.01445861,6.08453E-05,0.406028369,0.020023669,63,12
D:0| T0: 0.17| T1: 12.00| R0: 0.0| R1: 0.0| WTP: 0,0,0.173076923,12,0,0,0,0,0,-1740842274,764973813,12033.47932,1139168308,113916830.8,2,92100,4019,1125,1999,874,1125,92100,874,1999,140.4435028,3.053672316,5.47740113,54682.96893,1773.805085,8.655367232,99091.20056,0.548530774,0.017861815,8.88389E-05,0.437218609,0.021704669,50,12
D:0| T0: 0.17| T1: 12.00| R0: 0.0| R1: 0.0| WTP: 0,0,0.173076923,12,0,0,0,0,0,-1760807499,1245753446,12370.88494,1142263252,114226325.2,2,93419,4101,1336,2055,719,1336,93419,719,2055,157.8830769,3.969230769,6.147692308,47972.64615,1951.643077,10.24615385,98944.53538,0.482178964,0.019653856,0.000105069,0.349878345,0.021997666,47,12
D:0| T0: 0.17| T1: 12.00| R0: 0.0| R1: 0.0| WTP: 0,0,0.173076923,12,0,0,0,0,0,-1693317930,1013177794,11226.46888,1131994486,113199448.6,2,85106,3637,1214,1865,651,1214,85106,651,1865,129.8114286,3.305714286,5.117142857,56569.38,1018.317143,8.605714286,99101.94,0.568523594,0.010249588,8.85177E-05,0.349061662,0.021913849,50,12
D:0| T0: 0.17| T1: 12.00| R0: 0.0| R1: 0.0| WTP: 0,0,0.173076923,12,0,0,0,0,0,-1605076656,1395089249,9673.603062,1121396503,112139650.3,2,72312,3119,1075,1607,532,1075,72312,532,1607,84.81075269,2.2,3.31827957,73014.33548,817.0301075,5.610752688,99451.29677,0.731816359,0.00821807,5.80146E-05,0.331051649,0.022223144,67,12
D:0| T0: 0.17| T1: 12.00| R0: 0.0| R1: 0.0| WTP: 0,0,0.173076923,12,0,0,0,0,0,-438852878.3,1339545835,12.01008238,438252374.2,43825237.42,1,66,0,2,2,0,2,66,0,2,0,0,0,99962.31579,4.557894737,0.021052632,99998.72632,0.99963791,4.76049E-05,4.16669E-07,0,0.03030303,14,5
D:0| T0: 0.17| T1: 12.00| R0: 0.0| R1: 0.0| WTP: 0,0,0.173076923,12,0,0,0,0,0,-1716158222,219139554,11410.78146,1145619149,114561914.9,2,95408,4273,467,1895,1428,467,95408,1428,1895,366.147651,3.060402685,12.57718121,32898,1681.52349,15.7114094,98779.59732,0.331041421,0.016848896,0.000158928,0.753562005,0.019862066,22,12
D:0| T0: 0.17| T1: 12.00| R0: 0.0| R1: 0.0| WTP: 0,0,0.173076923,12,0,0,0,0,0,-1654992760,1336508942,10558.10922,1127087299,112708729.9,2,81311,3577,859,1754,895,859,81311,895,1754,119.1972222,2.247222222,4.702777778,69778.52222,915,7.108333333,99408.46944,0.699085653,0.009201315,7.30089E-05,0.510262258,0.021571497,52,12
D:0| T0: 0.17| T1: 12.00| R0: 0.0| R1: 0.0| WTP: 0,0,0.173076923,12,0,0,0,0,0,-703999557.1,448559423,54.07595311,701295759.4,70129575.94,1,162,4,9,9,0,9,162,0,9,0.434782609,0.017391304,0.017391304,99910.31304,10.29565217,0.095652174,99997.29565,0.999132373,0.000104226,1.55178E-06,0,0.055555556,17,8
D:0| T0: 0.17| T1: 12.00| R0: 0.0| R1: 0.0| WTP: 0,0,0.173076923,12,0,0,0,0,0,-1692141260,2110028840,11025.04485,1140889017,114088901.7,2,90915,4127,932,1831,899,932,90915,899,1831,150.7088235,2.591176471,5.197058824,60848.16176,1310.129412,7.923529412,99276.47941,0.609695476,0.013180732,8.17447E-05,0.490988531,0.020139691,49,12
D:0| T0: 0.17| T1: 12.00| R0: 0.0| R1: 0.0| WTP: 0,0,0.173076923,12,0,0,0,0,0,-1779265616,1982030155,12878.92528,1135319352,113531935.2,2,91265,3834,984,2140,1156,984,91265,1156,2140,133.720339,2.641242938,5.86440678,56479.70056,1703.177966,8.663841808,99058.50565,0.566230813,0.017161037,8.89179E-05,0.540186916,0.0234482,51,12
D:0| T0: 0.17| T1: 12.00| R0: 0.0| R1: 0.0| WTP: 0,0,0.173076923,12,0,0,0,0,0,-1735274274,696219407,12037.64017,1133392265,113339226.5,2,85987,3717,1188,2000,812,1188,85987,812,2000,130.2627119,3.217514124,5.466101695,52601.46328,809.1553672,8.836158192,98950.65537,0.528678273,0.008149767,9.06489E-05,0.406,0.02325933,51,12
D:0| T0: 0.17| T1: 12.00| R0: 0.0| R1: 0.0| WTP: 0,0,0.173076923,12,0,0,0,0,0,-1640555009,1402539442,10110.22482,1135043768,113504376.8,2,84633,3787,550,1679,1129,550,84633,1129,1679,272.6497175,3.02259887,9.355932203,43003.33333,2190.231638,12.43502825,98975.21469,0.432619485,0.0219499,0.000126287,0.672424062,0.019838597,26,12
D:0| T0: 0.17| T1: 12.00| R0: 0.0| R1: 0.0| WTP: 0,0,0.173076923,12,0,0,0,0,0,-1644384773,1319833493,10276.91729,1130538908,113053890.8,2,82075,3681,610,1707,1097,610,82075,1097,1707,200.6238938,2.628318584,7.446902655,39240.15487,2452.216814,10.13274336,98833.97788,0.395537733,0.024611207,0.00010295,0.64264792,0.020798051,33,12
D:0| T0: 0.17| T1: 12.00| R0: 0.0| R1: 0.0| WTP: 0,0,0.173076923,12,0,0,0,0,0,-1715510424,663608076,11599.83159,1135518844,113551884.4,2,87803,3872,951,1927,976,951,87803,976,1927,123.1340206,2.329896907,4.81443299,58387.68299,1369.074742,7.25,99150.74227,0.58543889,0.013782395,7.46843E-05,0.506486767,0.021946858,56,12
D:0| T0: 0.17| T1: 12.00| R0: 0.0| R1: 0.0| WTP: 0,0,0.173076923,12,0,0,0,0,0,-1660410989,414696500,10607.20931,1130050524,113005052.4,2,81272,3571,999,1762,763,999,81272,763,1762,96.51298701,2.075757576,3.699134199,67698.3961,1209.322511,5.854978355,99350.91558,0.678353746,0.012172348,6.01585E-05,0.433030647,0.021680283,65,12
D:0| T0: 0.17| T1: 12.00| R0: 0.0| R1: 0.0| WTP: 0,0,0.173076923,12,0,0,0,0,0,-1628097132,1249738535,10183.25384,1118934439,111893443.9,2,71122,3032,1066,1692,626,1066,71122,626,1692,85.90681818,2.313636364,3.704545455,75230.40455,646.6136364,6.106818182,99452.18409,0.754065869,0.006507283,6.30628E-05,0.369976359,0.023790442,63,12
D:0| T0: 0.17| T1: 12.00| R0: 0.0| R1: 0.0| WTP: 0,0,0.173076923,12,0,0,0,0,0,-1673336303,614415382,10853.61646,1130655480,113065548,2,80993,3531,971,1803,832,971,80993,832,1803,109.997555,2.251833741,4.246943765,64653.24939,1260.080685,6.628361858,99269.65526,0.64817906,0.012683256,6.82698E-05,0.461453134,0.022261183,59,12
D:0| T0: 0.17| T1: 12.00| R0: 0.0| R1: 0.0| WTP: 0,0,0.173076923,12,0,0,0,0,0,-1053777913,524899953,30.17395319,1052269216,105226921.6,2,480,29,5,5,0,5,480,0,5,1.516129032,0,0,99677.98387,14.65053763,0.02688172,99996.71505,0.99681847,0.000148025,5.3477E-07,0,0.010438413,27,12
D:0| T0: 0.17| T1: 12.00| R0: 0.0| R1: 0.0| WTP: 0,0,0.173076923,12,0,0,0,0,0,-1780878257,1338977757,12660.58602,1147848956,114784895.6,2,98967,4419,403,2103,1700,403,98967,1700,2103,361.6623377,2.545454545,13.53896104,26152.23377,1689.824675,16.16233766,98549.27273,0.263361216,0.016945494,0.000163349,0.808368997,0.021249507,22,12
D:0| T0: 0.17| T1: 12.00| R0: 0.0| R1: 0.0| WTP: 0,0,0.173076923,12,0,0,0,0,0,-1645710601,341384587,10377.79317,1126820943,112682094.3,2,78975,3373,518,1724,1206,518,78975,1206,1724,230.9679144,2.695187166,9.096256684,43613.90909,1431.032086,11.86631016,98861.60428,0.439601863,0.01434678,0.000120265,0.699535963,0.021829693,27,12
D:0| T0: 0.17| T1: 12.00| R0: 0.0| R1: 0.0| WTP: 0,0,0.173076923,12,0,0,0,0,0,-1754284729,2032000160,12356.90898,1136439279,113643927.9,2,90429,3800,1153,2053,900,1153,90429,900,2053,149.9375,3.440625,6.215625,58631.38437,1906.753125,9.815625,99148.39063,0.587953575,0.019201131,0.000100868,0.438382854,0.022703145,46,12
D:0| T0: 0.17| T1: 12.00| R0: 0.0| R1: 0.0| WTP: 0,0,0.173076923,12,0,0,0,0,0,-1612527684,779488939,9752.608197,1124897274,112489727.4,2,76361,3330,571,1620,1049,571,76361,1049,1620,112.5882353,1.449197861,4.219251337,36485.24332,775.5534759,5.759358289,98702.04813,0.368754564,0.007794193,5.89089E-05,0.647530864,0.021215574,54,12
D:0| T0: 0.17| T1: 12.00| R0: 0.0| R1: 0.0| WTP: 0,0,0.173076923,12,0,0,0,0,0,-1716922810,1449019578,11742.10841,1129817389,112981738.9,2,86215,3661,986,1951,965,986,86215,965,1951,110.1995012,2.326683292,4.698254364,61934.49875,1342.620948,7.159600998,99195.32668,0.620900529,0.013523116,7.37612E-05,0.494618145,0.022629473,57,12
D:0| T0: 0.17| T1: 12.00| R0: 0.0| R1: 0.0| WTP: 0,0,0.173076923,12,0,0,0,0,0,-1532955150,351952211,8196.77529,1123116386,112311638.6,2,72063,3333,979,1361,382,979,72063,382,1361,90.67627494,2.064301552,2.873614191,72873.88692,711.2017738,5.044345898,99519.21951,0.730187973,0.007146811,5.21206E-05,0.280882353,0.018872376,65,12
D:0| T0: 0.17| T1: 12.00| R0: 0.0| R1: 0.0| WTP: 0,0,0.173076923,12,0,0,0,0,0,-1681310586,486595046,10968.46622,1132887275,113288727.5,2,83857,3711,1061,1822,761,1061,83857,761,1822,95.83609959,2.099585062,3.649377593,67227.04149,1444.701245,5.846473029,99345.79668,0.673485647,0.014547079,6.02335E-05,0.417672887,0.021727465,67,12
D:0| T0: 0.17| T1: 12.00| R0: 0.0| R1: 0.0| WTP: 0,0,0.173076923,12,0,0,0,0,0,-1685730274,296745624,11017.20664,1134869942,113486994.2,2,87053,3806,1220,1830,610,1220,87053,610,1830,133.056338,3.267605634,4.94084507,49050.98592,1206.309859,8.397183099,98986.9493,0.49377356,0.012139761,8.64807E-05,0.333333333,0.021022642,51,12
D:0| T0: 0.17| T1: 12.00| R0: 0.0| R1: 0.0| WTP: 0,0,0.173076923,12,0,0,0,0,0,-1619235730,1671484194,9819.891677,1128241146,112824114.6,2,78533,3500,957,1631,674,957,78533,674,1631,115.3614776,2.401055409,4.137203166,67847.13456,1059.891821,6.654353562,99379.32718,0.680112274,0.010658199,6.86542E-05,0.413243409,0.020768339,55,12
D:0| T0: 0.17| T1: 12.00| R0: 0.0| R1: 0.0| WTP: 0,0,0.173076923,12,0,0,0,0,0,-1739579655,422157396,11879.18551,1145620380,114562038,2,98334,4369,476,1973,1497,476,98334,1497,1973,303.9050279,2.592178771,10.92178771,26113.46927,2049.960894,13.58100559,98631.15642,0.262861855,0.020571472,0.000137384,0.758743031,0.020064271,26,12
D:0| T0: 0.17| T1: 12.00| R0: 0.0| R1: 0.0| WTP: 0,0,0.173076923,12,0,0,0,0,0,-1788122914,1916599091,12816.58979,1147293425,114729342.5,2,98431,4258,447,2129,1682,447,98431,1682,2129,350.1329114,2.753164557,13.34810127,27640.51899,2168.949367,16.1835443,98569.12025,0.278220405,0.021755487,0.000163717,0.790042273,0.021629365,23,12
D:0| T0: 0.17| T1: 12.00| R0: 0.0| R1: 0.0| WTP: 0,0,0.173076923,12,0,0,0,0,0,-1758603969,1005953941,12216.23243,1147792347,114779234.7,2,98342,4312,495,2029,1534,495,98342,1534,2029,368.8013245,3.225165563,13.32450331,30384.56954,2637.046358,16.58940397,98711.46358,0.305556772,0.026435801,0.000167715,0.756037457,0.02063208,22,12
D:0| T0: 0.17| T1: 12.00| R0: 0.0| R1: 0.0| WTP: 0,0,0.173076923,12,0,0,0,0,0,-1746751480,1422765615,12241.99292,1134651835,113465183.5,2,88872,3789,548,2034,1486,548,88872,1486,2034,297.05,3.31875,12.5375,40028.55,1926.55,16.00625,98767.19375,0.402835345,0.019329845,0.000161992,0.730580138,0.022886849,23,12
D:0| T0: 0.17| T1: 12.00| R0: 0.0| R1: 0.0| WTP: 0,0,0.173076923,12,0,0,0,0,0,-1575062749,699740192,9179.476468,1116088926,111608892.6,2,67804,2858,1163,1525,362,1163,67804,362,1525,65.34115523,2.001805054,2.620938628,74272.40975,734.0812274,4.722021661,99461.40072,0.744621738,0.007383736,4.88011E-05,0.237377049,0.022491298,80,12
D:0| T0: 0.17| T1: 12.00| R0: 0.0| R1: 0.0| WTP: 0,0,0.173076923,12,0,0,0,0,0,-877077009.2,240885764,6.0931291,876772352.8,87677235.28,1,99,9,1,1,0,1,99,0,1,1.3046875,0,0,99939.54688,3.9609375,0.0078125,99999.63281,0.999401857,4.1628E-05,1.55039E-07,0,0.01010101,19,10
D:0| T0: 0.17| T1: 12.00| R0: 0.0| R1: 0.0| WTP: 0,0,0.173076923,12,0,0,0,0,0,-1558013028,2023806564,8701.022709,1122961892,112296189.2,2,75094,3377,783,1445,662,783,75094,662,1445,44.1311828,0.716129032,1.419354839,34001.69677,338.6365591,2.253763441,98752.15591,0.344042924,0.003408362,2.41122E-05,0.458448753,0.019230257,133,12
D:0| T0: 0.17| T1: 12.00| R0: 0.0| R1: 0.0| WTP: 0,0,0.173076923,12,0,0,0,0,0,-1603245326,1907493879,9596.169052,1123436873,112343687.3,2,76554,3262,1039,1594,555,1039,76554,555,1594,82.12903226,1.989919355,3.080645161,66716.17944,958.7278226,5.173387097,99349.83065,0.668922129,0.009642935,5.33984E-05,0.348180678,0.020821903,70,12
D:0| T0: 0.17| T1: 12.00| R0: 0.0| R1: 0.0| WTP: 0,0,0.173076923,12,0,0,0,0,0,-1758098065,1565815291,12434.90876,1136352627,113635262.7,2,91786,3843,1080,2066,986,1080,91786,986,2066,148.0895062,3.175925926,6.166666667,57082.74691,2271.311728,9.49382716,99126.04938,0.572236395,0.022871992,9.77699E-05,0.477250726,0.022508879,47,12
D:0| T0: 0.17| T1: 12.00| R0: 0.0| R1: 0.0| WTP: 0,0,0.173076923,12,0,0,0,0,0,-1539117833,784442364,8393.790446,1119428311,111942831.1,2,70361,3109,1083,1394,311,1083,70361,311,1394,84.48464912,2.219298246,2.870614035,71656.29386,815.6907895,5.243421053,99475.92544,0.718401092,0.008196219,5.45769E-05,0.223098996,0.019812112,65,12
D:0| T0: 0.17| T1: 12.00| R0: 0.0| R1: 0.0| WTP: 0,0,0.173076923,12,0,0,0,0,0,-1587873423,206369745,9224.695449,1126638651,112663865.1,2,76998,3447,550,1532,982,550,76998,982,1532,169.09375,2.0703125,5.87109375,41017.04688,1255.609375,8.0234375,98891.95313,0.41366354,0.012598312,8.16381E-05,0.640992167,0.019896621,37,12
D:0| T0: 0.17| T1: 12.00| R0: 0.0| R1: 0.0| WTP: 0,0,0.173076923,12,0,0,0,0,0,-1731680194,2087235992,11811.70151,1141095119,114109511.9,2,94449,4081,555,1962,1407,555,94449,1407,1962,284.9779006,2.983425414,10.68508287,32573.52486,2271.955801,13.75138122,98736.20994,0.327710743,0.022793562,0.00013965,0.717125382,0.020773116,26,12
D:0| T0: 0.17| T1: 12.00| R0: 0.0| R1: 0.0| WTP: 0,0,0.173076923,12,0,0,0,0,0,-1716501622,1019092536,11594.23228,1136790008,113679000.8,2,89919,3880,914,1926,1012,914,89919,1012,1926,134.6952909,2.40166205,5.166204986,59050.67313,1371.963989,7.686980609,99201.35457,0.591810408,0.013810044,7.9198E-05,0.525441329,0.021419277,52,12
D:0| T0: 0.17| T1: 12.00| R0: 0.0| R1: 0.0| WTP: 0,0,0.173076923,12,0,0,0,0,0,-1621367534,1885906113,9992.05741,1121764663,112176466.3,2,77218,3236,1254,1660,406,1254,77218,406,1660,113.0603448,3.445402299,4.57183908,59940.39943,676.7011494,8.172413793,99188.29023,0.602513077,0.006805103,8.41733E-05,0.244578313,0.021497857,50,12
D:0| T0: 0.17| T1: 12.00| R0: 0.0| R1: 0.0| WTP: 0,0,0.173076923,12,0,0,0,0,0,-1645102735,2028637200,10241.82404,1133011533,113301153.3,2,83795,3756,996,1701,705,996,83795,705,1701,104.0201342,2.118568233,3.67114094,56331.44743,721.2662192,5.89261745,99163.62864,0.565456642,0.007255775,6.06958E-05,0.414462081,0.020299541,64,12
D:0| T0: 0.17| T1: 12.00| R0: 0.0| R1: 0.0| WTP: 0,0,0.173076923,12,0,0,0,0,0,-1667965932,181476086,10715.79432,1132176216,113217621.6,2,86746,3824,538,1780,1242,538,86746,1242,1780,263.125,2.965909091,9.960227273,40899.91477,2310.102273,13.02840909,98902.01136,0.411518466,0.023162832,0.000132132,0.697752809,0.020519678,26,12
D:0| T0: 0.17| T1: 12.00| R0: 0.0| R1: 0.0| WTP: 0,0,0.173076923,12,0,0,0,0,0,-1677440935,2097578470,10842.9697,1135292450,113529245,2,85558,3814,584,1801,1217,584,85558,1217,1801,259.1290323,3.059139785,9.548387097,40090.06452,2490.709677,12.67204301,98856.64516,0.403672229,0.024981195,0.000128687,0.675735702,0.021050048,27,12
D:0| T0: 0.17| T1: 12.00| R0: 0.0| R1: 0.0| WTP: 0,0,0.173076923,12,0,0,0,0,0,-1722907403,119646392,11803.12942,1132750932,113275093.2,2,87785,3658,957,1961,1004,957,87785,1004,1961,112.6356968,2.212713936,4.628361858,53807.29584,1353.085575,6.958435208,99029.1687,0.539811697,0.013626647,7.18544E-05,0.511983682,0.022338668,59,12
D:0| T0: 0.17| T1: 12.00| R0: 0.0| R1: 0.0| WTP: 0,0,0.173076923,12,0,0,0,0,0,-1734618665,1298895859,11824.44223,1143396553,114339655.3,2,95331,4196,512,1964,1452,512,95331,1452,1964,353.56,3.333333333,12.93333333,35246.99333,2644.933333,16.35333333,98804.68,0.354356787,0.026513078,0.000165562,0.739307536,0.020601903,22,12
D:0| T0: 0.17| T1: 12.00| R0: 0.0| R1: 0.0| WTP: 0,0,0.173076923,12,0,0,0,0,0,-1661380720,1489316290,10625.05732,1130127854,113012785.4,2,82541,3668,529,1765,1236,529,82541,1236,1765,196.9781659,2.23580786,7.585152838,36935.06987,1254.144105,9.895196507,98727.77729,0.372680879,0.012588425,0.000100605,0.700283286,0.021383313,33,12
D:0| T0: 0.17| T1: 12.00| R0: 0.0| R1: 0.0| WTP: 0,0,0.173076923,12,0,0,0,0,0,-1841061199,855602142,14009.49354,1140586522,114058652.2,2,96194,3955,472,2328,1856,472,96194,1856,2328,236.6604651,2.153488372,10.74883721,26336.70233,1594.795349,12.94418605,98322.34419,0.265324005,0.016043383,0.000131127,0.797250859,0.024201094,31,12
D:0| T0: 0.17| T1: 12.00| R0: 0.0| R1: 0.0| WTP: 0,0,0.173076923,12,0,0,0,0,0,-1706253216,1438649896,11413.80705,1135562863,113556286.3,2,89368,3797,1237,1896,659,1237,89368,659,1896,128.1698113,3.185983827,4.92722372,52983.5283,1221.401617,8.253369272,99062.43396,0.532275805,0.012298173,8.49911E-05,0.34757384,0.021215648,52,12
D:0| T0: 0.17| T1: 12.00| R0: 0.0| R1: 0.0| WTP: 0,0,0.173076923,12,0,0,0,0,0,-1684272123,952489126,11217.64946,1123389650,112338965,2,78282,3202,1108,1864,756,1108,78282,756,1864,75.10074627,1.990671642,3.36380597,63902.37687,1125.958955,5.423507463,99192.18284,0.641057388,0.011341767,5.58635E-05,0.405579399,0.023811349,77,12
D:0| T0: 0.17| T1: 12.00| R0: 0.0| R1: 0.0| WTP: 0,0,0.173076923,12,0,0,0,0,0,-1687488373,1550779155,12652.83926,1054846410,105484641,1,99140,4210,405,2102,1697,405,99140,1697,2102,388.0444444,2.925925926,15.45185185,25772.78519,2053.718519,18.45185185,98562.6,0.259796048,0.020577355,0.00018625,0.807326356,0.02120234,20,11
D:0| T0: 0.17| T1: 12.00| R0: 0.0| R1: 0.0| WTP: 0,0,0.173076923,12,0,0,0,0,0,-1623191327,607323321,9968.933465,1124744653,112474465.3,2,76827,3297,1032,1656,624,1032,76827,624,1656,95.52764977,2.274193548,3.675115207,71047.03917,860.4239631,6.039170507,99424.54147,0.711960242,0.008655857,6.23054E-05,0.376811594,0.021554922,62,12
D:0| T0: 0.17| T1: 12.00| R0: 0.0| R1: 0.0| WTP: 0,0,0.173076923,12,0,0,0,0,0,-1577762126,2103646485,9174.316528,1119046300,111904630,2,70775,3082,992,1524,532,992,70775,532,1524,73.69942197,1.743737958,2.757225434,48402.18882,411.8458574,4.672447013,98914.60116,0.488740769,0.004143227,4.87788E-05,0.349081365,0.021533027,75,12
D:0| T0: 0.17| T1: 12.00| R0: 0.0| R1: 0.0| WTP: 0,0,0.173076923,12,0,0,0,0,0,-1704400483,258120157,11146.97866,1147051550,114705155,2,97711,4438,441,1851,1410,441,97711,1410,1851,336.3151515,2.6,11.09090909,25085.55152,1505.909091,13.77575758,98682.07273,0.25287235,0.015096437,0.000139335,0.761750405,0.018943619,24,12
D:0| T0: 0.17| T1: 12.00| R0: 0.0| R1: 0.0| WTP: 0,0,0.173076923,12,0,0,0,0,0,-1631938819,1068951401,9953.899097,1134243864,113424386.4,2,86713,3832,827,1653,826,827,86713,826,1653,131.5761773,2.180055402,4.432132964,67685.82271,941.7977839,6.720221607,99441.89751,0.67789957,0.009467118,6.90588E-05,0.49969752,0.019062886,52,12
D:0| T0: 0.17| T1: 12.00| R0: 0.0| R1: 0.0| WTP: 0,0,0.173076923,12,0,0,0,0,0,-1684767895,635956235,11052.25642,1132155074,113215507.4,2,85957,3698,973,1836,863,973,85957,863,1836,104.8855835,2.102974828,4.038901602,59484.48055,1491.382151,6.279176201,99193.72311,0.59630735,0.015014061,6.47184E-05,0.470043573,0.021359517,62,12
D:0| T0: 0.17| T1: 12.00| R0: 0.0| R1: 0.0| WTP: 0,0,0.173076923,12,0,0,0,0,0,-1056481164,1346693470,78.31500247,1052565414,105256541.4,1,830,35,13,13,0,13,830,0,13,3.167832168,0.034965035,0.034965035,99510.42657,29.68531469,0.104895105,99993.27972,0.995177696,0.00029731,1.80566E-06,0,0.015662651,21,12
D:0| T0: 0.17| T1: 12.00| R0: 0.0| R1: 0.0| WTP: 0,0,0.173076923,12,0,0,0,0,0,-1790693346,847102011,12959.21789,1142732452,114273245.2,2,98233,4205,472,2153,1681,472,98233,1681,2153,319.4573171,2.817073171,13,28185.04878,2044.310976,15.8597561,98563.80488,0.283633893,0.020520756,0.000160784,0.780771017,0.021917278,24,12
D:0| T0: 0.17| T1: 12.00| R0: 0.0| R1: 0.0| WTP: 0,0,0.173076923,12,0,0,0,0,0,-1796347196,812083272,13162.3056,1138231916,113823191.6,2,92383,3890,1378,2187,809,1378,92383,809,2187,158.8660131,4.359477124,6.941176471,52697.60131,1846.421569,11.46078431,98978.05556,0.528956804,0.018603729,0.000117334,0.369913123,0.023673443,44,12
D:0| T0: 0.17| T1: 12.00| R0: 0.0| R1: 0.0| WTP: 0,0,0.173076923,12,0,0,0,0,0,-1735548578,2146825809,11771.51154,1146973001,114697300.1,2,98874,4500,465,1955,1490,465,98874,1490,1955,310.3202247,2.556179775,10.8988764,22618.65169,1755.179775,13.51123596,98579.26404,0.228024452,0.017605376,0.000136496,0.762148338,0.01977264,26,12
D:0| T0: 0.17| T1: 12.00| R0: 0.0| R1: 0.0| WTP: 0,0,0.173076923,12,0,0,0,0,0,-1786175599,226186520,12851.40519,1143605339,114360533.9,2,97214,4231,468,2135,1667,468,97214,1667,2135,315.2619048,2.726190476,12.57738095,29346.85714,1687.755952,15.35714286,98566.32143,0.29534006,0.016944885,0.00015565,0.780796253,0.021961857,24,12
D:0| T0: 0.17| T1: 12.00| R0: 0.0| R1: 0.0| WTP: 0,0,0.173076923,12,0,0,0,0,0,-1749511848,1110225441,12136.69336,1142677180,114267718,2,94599,4165,1090,2016,926,1090,94599,926,2016,161.7071651,3.246105919,6.080996885,53481.00312,2284.570093,9.485981308,99110.43925,0.535953509,0.022996433,9.73995E-05,0.459325397,0.021311008,46,12
D:0| T0: 0.17| T1: 12.00| R0: 0.0| R1: 0.0| WTP: 0,0,0.173076923,12,0,0,0,0,0,-1672333093,1190767082,10616.96277,1141484954,114148495.4,2,92258,4143,1140,1763,623,1140,92258,623,1763,162.835443,3.452531646,5.370253165,53716.98734,1558.920886,8.984177215,99196.41456,0.53897445,0.015673554,9.23485E-05,0.353374929,0.019109454,46,12
D:0| T0: 0.17| T1: 12.00| R0: 0.0| R1: 0.0| WTP: 0,0,0.173076923,12,0,0,0,0,0,-1679862637,2108234095,11032.96949,1128214163,112821416.3,2,81522,3535,1029,1833,804,1029,81522,804,1833,113.5340314,2.518324607,4.578534031,65359.20681,1309.248691,7.295811518,99274.08115,0.655364599,0.013178261,7.54038E-05,0.438625205,0.022484728,55,12
D:0| T0: 0.17| T1: 12.00| R0: 0.0| R1: 0.0| WTP: 0,0,0.173076923,12,0,0,0,0,0,-1799555940,465621985,13044.7896,1147316460,114731646,2,98735,4381,480,2167,1687,480,98735,1687,2167,334.5272727,2.83030303,13.01212121,26112.41818,2058.369697,15.90909091,98516.55758,0.262930085,0.020662792,0.000161171,0.778495616,0.021947638,24,12
D:0| T0: 0.17| T1: 12.00| R0: 0.0| R1: 0.0| WTP: 0,0,0.173076923,12,0,0,0,0,0,-1625916586,1487072553,9881.106773,1131861247,113186124.7,2,84388,3698,913,1641,728,913,84388,728,1641,132.0344828,2.517241379,4.577586207,65510.88793,870.0603448,7.183908046,99387.49425,0.656665449,0.008745336,7.37592E-05,0.443631932,0.019446815,50,12
D:0| T0: 0.17| T1: 12.00| R0: 0.0| R1: 0.0| WTP: 0,0,0.173076923,12,0,0,0,0,0,-1669723366,1213733847,10864.43804,1126501464,112650146.4,2,81602,3426,1419,1805,386,1419,81602,386,1805,98.79245283,3.200471698,4.070754717,46911.55896,813.1556604,7.412735849,98882.66745,0.472723893,0.00818629,7.65564E-05,0.213850416,0.022119556,61,12
D:0| T0: 0.17| T1: 12.00| R0: 0.0| R1: 0.0| WTP: 0,0,0.173076923,12,0,0,0,0,0,-1686246388,2003658337,11117.86894,1130352941,113035294.1,2,84338,3603,1296,1847,551,1296,84338,551,1847,121.4493151,3.394520548,4.873972603,47407.30685,938.4547945,8.421917808,98896.2274,0.477737228,0.009447361,8.67018E-05,0.298321603,0.021899974,53,12
D:0| T0: 0.17| T1: 12.00| R0: 0.0| R1: 0.0| WTP: 0,0,0.173076923,12,0,0,0,0,0,-1056628393,1170868072,84.26888432,1052414949,105241494.9,1,737,34,14,14,0,14,737,0,14,2.5,0.027777778,0.027777778,99553.38889,29.02777778,0.111111111,99993.40972,0.995606114,0.000290569,1.93116E-06,0,0.018995929,21,12
D:0| T0: 0.17| T1: 12.00| R0: 0.0| R1: 0.0| WTP: 0,0,0.173076923,12,0,0,0,0,0,-1743299024,569919592,11915.80294,1147508877,114750887.7,2,99253,4499,426,1979,1553,426,99253,1553,1979,291.0471204,2.178010471,10.28272251,19861.66492,1353.65445,12.51308901,98501.8377,0.200403918,0.013586368,0.000126488,0.784739768,0.019938944,28,12
D:0| T0: 0.17| T1: 12.00| R0: 0.0| R1: 0.0| WTP: 0,0,0.173076923,12,0,0,0,0,0,-1621714992,1833180623,9726.242488,1135402868,113540286.8,2,84225,3823,1270,1615,345,1270,84225,345,1615,114.1264916,2.871121718,3.656324582,45736.53699,932.9976134,6.6849642,99032.54654,0.46048652,0.009380574,6.92613E-05,0.213622291,0.019174829,60,12
D:0| T0: 0.17| T1: 12.00| R0: 0.0| R1: 0.0| WTP: 0,0,0.173076923,12,0,0,0,0,0,-1812176886,1123666637,13397.49232,1142302270,114230227,2,97045,4088,484,2226,1742,484,97045,1742,2226,292.4382022,2.646067416,12.37640449,26979.19101,1643.123596,15.08988764,98445.79213,0.271790086,0.016507599,0.000153066,0.782569632,0.022937812,26,12
D:0| T0: 0.17| T1: 12.00| R0: 0.0| R1: 0.0| WTP: 0,0,0.173076923,12,0,0,0,0,0,-1649659853,1682024981,10349.6186,1132178923,113217892.3,2,81804,3620,954,1719,765,954,81804,765,1719,86.05783582,1.625,3.024253731,33023.2556,1252.529851,4.811567164,98641.51866,0.333799166,0.012606731,5.02329E-05,0.445026178,0.021013642,76,12
D:0| T0: 0.17| T1: 12.00| R0: 0.0| R1: 0.0| WTP: 0,0,0.173076923,12,0,0,0,0,0,-1722400924,1687523543,11678.87231,1138457309,113845730.9,2,91736,3975,978,1940,962,978,91736,962,1940,160.3398058,3.012944984,6.087378641,58861.98382,1130.022654,9.262135922,99201.8835,0.590013334,0.011372345,9.50031E-05,0.495876289,0.021147641,45,12
D:0| T0: 0.17| T1: 12.00| R0: 0.0| R1: 0.0| WTP: 0,0,0.173076923,12,0,0,0,0,0,-1747916903,178034412,12141.87123,1140823342,114082334.2,2,94595,4091,473,2017,1544,473,94595,1544,2017,302.4882353,2.705882353,11.71176471,32179.84706,1957.470588,14.5,98671.00588,0.323884412,0.01964123,0.000147066,0.765493307,0.02132248,25,12
D:0| T0: 0.17| T1: 12.00| R0: 0.0| R1: 0.0| WTP: 0,0,0.173076923,12,0,0,0,0,0,-1702607857,739490003,11252.80218,1139967748,113996774.8,2,93004,4063,472,1869,1397,472,93004,1397,1869,315.3580247,2.858024691,11.41358025,35432.75926,1602.95679,14.30864198,98812.0679,0.356447524,0.016067527,0.000144941,0.747458534,0.02009591,24,12
D:0| T0: 0.17| T1: 12.00| R0: 0.0| R1: 0.0| WTP: 0,0,0.173076923,12,0,0,0,0,0,-1639287456,178482706,10352.1321,1121680851,112168085.1,2,76464,3316,846,1720,874,846,76464,874,1720,59.14136905,1.123511905,2.40922619,37851.43601,486.6607143,3.671130952,98631.875,0.383245769,0.004901158,3.84766E-05,0.508139535,0.022494246,96,12
D:0| T0: 0.17| T1: 12.00| R0: 0.0| R1: 0.0| WTP: 0,0,0.173076923,12,0,0,0,0,0,-1750487169,1919366370,12343.87387,1133293475,113329347.5,2,89592,3789,1200,2051,851,1200,89592,851,2051,136.6994048,3.43452381,5.919642857,55318.32143,921.5029762,9.505952381,99052.70833,0.555651124,0.009279532,9.74202E-05,0.414919551,0.022892669,48,12
D:0| T0: 0.17| T1: 12.00| R0: 0.0| R1: 0.0| WTP: 0,0,0.173076923,12,0,0,0,0,0,-1718536310,1819796913,11429.23864,1147074378,114707437.8,2,97451,4460,447,1898,1451,447,97451,1451,1898,331.8562874,2.622754491,11.25149701,29956.10778,2402.502994,13.91616766,98757.13174,0.301268217,0.024087167,0.000140892,0.764488936,0.019476455,24,12
D:0| T0: 0.17| T1: 12.00| R0: 0.0| R1: 0.0| WTP: 0,0,0.173076923,12,0,0,0,0,0,-1779410350,1866591913,12725.29107,1143145797,114314579.7,2,96154,4165,865,2114,1249,865,96154,1249,2114,152.0813953,2.401162791,5.994186047,55290.36919,2302.956395,8.523255814,99113.90407,0.5534927,0.023198989,8.7251E-05,0.590823084,0.021985565,50,12
D:0| T0: 0.17| T1: 12.00| R0: 0.0| R1: 0.0| WTP: 0,0,0.173076923,12,0,0,0,0,0,-1766402881,1219425989,12401.84865,1146310448,114631044.8,2,99237,4466,445,2060,1615,445,99237,1615,2060,367.2281879,2.899328859,13.69798658,25378.61074,1725.073826,16.67785235,98582.61074,0.255690659,0.017298075,0.000168699,0.783980583,0.020758386,22,12
D:0| T0: 0.17| T1: 12.00| R0: 0.0| R1: 0.0| WTP: 0,0,0.173076923,12,0,0,0,0,0,-1730400826,502409586,11734.42741,1143679456,114367945.6,2,97438,4267,475,1949,1474,475,97438,1474,1949,306.0287356,2.655172414,11.08045977,28094.3908,2257.413793,13.83333333,98682,0.282737,0.022643698,0.00013985,0.756285274,0.020002463,25,12
D:0| T0: 0.17| T1: 12.00| R0: 0.0| R1: 0.0| WTP: 0,0,0.173076923,12,0,0,0,0,0,-1605992049,1405887957,9608.669848,1125558557,112555855.7,2,76415,3438,512,1596,1084,512,76415,1084,1596,251.7869822,2.940828402,9.313609467,49101.85207,1371.710059,12.32544379,99030.04142,0.494238164,0.013737337,0.000124981,0.679197995,0.020885952,25,12
D:0| T0: 0.17| T1: 12.00| R0: 0.0| R1: 0.0| WTP: 0,0,0.173076923,12,0,0,0,0,0,-1743819079,283033753,12288.32318,1129402920,112940292,2,87277,3583,531,2042,1511,531,87277,1511,2042,255.9884393,2.994219653,11.67052023,38554.0578,1341.491329,14.74566474,98675.24855,0.388482073,0.013467474,0.000149366,0.739960823,0.023396771,25,12
D:0| T0: 0.17| T1: 12.00| R0: 0.0| R1: 0.0| WTP: 0,0,0.173076923,12,0,0,0,0,0,-1715174149,1083157068,11635.377,1133405299,113340529.9,2,85484,3632,1415,1933,518,1415,85484,518,1933,118.6159794,3.461340206,4.760309278,46529.87887,1116.090206,8.427835052,98860.19072,0.469046833,0.011239547,8.69373E-05,0.267977237,0.022612683,56,12
D:0| T0: 0.17| T1: 12.00| R0: 0.0| R1: 0.0| WTP: 0,0,0.173076923,12,0,0,0,0,0,-1691552976,1988704626,11285.00013,1127302970,112730297,2,82353,3439,1220,1875,655,1220,82353,655,1875,126.547619,3.461309524,5.363095238,60560.3869,631.0267857,9.008928571,99146.6756,0.608547753,0.006352039,9.26682E-05,0.349333333,0.022767841,48,12
D:0| T0: 0.17| T1: 12.00| R0: 0.0| R1: 0.0| WTP: 0,0,0.173076923,12,0,0,0,0,0,-1782919123,884761309,12743.97338,1145720455,114572045.5,1,99069,4387,436,2117,1681,436,99069,1681,2117,369.3673469,2.911564626,14.29251701,24302.81633,1752.081633,17.2585034,98511.2381,0.245066138,0.017571463,0.00017431,0.794048181,0.021368945,21,12
D:0| T0: 0.17| T1: 12.00| R0: 0.0| R1: 0.0| WTP: 0,0,0.173076923,12,0,0,0,0,0,-1591203044,533485933,9089.963584,1136704865,113670486.5,2,82525,3856,876,1509,633,876,82525,633,1509,134.3961749,2.278688525,3.980874317,65742.84699,612.7786885,6.368852459,99417.3388,0.658834842,0.006157013,6.5465E-05,0.419483101,0.018285368,53,12
D:0| T0: 0.17| T1: 12.00| R0: 0.0| R1: 0.0| WTP: 0,0,0.173076923,12,0,0,0,0,0,-1697505182,632196071,11328.13189,1131098587,113109858.7,2,84484,3593,846,1882,1036,846,84484,1036,1882,117.8828125,2.0859375,4.763020833,63317.89323,568.40625,6.986979167,99233.67188,0.634901655,0.00572163,7.15041E-05,0.550478215,0.022276407,55,12
D:0| T0: 0.17| T1: 12.00| R0: 0.0| R1: 0.0| WTP: 0,0,0.173076923,12,0,0,0,0,0,-1782394743,393400457,12797.00807,1142544339,114254433.9,2,96342,4175,447,2126,1679,447,96342,1679,2126,304.3430233,2.540697674,12.26162791,30650.72093,1753.767442,14.8372093,98579.56395,0.30840584,0.017605094,0.000150281,0.789746002,0.022067219,25,12
D:0| T0: 0.17| T1: 12.00| R0: 0.0| R1: 0.0| WTP: 0,0,0.173076923,12,0,0,0,0,0,-1666486475,398973227,10756.71502,1128650724,112865072.4,2,82399,3546,541,1787,1246,541,82399,1246,1787,262.9107143,3.136904762,10.48809524,44001.22024,1467.214286,13.69642857,98895.46429,0.443037157,0.014703408,0.000138964,0.697257974,0.021687156,24,12
D:0| T0: 0.17| T1: 12.00| R0: 0.0| R1: 0.0| WTP: 0,0,0.173076923,12,0,0,0,0,0,-1701811654,1402256491,11312.01044,1136211133,113621113.3,2,88972,3825,1425,1879,454,1425,88972,454,1879,145.0942249,4.182370821,5.519756839,49749.81763,1713.656535,9.857142857,99016.98176,0.499865461,0.017244768,0.000101031,0.241617882,0.021119004,47,12
D:0| T0: 0.17| T1: 12.00| R0: 0.0| R1: 0.0| WTP: 0,0,0.173076923,12,0,0,0,0,0,-1673554751,2102527413,10859.48345,1130580579,113058057.9,2,80413,3563,806,1804,998,806,80413,998,1804,52.21247113,0.821016166,1.965357968,27406.36259,537.26097,2.906466513,98408.03926,0.277977679,0.00541354,3.03895E-05,0.553215078,0.0224353,124,12
D:0| T0: 0.17| T1: 12.00| R0: 0.0| R1: 0.0| WTP: 0,0,0.173076923,12,0,0,0,0,0,-1697937485,1748031099,11322.30663,1131822154,113182215.4,2,84841,3585,627,1881,1254,627,84841,1254,1881,219.7368421,2.933014354,8.889952153,39068.20096,2190.023923,11.8708134,98753.89952,0.393695243,0.02199491,0.000120557,0.666666667,0.022170884,30,12
D:0| T0: 0.17| T1: 12.00| R0: 0.0| R1: 0.0| WTP: 0,0,0.173076923,12,0,0,0,0,0,-1686929640,1946754629,11088.3912,1132510081,113251008.1,2,86283,3703,920,1842,922,920,86283,922,1842,136.3816568,2.576923077,5.269230769,63435.50296,973.4408284,7.982248521,99276.2929,0.635912091,0.009793464,8.21986E-05,0.500542888,0.021348354,49,12
D:0| T0: 0.17| T1: 12.00| R0: 0.0| R1: 0.0| WTP: 0,0,0.173076923,12,0,0,0,0,0,-1652895987,2097712204,10392.06432,1133292771,113329277.1,2,84599,3795,1057,1726,669,1057,84599,669,1726,123.1851852,2.653439153,4.391534392,55385.78042,694.952381,7.17989418,99138.83862,0.556205609,0.006990612,7.40371E-05,0.38760139,0.020402132,54,12
D:0| T0: 0.17| T1: 12.00| R0: 0.0| R1: 0.0| WTP: 0,0,0.173076923,12,0,0,0,0,0,-1708367271,1198827119,11556.18754,1130557895,113055789.5,2,85080,3624,936,1920,984,936,85080,984,1920,118.6949602,2.379310345,4.944297082,66691.16976,1452.209549,7.416445623,99311.83554,0.66808094,0.014621508,7.62777E-05,0.5125,0.022566996,54,12
D:0| T0: 0.17| T1: 12.00| R0: 0.0| R1: 0.0| WTP: 0,0,0.173076923,12,0,0,0,0,0,-1557261732,109253198,8807.410376,1116891213,111689121.3,2,66684,2891,1196,1463,267,1196,66684,267,1463,60.06862745,1.843137255,2.263071895,69988.02451,769.3382353,4.22875817,99380.53922,0.702187755,0.007736245,4.3693E-05,0.182501709,0.021939296,87,12
D:0| T0: 0.17| T1: 12.00| R0: 0.0| R1: 0.0| WTP: 0,0,0.173076923,12,0,0,0,0,0,-1655258127,314481292,10487.3099,1130892632,113089263.2,2,81424,3641,849,1742,893,849,81424,893,1742,118.8818898,2.131233596,4.446194226,66951.9895,637.3753281,6.653543307,99341.11286,0.671092384,0.006411455,6.84048E-05,0.512629162,0.021394184,55,12
D:0| T0: 0.17| T1: 16.00| R0: 0.0| R1: 0.0| WTP: 0,0,0.173076923,16,0,0,0,0,0,-1404208000,1178568022,30.12067847,1402701966,140270196.6,2,312,15,5,5,0,5,312,0,5,0.978378378,0,0,99803.42162,8.740540541,0.027027027,99996.95676,0.998068194,8.91422E-05,5.37645E-07,0,0.01607717,26,16
D:0| T0: 0.17| T1: 16.00| R0: 0.0| R1: 0.0| WTP: 0,0,0.173076923,16,0,0,0,0,0,-1906711473,2029998696,11746.56513,1319383216,131938321.6,1,95757,4310,471,1951,1480,471,95757,1480,1951,338.5,2.917721519,12.23417722,34133.97468,2047.259494,15.20253165,98787.36076,0.343134047,0.020521127,0.000153792,0.758585341,0.02037449,23,14
D:0| T0: 0.17| T1: 16.00| R0: 0.0| R1: 0.0| WTP: 0,0,0.173076923,16,0,0,0,0,0,-2006218000,776062361,10646.93592,1473871204,147387120.4,2,78397,3348,752,1769,1017,752,78397,1017,1769,110.760218,1.967302452,4.705722071,37610.16621,1325.583106,6.754768392,98661.6921,0.379854871,0.013333173,6.91327E-05,0.574901074,0.022564639,52,16
D:0| T0: 0.17| T1: 16.00| R0: 0.0| R1: 0.0| WTP: 0,0,0.173076923,16,0,0,0,0,0,-1406997326,1813046880,78.28705192,1403082974,140308297.4,2,567,31,13,13,0,13,567,0,13,2.195652174,0.02173913,0.02173913,99625.16848,18.66304348,0.092391304,99992.36957,0.996334157,0.00018812,1.40549E-06,0,0.02292769,27,16
D:0| T0: 0.17| T1: 16.00| R0: 0.0| R1: 0.0| WTP: 0,0,0.173076923,16,0,0,0,0,0,-1432585441,2032407216,2029.219858,1331124449,133112444.9,1,17270,787,311,337,26,311,17270,26,337,56.13333333,1.757575758,1.903030303,89330.33939,364.8,3.793939394,99814.11515,0.894983692,0.003633692,3.90999E-05,0.077151335,0.019513607,24,15
D:0| T0: 0.17| T1: 16.00| R0: 0.0| R1: 0.0| WTP: 0,0,0.173076923,16,0,0,0,0,0,-789830023.7,1507873352,18.03885983,788928080.7,78892808.07,1,53,5,3,3,0,3,53,0,3,0.346153846,0,0,99969.92308,3.353846154,0.023076923,99999.23846,0.999708164,3.52674E-05,4.5802E-07,0,0.056603774,18,9
D:0| T0: 0.17| T1: 16.00| R0: 0.0| R1: 0.0| WTP: 0,0,0.173076923,16,0,0,0,0,0,-968754026.9,1855899401,78.28915632,964839569,96483956.9,1,825,38,13,13,0,13,825,0,13,2.927536232,0.036231884,0.036231884,99516.06522,21.85507246,0.115942029,99992.72464,0.995239322,0.000219585,1.87061E-06,0,0.015757576,20,11
D:0| T0: 0.17| T1: 16.00| R0: 0.0| R1: 0.0| WTP: 0,0,0.173076923,16,0,0,0,0,0,-1841231582,1819459251,7663.090303,1458077067,145807706.7,2,60031,2612,568,1273,705,568,60031,705,1273,144.6363636,2.5,5.659090909,56933.77727,980.8545455,8.259090909,99145.56364,0.57350459,0.009823705,8.38388E-05,0.553809898,0.02120571,32,16
D:0| T0: 0.17| T1: 16.00| R0: 0.0| R1: 0.0| WTP: 0,0,0.173076923,16,0,0,0,0,0,-879717430.9,909791748,48.30141192,877302360.3,87730236.03,1,712,35,8,8,0,8,712,0,8,3.715384615,0.023076923,0.023076923,99597.11538,18.2,0.092307692,99996.43846,0.996011817,0.000183516,1.22141E-06,0,0.011235955,19,10
D:0| T0: 0.17| T1: 16.00| R0: 0.0| R1: 0.0| WTP: 0,0,0.173076923,16,0,0,0,0,0,-1998526901,1339092841,10526.54092,1472199855,147219985.5,2,74452,3113,1380,1749,369,1380,74452,369,1749,84.52813853,2.824675325,3.603896104,52899.57143,578.6320346,6.606060606,98921.22078,0.533562013,0.005826696,6.82E-05,0.210977702,0.023491646,66,16
D:0| T0: 0.17| T1: 16.00| R0: 0.0| R1: 0.0| WTP: 0,0,0.173076923,16,0,0,0,0,0,-2030729947,1365866345,12461.40314,1407659790,140765979,1,97538,4342,473,2070,1597,473,97538,1597,2070,323.5361446,2.777108434,12.3313253,30129.07229,1838.403614,15.18674699,98646.18072,0.303029949,0.018449069,0.000153835,0.771497585,0.021222498,24,15
D:0| T0: 0.17| T1: 16.00| R0: 0.0| R1: 0.0| WTP: 0,0,0.173076923,16,0,0,0,0,0,-2005133172,825453433,10392.70921,1485497711,148549771.1,2,86066,3802,1359,1726,367,1359,86066,367,1726,121.1538462,3.302564103,4.215384615,52260.98974,1121.641026,7.715384615,99113.23077,0.525380517,0.011281827,7.95666E-05,0.212630359,0.020054377,56,16
D:0| T0: 0.17| T1: 16.00| R0: 0.0| R1: 0.0| WTP: 0,0,0.173076923,16,0,0,0,0,0,-1951386180,939711378,12599.97694,1321387333,132138733.3,1,97565,4337,449,2093,1644,449,97565,1644,2093,352.1225806,2.806451613,13.36129032,32566.96774,2472.883871,16.23870968,98693.54839,0.327314107,0.024802877,0.000164638,0.785475394,0.021452365,23,14
D:0| T0: 0.17| T1: 16.00| R0: 0.0| R1: 0.0| WTP: 0,0,0.173076923,16,0,0,0,0,0,-2052244988,638950699,11164.09225,1494040376,149404037.6,2,90870,4164,1144,1854,710,1144,90870,710,1854,143.6448087,2.959016393,4.868852459,61679.61475,1573.581967,7.991803279,99275.90437,0.618358219,0.015839556,8.24188E-05,0.382955771,0.020402773,53,16
D:0| T0: 0.17| T1: 16.00| R0: 0.0| R1: 0.0| WTP: 0,0,0.173076923,16,0,0,0,0,0,-2008041413,938699148,10487.99918,1483641454,148364145.4,2,84864,3859,934,1742,808,934,84864,808,1742,121.7565445,2.293193717,4.384816754,69699.46859,747.9319372,6.845549738,99424.78272,0.698383115,0.007524699,7.04617E-05,0.463834673,0.020526961,55,16
D:0| T0: 0.17| T1: 16.00| R0: 0.0| R1: 0.0| WTP: 0,0,0.173076923,16,0,0,0,0,0,-1977416681,121790188,9934.615996,1480685881,148068588.1,2,81001,3584,1019,1650,631,1019,81001,631,1650,88.28402367,1.911242604,3.128205128,69587.24458,1154.99211,5.147928994,99424.74951,0.697062049,0.011623442,5.2973E-05,0.382424242,0.020370119,72,16
D:0| T0: 0.17| T1: 16.00| R0: 0.0| R1: 0.0| WTP: 0,0,0.173076923,16,0,0,0,0,0,-1983927417,1331335240,10143.40579,1476757128,147675712.8,2,78983,3452,893,1685,792,893,78983,792,1685,41.01156069,0.749518304,1.5,28661.35356,500.6348748,2.354527938,98505.48844,0.290524787,0.005043623,2.50329E-05,0.470029674,0.021333705,149,16
D:0| T0: 0.17| T1: 16.00| R0: 0.0| R1: 0.0| WTP: 0,0,0.173076923,16,0,0,0,0,0,-2163737738,470935411,13362.35035,1495620221,149562022.1,1,98775,4173,475,2220,1745,475,98775,1745,2220,312.5,2.697674419,12.81395349,24473.4186,1485.94186,15.54651163,98426.86628,0.246574405,0.014924275,0.000157498,0.786036036,0.022475323,25,16
D:0| T0: 0.17| T1: 16.00| R0: 0.0| R1: 0.0| WTP: 0,0,0.173076923,16,0,0,0,0,0,-2103438817,823434397,12326.80888,1487098373,148709837.3,2,89877,3868,963,2048,1085,963,89877,1085,2048,134.3259053,2.545961003,5.52367688,65009.44847,1279.785515,8.189415042,99275.60724,0.651380468,0.01288866,8.44704E-05,0.529785156,0.022786697,52,16
D:0| T0: 0.17| T1: 16.00| R0: 0.0| R1: 0.0| WTP: 0,0,0.173076923,16,0,0,0,0,0,-1147243496,493045351,132.4932633,1140618833,114061883.3,1,1358,62,22,22,0,22,1358,0,22,4.570469799,0.073825503,0.073825503,99178.87919,23.2147651,0.228187919,99988.9396,0.991908714,0.000233087,2.93363E-06,0,0.016212233,22,13
D:0| T0: 0.17| T1: 16.00| R0: 0.0| R1: 0.0| WTP: 0,0,0.173076923,16,0,0,0,0,0,-1993718790,1700216563,10081.59776,1489638902,148963890.2,2,87206,3979,889,1674,785,889,87206,785,1674,135.4704301,2.255376344,4.327956989,65051.88172,1258.956989,6.709677419,99385.01344,0.651539356,0.012657503,6.92832E-05,0.468936679,0.019195927,54,16
D:0| T0: 0.17| T1: 16.00| R0: 0.0| R1: 0.0| WTP: 0,0,0.173076923,16,0,0,0,0,0,-1612146596,1744119059,3565.543265,1433869432,143386943.2,2,31580,1440,445,592,147,445,31580,147,592,87.65533981,2.038834951,2.733009709,77949.7767,424.7475728,4.898058252,99617.40291,0.782468081,0.004240367,5.02431E-05,0.248310811,0.018746635,30,16
D:0| T0: 0.17| T1: 16.00| R0: 0.0| R1: 0.0| WTP: 0,0,0.173076923,16,0,0,0,0,0,-2020410325,2036906360,10763.83098,1482218776,148221877.6,2,84518,3668,985,1788,803,985,84518,803,1788,95.91368421,1.957894737,3.616842105,69577.91789,1241.905263,5.701052632,99412.45474,0.696790504,0.012501059,5.87748E-05,0.449105145,0.021155257,67,16
D:0| T0: 0.17| T1: 16.00| R0: 0.0| R1: 0.0| WTP: 0,0,0.173076923,16,0,0,0,0,0,-2013075033,809704121,10442.38721,1490955672,149095567.2,2,88248,4014,997,1734,737,997,88248,737,1734,129.1772152,2.369620253,4.202531646,60493.09873,1151.002532,6.741772152,99272.42278,0.606502758,0.011580029,6.95417E-05,0.425028835,0.019649171,56,16
D:0| T0: 0.17| T1: 16.00| R0: 0.0| R1: 0.0| WTP: 0,0,0.173076923,16,0,0,0,0,0,-1961164496,1219866412,9616.121269,1480358433,148035843.3,2,79227,3526,870,1597,727,870,79227,727,1597,55.49012346,0.941975309,1.82962963,30307.92963,801.8938272,2.897530864,98631.75802,0.306850904,0.008071503,3.06751E-05,0.455228554,0.02015727,116,16
D:0| T0: 0.17| T1: 16.00| R0: 0.0| R1: 0.0| WTP: 0,0,0.173076923,16,0,0,0,0,0,-880548875.2,843498920,72.19973601,876938888.4,87693888.84,1,647,29,12,12,0,12,647,0,12,1.92481203,0.015037594,0.015037594,99623.25564,22.4887218,0.127819549,99993.54887,0.996302547,0.000225537,1.79114E-06,0,0.018547141,19,10
D:0| T0: 0.17| T1: 16.00| R0: 0.0| R1: 0.0| WTP: 0,0,0.173076923,16,0,0,0,0,0,-2178064268,107351963,13857.59964,1485184286,148518428.6,2,92421,3809,1074,2303,1229,1074,92421,1229,2303,107.9837587,2.378190255,5.208816705,56980.43619,1495.663573,7.6774942,99004.87935,0.571331766,0.015090468,7.90521E-05,0.533651759,0.024918579,62,16
D:0| T0: 0.17| T1: 16.00| R0: 0.0| R1: 0.0| WTP: 0,0,0.173076923,16,0,0,0,0,0,-2042617396,773789021,11090.02049,1488116371,148811637.1,2,91426,3952,971,1842,871,971,91426,871,1842,132.0806452,2.446236559,4.752688172,62542.66398,1663.913978,7.376344086,99311.80645,0.626505256,0.016745142,7.60938E-05,0.472855592,0.020147442,54,16
D:0| T0: 0.17| T1: 16.00| R0: 0.0| R1: 0.0| WTP: 0,0,0.173076923,16,0,0,0,0,0,-2096993448,850936611,12312.98184,1481344356,148134435.6,2,88382,3606,1123,2046,923,1123,88382,923,2046,120.6856369,2.859078591,5.325203252,61719.39837,1267.01084,8.417344173,99172.47696,0.619241446,0.012765693,8.64864E-05,0.451124145,0.02314951,53,16
D:0| T0: 0.17| T1: 16.00| R0: 0.0| R1: 0.0| WTP: 0,0,0.173076923,16,0,0,0,0,0,-1770740959,1701318364,6446.894467,1448396236,144839623.6,2,48576,2067,594,1071,477,594,48576,477,1071,121.6883721,2.655813953,4.837209302,65369.86512,962.2697674,7.609302326,99296.66977,0.657925927,0.00962694,7.74998E-05,0.445378151,0.022049287,31,16
D:0| T0: 0.17| T1: 16.00| R0: 0.0| R1: 0.0| WTP: 0,0,0.173076923,16,0,0,0,0,0,-1140198407,778708269,12.05544501,1139595635,113959563.5,1,160,9,2,2,0,2,160,0,2,0.577181208,0,0,99907.56376,7.577181208,0.013422819,99999.52349,0.999082926,7.74669E-05,2.66668E-07,0,0.012578616,22,13
D:0| T0: 0.17| T1: 16.00| R0: 0.0| R1: 0.0| WTP: 0,0,0.173076923,16,0,0,0,0,0,-1494263834,1391938506,1619.063448,1413310662,141331066.2,2,12213,490,265,269,4,265,12213,4,269,34.41242938,1.322033898,1.333333333,91991.16949,246.559322,2.870056497,99838.23164,0.921450139,0.002457106,3.00386E-05,0.014869888,0.02202571,26,16
D:0| T0: 0.17| T1: 16.00| R0: 0.0| R1: 0.0| WTP: 0,0,0.173076923,16,0,0,0,0,0,-966359998.7,43418681,36.15789548,964552103.9,96455210.39,1,448,22,6,6,0,6,448,0,6,1.766423358,0,0,99738.22628,18.38686131,0.04379562,99996.93431,0.997417343,0.000185078,8.69587E-07,0,0.013392857,20,11
D:0| T0: 0.17| T1: 16.00| R0: 0.0| R1: 0.0| WTP: 0,0,0.173076923,16,0,0,0,0,0,-2143983382,817384966,13042.80165,1491843299,149184329.9,2,97822,4117,441,2167,1726,441,97822,1726,2167,235.1506849,1.96803653,9.808219178,20561.99087,1216.515982,11.82648402,98330.76712,0.207488953,0.012227703,0.000119801,0.796492847,0.022152481,32,16
D:0| T0: 0.17| T1: 16.00| R0: 0.0| R1: 0.0| WTP: 0,0,0.173076923,16,0,0,0,0,0,-1933910598,762053968,12269.39796,1320440700,132044070,1,95458,4290,497,2038,1541,497,95458,1541,2038,339.6918239,3.062893082,12.68553459,32651.35849,1878.163522,15.80503145,98698.81761,0.328496954,0.018836603,0.000160036,0.756133464,0.021349704,23,14
D:0| T0: 0.17| T1: 16.00| R0: 0.0| R1: 0.0| WTP: 0,0,0.173076923,16,0,0,0,0,0,-2004369961,1692506311,10167.75328,1495982297,149598229.7,2,90201,4244,938,1688,750,938,90201,750,1688,127.314554,2.072769953,3.807511737,61511.43427,1408.422535,6,99339.5493,0.61613443,0.014167522,6.20067E-05,0.444312796,0.018713761,60,16
D:0| T0: 0.17| T1: 16.00| R0: 0.0| R1: 0.0| WTP: 0,0,0.173076923,16,0,0,0,0,0,-615459852.2,1037620300,36.0634779,613656678.3,61365667.83,1,189,3,6,6,0,6,189,0,6,0.5625,0,0,99899.99107,6.258928571,0.0625,99997.875,0.999023061,6.41604E-05,1.06197E-06,0,0.031746032,16,7
D:0| T0: 0.17| T1: 16.00| R0: 0.0| R1: 0.0| WTP: 0,0,0.173076923,16,0,0,0,0,0,-1997116975,301400999,10289.54799,1482639576,148263957.6,2,82084,3628,956,1709,753,956,82084,753,1709,107.1678322,2.111888112,3.82983683,69547.44522,792.2261072,6.053613054,99411.5641,0.696921398,0.007971436,6.24977E-05,0.440608543,0.020820135,62,16
D:0| T0: 0.17| T1: 16.00| R0: 0.0| R1: 0.0| WTP: 0,0,0.173076923,16,0,0,0,0,0,-1978480391,1868336855,9999.850421,1478487870,147848787,2,78144,3398,846,1661,815,846,78144,815,1661,60.53388658,1.015214385,2.128630705,34319.59059,420.4827109,3.300138313,98635.40526,0.347439205,0.004234802,3.49324E-05,0.490668272,0.021255631,104,16
D:0| T0: 0.17| T1: 16.00| R0: 0.0| R1: 0.0| WTP: 0,0,0.173076923,16,0,0,0,0,0,-2004405991,1868498144,10540.04966,1477403508,147740350.8,2,78698,3394,1020,1751,731,1020,78698,731,1751,60.44837341,1.289957567,2.312588402,35652.57284,461.1541726,3.755304102,98607.73267,0.360930821,0.004645791,3.95068E-05,0.417475728,0.022249612,101,16
D:0| T0: 0.17| T1: 16.00| R0: 0.0| R1: 0.0| WTP: 0,0,0.173076923,16,0,0,0,0,0,-1413304834,2101566889,192.5832081,1403675674,140367567.4,2,1311,55,32,32,0,32,1311,0,32,3.360730594,0.073059361,0.073059361,99097.84018,32.8630137,0.214611872,99979.55708,0.991192768,0.000329232,2.90952E-06,0,0.024408848,32,16
D:0| T0: 0.17| T1: 16.00| R0: 0.0| R1: 0.0| WTP: 0,0,0.173076923,16,0,0,0,0,0,-1968416855,1665097450,13001.34028,1318349841,131834984.1,1,98303,4245,438,2160,1722,438,98303,1722,2160,335.0573248,2.732484076,13.63694268,28653.10191,2147.821656,16.41401274,98558.82803,0.28833457,0.021555904,0.000166186,0.797222222,0.02197288,23,14
D:0| T0: 0.17| T1: 16.00| R0: 0.0| R1: 0.0| WTP: 0,0,0.173076923,16,0,0,0,0,0,-1883626195,1716179948,11242.80387,1321486001,132148600.1,1,98040,4376,478,1867,1389,478,98040,1389,1867,349.6815287,2.98089172,11.75159236,31126.16561,2151.77707,14.78343949,98819.96815,0.312876334,0.021562003,0.000149784,0.74397429,0.019043248,23,14
D:0| T0: 0.17| T1: 16.00| R0: 0.0| R1: 0.0| WTP: 0,0,0.173076923,16,0,0,0,0,0,-1161076997,1560278715,391.0284409,1141525574,114152557.4,1,2287,99,65,65,0,65,2287,0,65,7.272151899,0.284810127,0.284810127,98698.41139,47.56962025,0.696202532,99967.28481,0.987315533,0.000475487,8.17863E-06,0,0.028421513,22,13
D:0| T0: 0.17| T1: 16.00| R0: 0.0| R1: 0.0| WTP: 0,0,0.173076923,16,0,0,0,0,0,-1979848942,991019385,10124.37499,1473630192,147363019.2,2,75583,3192,610,1682,1072,610,75583,1072,1682,202.0594059,2.940594059,8.193069307,47252.32178,2219.079208,11.20792079,98933,0.476067804,0.022253427,0.000113872,0.637336504,0.022253681,29,16
D:0| T0: 0.17| T1: 16.00| R0: 0.0| R1: 0.0| WTP: 0,0,0.173076923,16,0,0,0,0,0,-2060975215,118052103,11468.46536,1487551947,148755194.7,2,88297,3840,1607,1905,298,1607,88297,298,1905,130.3125,4.217391304,4.994565217,48597.2962,1213.644022,9.361413043,98967.81793,0.488840486,0.012218304,9.60782E-05,0.156430446,0.021574912,53,16
D:0| T0: 0.17| T1: 16.00| R0: 0.0| R1: 0.0| WTP: 0,0,0.173076923,16,0,0,0,0,0,-2018243144,1209758844,12487.00953,1393892667,139389266.7,1,88204,3609,528,2075,1547,528,88204,1547,2075,273.9515152,3.139393939,12.44848485,40211.76364,1568.357576,15.62424242,98708.38788,0.404832705,0.015744512,0.000158423,0.745542169,0.02352501,24,15
D:0| T0: 0.17| T1: 16.00| R0: 0.0| R1: 0.0| WTP: 0,0,0.173076923,16,0,0,0,0,0,-971295411.4,70671723,132.287538,964681034.5,96468103.45,1,879,37,22,22,0,22,879,0,22,2.096296296,0.096296296,0.096296296,99502.6,40.9037037,0.251851852,99989.91111,0.995132145,0.000408641,3.23562E-06,0,0.025028441,20,11
D:0| T0: 0.17| T1: 16.00| R0: 0.0| R1: 0.0| WTP: 0,0,0.173076923,16,0,0,0,0,0,-615724590.1,1722612191,42.05585974,613621797.1,61362179.71,1,154,7,7,7,0,7,154,0,7,0.339130435,0,0,99925.90435,6.269565217,0.069565217,99997.8,0.999282038,6.45706E-05,1.20693E-06,0,0.045454545,16,7
D:0| T0: 0.17| T1: 16.00| R0: 0.0| R1: 0.0| WTP: 0,0,0.173076923,16,0,0,0,0,0,-1919842409,1968291596,8882.06601,1475739108,147573910.8,2,72830,3289,967,1475,508,967,72830,508,1475,91.40652174,1.993478261,3.07173913,74360.70652,636.1891304,5.186956522,99518.44348,0.744973985,0.006395935,5.336E-05,0.34440678,0.020252921,66,16
D:0| T0: 0.17| T1: 16.00| R0: 0.0| R1: 0.0| WTP: 0,0,0.173076923,16,0,0,0,0,0,-2081251979,1877569084,13494.00386,1406551787,140655178.7,1,98396,4145,476,2242,1766,476,98396,1766,2242,326.0802469,2.895061728,13.75308642,28298.09259,1940.851852,16.66666667,98508.96296,0.284748422,0.019488655,0.000168597,0.787689563,0.022785479,24,15
D:0| T0: 0.17| T1: 16.00| R0: 0.0| R1: 0.0| WTP: 0,0,0.173076923,16,0,0,0,0,0,-2068572054,1726322189,13306.75095,1403234506,140323450.6,1,96304,4112,524,2211,1687,524,96304,1687,2211,307.5030303,3.109090909,13.26060606,31480.65455,1982.472727,16.44848485,98571.98788,0.316751669,0.019905308,0.000166567,0.763003166,0.022958548,24,15
D:0| T0: 0.17| T1: 16.00| R0: 0.0| R1: 0.0| WTP: 0,0,0.173076923,16,0,0,0,0,0,-1886903744,307848836,11497.9627,1312005608,131200560.8,1,90240,3972,507,1910,1403,507,90240,1403,1910,304.1552795,3.062111801,11.72049689,39548.54658,1977.285714,14.86956522,98843.35404,0.397740099,0.019823457,0.000150608,0.734554974,0.02116578,23,14
D:0| T0: 0.17| T1: 16.00| R0: 0.0| R1: 0.0| WTP: 0,0,0.173076923,16,0,0,0,0,0,-1835977801,1154000220,12035.59302,1234198150,123419815,1,98939,4480,439,1999,1560,439,98939,1560,1999,356.8766234,2.753246753,12.83766234,25431.02597,1673.532468,15.72077922,98620.52597,0.256197708,0.016774105,0.000158844,0.780390195,0.020204368,22,13
D:0| T0: 0.17| T1: 16.00| R0: 0.0| R1: 0.0| WTP: 0,0,0.173076923,16,0,0,0,0,0,-1968539089,2028661055,9949.480614,1471065058,147106505.8,2,75365,3221,984,1653,669,984,75365,669,1653,87.69977427,2.106094808,3.589164786,76654.96614,889.8329571,5.794582393,99528.6298,0.767757396,0.008951515,5.98809E-05,0.404718693,0.021933258,64,16
D:0| T0: 0.17| T1: 16.00| R0: 0.0| R1: 0.0| WTP: 0,0,0.173076923,16,0,0,0,0,0,-2063651742,1629114640,11463.222,1490490642,149049064.2,2,91691,4115,1243,1904,661,1243,91691,661,1904,132.7275132,3.111111111,4.833333333,53976.76984,1499.18254,8.132275132,99125.94974,0.541849552,0.015091412,8.37879E-05,0.347163866,0.020765397,54,16
D:0| T0: 0.17| T1: 16.00| R0: 0.0| R1: 0.0| WTP: 0,0,0.173076923,16,0,0,0,0,0,-1964457217,1439048174,12952.84406,1316815014,131681501.4,1,97218,4091,501,2152,1651,501,97218,1651,2152,320.6583851,3.049689441,13.26708075,31550.6646,2571.826087,16.38509317,98626.93789,0.317283489,0.025819004,0.000165513,0.767193309,0.022135818,23,14
D:0| T0: 0.17| T1: 16.00| R0: 0.0| R1: 0.0| WTP: 0,0,0.173076923,16,0,0,0,0,0,-2167943188,865227006,13487.76317,1493555030,149355503,2,99171,4141,440,2241,1801,440,99171,1801,2241,253.4975845,2.062801932,10.73429952,18111.4058,1287.507246,12.87439614,98252.28502,0.182903911,0.012941058,0.000130328,0.803659081,0.022597332,30,16
D:0| T0: 0.17| T1: 16.00| R0: 0.0| R1: 0.0| WTP: 0,0,0.173076923,16,0,0,0,0,0,-2004803670,890479738,10445.73386,1482516977,148251697.7,2,82803,3567,1229,1735,506,1229,82803,506,1735,83.45521024,2.074954296,2.978062157,35632.87569,1082.764168,5.226691042,98702.97989,0.359996599,0.010901694,5.45854E-05,0.291642651,0.020953347,79,16
D:0| T0: 0.17| T1: 16.00| R0: 0.0| R1: 0.0| WTP: 0,0,0.173076923,16,0,0,0,0,0,-1260009283,1017049163,571.924303,1231413068,123141306.8,1,4882,218,95,95,0,95,4882,0,95,15.35220126,0.471698113,0.471698113,97010.84906,111.0251572,1.088050314,99947.66667,0.970643074,0.001106399,1.18804E-05,0,0.019459238,23,14
D:0| T0: 0.17| T1: 16.00| R0: 0.0| R1: 0.0| WTP: 0,0,0.173076923,16,0,0,0,0,0,-1316046176,1707305064,18.14171148,1315139090,131513909,1,304,12,3,3,0,3,304,0,3,1.43902439,0.006097561,0.006097561,99809.40854,9.384146341,0.018292683,99998.14634,0.998116373,9.53351E-05,3.63639E-07,0,0.009868421,24,15
D:0| T0: 0.17| T1: 16.00| R0: 0.0| R1: 0.0| WTP: 0,0,0.173076923,16,0,0,0,0,0,-2168513549,400145663,13458.37785,1495594656,149559465.6,2,99063,4296,416,2236,1820,416,99063,1820,2236,305.3125,2.301136364,12.61363636,21244.23864,1511.471591,14.97727273,98336.77273,0.214354435,0.015179205,0.000151496,0.813953488,0.022571495,26,16
D:0| T0: 0.17| T1: 16.00| R0: 0.0| R1: 0.0| WTP: 0,0,0.173076923,16,0,0,0,0,0,-1146840749,1662654181,120.5449117,1140813503,114081350.3,1,1480,66,20,20,0,20,1480,0,20,5.25974026,0.051948052,0.051948052,99114.72078,38.96753247,0.168831169,99989.98701,0.991256664,0.000389447,2.58088E-06,0,0.013513514,22,13
D:0| T0: 0.17| T1: 16.00| R0: 0.0| R1: 0.0| WTP: 0,0,0.173076923,16,0,0,0,0,0,-2028784179,182136456,12413.50839,1408108760,140810876,1,98235,4374,473,2062,1589,473,98235,1589,2062,333.2037037,2.87037037,12.62345679,28120.00617,2101.364198,15.5308642,98623.17284,0.282984097,0.021080113,0.000157104,0.770611057,0.020990482,24,15
D:0| T0: 0.17| T1: 16.00| R0: 0.0| R1: 0.0| WTP: 0,0,0.173076923,16,0,0,0,0,0,-1403902093,979575387,24.11458233,1402696364,140269636.4,1,290,12,4,4,0,4,290,0,4,1.046783626,0,0,99823.53216,11.45614035,0.023391813,99998.20468,0.99825693,0.000116223,4.65123E-07,0,0.013793103,25,16
D:0| T0: 0.17| T1: 16.00| R0: 0.0| R1: 0.0| WTP: 0,0,0.173076923,16,0,0,0,0,0,-2026880000,2142525414,10984.42846,1477658577,147765857.7,2,81403,3435,588,1825,1237,588,81403,1237,1825,240.7653631,3.201117318,10.05027933,45963.01676,1782.201117,13.33519553,98902.11732,0.462652857,0.017876666,0.000135287,0.677808219,0.022419321,26,16
D:0| T0: 0.17| T1: 16.00| R0: 0.0| R1: 0.0| WTP: 0,0,0.173076923,16,0,0,0,0,0,-2026329904,1464057597,10819.16548,1485371630,148537163,2,84194,3696,1573,1797,224,1573,84194,224,1797,121.9791667,3.934895833,4.479166667,49796.42448,821.9244792,8.578125,98995.60937,0.501126713,0.008271663,8.83198E-05,0.124652198,0.021343564,55,16
D:0| T0: 0.17| T1: 16.00| R0: 0.0| R1: 0.0| WTP: 0,0,0.173076923,16,0,0,0,0,0,-2062133212,364562610,11580.68812,1483098806,148309880.6,1,87956,3757,530,1924,1394,530,87956,1394,1924,266.3275862,2.965517241,10.93678161,39138.09195,1709.189655,14,98782.65517,0.394011626,0.017143152,0.000141569,0.724532225,0.021874574,25,16
D:0| T0: 0.17| T1: 16.00| R0: 0.0| R1: 0.0| WTP: 0,0,0.173076923,16,0,0,0,0,0,-1994832855,40350784,10400.98761,1474783474,147478347.4,2,77125,3268,605,1728,1123,605,77125,1123,1728,212.625641,3.01025641,8.717948718,47288.47692,1529.682051,11.81538462,98915.11282,0.476332949,0.015341981,0.000120075,0.649884259,0.022405186,28,16
D:0| T0: 0.17| T1: 16.00| R0: 0.0| R1: 0.0| WTP: 0,0,0.173076923,16,0,0,0,0,0,-1986459746,804064356,9890.023559,1491958568,149195856.8,2,89264,4116,438,1642,1204,438,89264,1204,1642,292.2011173,2.379888268,9.072625698,36867.4581,1444.03352,11.50837989,98925.40223,0.370984933,0.014467612,0.000116487,0.733252132,0.018394874,26,16
D:0| T0: 0.17| T1: 16.00| R0: 0.0| R1: 0.0| WTP: 0,0,0.173076923,16,0,0,0,0,0,-1628227273,2125493986,5507.451387,1352854703,135285470.3,1,39738,1695,465,915,450,465,39738,450,915,129.0059524,2.654761905,5.303571429,74078.57738,742.8690476,8.041666667,99455.19643,0.744512211,0.007417016,8.20256E-05,0.491803279,0.023025819,24,15
D:0| T0: 0.17| T1: 16.00| R0: 0.0| R1: 0.0| WTP: 0,0,0.173076923,16,0,0,0,0,0,-1846844674,23154253,7499.412326,1471874058,147187405.8,2,69083,3146,519,1245,726,519,69083,726,1245,219.8315217,2.695652174,6.60326087,53171.11413,1000.472826,9.461956522,99223.38043,0.53493693,0.010008325,9.59413E-05,0.58313253,0.0180218,27,16
D:0| T0: 0.17| T1: 16.00| R0: 0.0| R1: 0.0| WTP: 0,0,0.173076923,16,0,0,0,0,0,-1962180555,1391367689,9781.990568,1473081027,147308102.7,2,74585,3181,952,1625,673,952,74585,673,1625,90.61936937,2.02027027,3.493243243,72350.5473,565.5337838,5.630630631,99436.93919,0.725180192,0.005688886,5.83755E-05,0.414153846,0.021787223,64,16
D:0| T0: 0.17| T1: 16.00| R0: 0.0| R1: 0.0| WTP: 0,0,0.173076923,16,0,0,0,0,0,-2052413822,574142276,11394.57238,1482685202,148268520.2,2,87075,3716,1069,1893,824,1069,87075,824,1893,123.5718157,2.723577236,4.945799458,61517.8645,1084.205962,7.845528455,99217.4607,0.617270786,0.010915335,8.07716E-05,0.435287903,0.021740129,53,16
D:0| T0: 0.17| T1: 16.00| R0: 0.0| R1: 0.0| WTP: 0,0,0.173076923,16,0,0,0,0,0,-701611202.7,898736779,6.039854375,701309210,70130921,1,92,4,1,1,0,1,92,0,1,0.578947368,0,0,99953.01754,5.789473684,0.00877193,99999.17544,0.999539648,5.9218E-05,1.73913E-07,0,0.010869565,17,8
D:0| T0: 0.17| T1: 16.00| R0: 0.0| R1: 0.0| WTP: 0,0,0.173076923,16,0,0,0,0,0,-2004811559,346473503,10179.86777,1495818171,149581817.1,2,90623,4277,1324,1690,366,1324,90623,366,1690,132.1280788,3.140394089,4.004926108,45037.19951,1269.497537,7.24137931,99047.79557,0.452964973,0.012767439,7.46802E-05,0.216568047,0.018648687,58,16
D:0| T0: 0.17| T1: 16.00| R0: 0.0| R1: 0.0| WTP: 0,0,0.173076923,16,0,0,0,0,0,-2054089873,445552282,11324.32458,1487873645,148787364.5,2,88561,3886,1373,1881,508,1373,88561,508,1881,120.3027295,3.245657568,4.464019851,52442.05459,1253.325062,7.888337469,99035.29529,0.527387932,0.012622509,8.12979E-05,0.270069112,0.021239598,57,16
D:0| T0: 0.17| T1: 16.00| R0: 0.0| R1: 0.0| WTP: 0,0,0.173076923,16,0,0,0,0,0,-1746013496,911758476,11946.23269,1148701861,114870186.1,1,99146,4479,437,1984,1547,437,99146,1547,1984,396.7676056,2.985915493,13.83098592,27636.58451,1954.535211,16.9084507,98686.9507,0.278200211,0.019581078,0.000170959,0.779737903,0.020010893,21,12
D:0| T0: 0.17| T1: 16.00| R0: 0.0| R1: 0.0| WTP: 0,0,0.173076923,16,0,0,0,0,0,-2053829222,1464197940,11111.20923,1498268761,149826876.1,2,93996,4382,552,1845,1293,552,93996,1293,1845,311.6256983,3.005586592,10.18994413,33594.05028,3063.877095,13.24581006,98820.50279,0.337879763,0.03073005,0.000134389,0.700813008,0.019628495,26,16
D:0| T0: 0.17| T1: 16.00| R0: 0.0| R1: 0.0| WTP: 0,0,0.173076923,16,0,0,0,0,0,-2025097481,500405854,10842.21161,1482986900,148298690,2,84350,3631,1094,1801,707,1094,84350,707,1801,110.6240964,2.496385542,4.18313253,64073.65301,829.4457831,6.814457831,99274.00964,0.642955167,0.008348953,7.01951E-05,0.392559689,0.021351512,60,16
D:0| T0: 0.17| T1: 16.00| R0: 0.0| R1: 0.0| WTP: 0,0,0.173076923,16,0,0,0,0,0,-2004424760,772037341,12110.26047,1398911737,139891173.7,1,92766,3897,464,2012,1548,464,92766,1548,2012,293.5333333,2.739393939,12.06666667,35320.81818,1842.612121,14.87272727,98710.27879,0.355418127,0.018482671,0.000150624,0.769383698,0.021688981,24,15
D:0| T0: 0.17| T1: 16.00| R0: 0.0| R1: 0.0| WTP: 0,0,0.173076923,16,0,0,0,0,0,-967790505.6,1543158763,66.16145856,964482432.7,96448243.27,1,464,23,11,11,0,11,464,0,11,1.379562044,0.02189781,0.02189781,99731.39416,15.99270073,0.102189781,99993.85401,0.997379249,0.000161025,1.59428E-06,0,0.023706897,20,11
D:0| T0: 0.17| T1: 16.00| R0: 0.0| R1: 0.0| WTP: 0,0,0.173076923,16,0,0,0,0,0,-1832721565,1604932531,13782.2358,1143609775,114360977.5,1,98721,4189,442,2290,1848,442,98721,1848,2290,361.6438356,2.938356164,15.55479452,28998.41781,1995.582192,18.5890411,98497.54795,0.291808024,0.020024328,0.000187945,0.8069869,0.023196686,21,12
D:0| T0: 0.17| T1: 16.00| R0: 0.0| R1: 0.0| WTP: 0,0,0.173076923,16,0,0,0,0,0,-1992891797,539051477,10270.39674,1479371959,147937195.9,2,77435,3438,689,1706,1017,689,77435,1017,1706,195.7522124,2.951327434,7.398230088,44363.13274,1965.557522,10.44247788,98879.26991,0.447150041,0.019727185,0.000106435,0.596131301,0.022031381,33,16
D:0| T0: 0.17| T1: 16.00| R0: 0.0| R1: 0.0| WTP: 0,0,0.173076923,16,0,0,0,0,0,-1235046152,1743124675,144.3604116,1227828131,122782813.1,1,733,30,24,24,0,24,733,0,24,2.662420382,0.057324841,0.057324841,99529.2293,15.29299363,0.21656051,99986.01911,0.99543861,0.000153751,3.03832E-06,0,0.032742156,23,14
D:0| T0: 0.17| T1: 16.00| R0: 0.0| R1: 0.0| WTP: 0,0,0.173076923,16,0,0,0,0,0,-2073703665,1965983789,11779.57376,1484724977,148472497.7,2,88569,3781,1041,1957,916,1041,88569,916,1957,117.0025,2.46,4.72,59640.455,1298.1925,7.3225,99167.1925,0.597929499,0.013076435,7.54753E-05,0.468063362,0.022095767,58,16
D:0| T0: 0.17| T1: 16.00| R0: 0.0| R1: 0.0| WTP: 0,0,0.173076923,16,0,0,0,0,0,-2027036342,516774280,10884.15163,1482828761,148282876.1,2,86063,3682,1013,1808,795,1013,86063,795,1808,107.4379391,2.245901639,4.072599532,67735.90632,1299.629977,6.454332553,99377.07728,0.678650757,0.013081937,6.6498E-05,0.439712389,0.021007866,60,16
D:0| T0: 0.17| T1: 16.00| R0: 0.0| R1: 0.0| WTP: 0,0,0.173076923,16,0,0,0,0,0,-2121414811,86603142,12497.83911,1496522855,149652285.5,2,98877,4264,422,2076,1654,422,98877,1654,2076,296.4565217,2.239130435,11.19565217,20627.42391,1394.456522,13.48913043,98429.9837,0.20817992,0.013998365,0.000136404,0.79672447,0.020995783,27,16
D:0| T0: 0.17| T1: 16.00| R0: 0.0| R1: 0.0| WTP: 0,0,0.173076923,16,0,0,0,0,0,-965989593.7,1431870609,30.13122792,964483032.3,96448303.23,1,447,16,5,5,0,5,447,0,5,1.467153285,0,0,99737.33577,22.10948905,0.03649635,99997.13139,0.997406558,0.000221746,7.24652E-07,0,0.011185682,20,11
D:0| T0: 0.17| T1: 16.00| R0: 0.0| R1: 0.0| WTP: 0,0,0.173076923,16,0,0,0,0,0,-1988767362,1592383984,10174.76072,1480029326,148002932.6,2,80901,3517,1381,1690,309,1381,80901,309,1690,112.3222506,3.358056266,4.117647059,53914.26598,604.6905371,7.659846547,99078.80563,0.542707913,0.006084522,7.90177E-05,0.182840237,0.020889729,56,16
D:0| T0: 0.17| T1: 16.00| R0: 0.0| R1: 0.0| WTP: 0,0,0.173076923,16,0,0,0,0,0,-2016740660,1440183867,10561.76723,1488652299,148865229.9,2,86360,3981,1069,1754,685,1069,86360,685,1754,123.0223881,2.52238806,4.189054726,59480.97264,1032.71393,6.81840796,99239.14179,0.596755427,0.010390053,7.06414E-05,0.390535918,0.020310329,58,16
D:0| T0: 0.17| T1: 16.00| R0: 0.0| R1: 0.0| WTP: 0,0,0.173076923,16,0,0,0,0,0,-2088972755,1696510588,12026.65812,1487639849,148763984.9,2,90864,3868,800,1998,1198,800,90864,1198,1998,125.5012853,1.938303342,4.98714653,66620.53213,1097.660668,7.051413882,99330.82262,0.666984637,0.011054388,7.24487E-05,0.5995996,0.021988906,56,16
D:0| T0: 0.17| T1: 16.00| R0: 0.0| R1: 0.0| WTP: 0,0,0.173076923,16,0,0,0,0,0,-2035764704,895039877,11046.3651,1483446449,148344644.9,2,84956,3665,584,1835,1251,584,84956,1251,1835,240.5206186,2.93814433,9.319587629,39528.04124,2295.494845,12.31443299,98817.30412,0.398154226,0.02302829,0.000125193,0.681743869,0.021599416,28,16
D:0| T0: 0.17| T1: 16.00| R0: 0.0| R1: 0.0| WTP: 0,0,0.173076923,16,0,0,0,0,0,-2104237631,129565953,12338.9971,1487287776,148728777.6,2,88870,3803,1232,2050,818,1232,88870,818,2050,113.3726415,2.757075472,4.655660377,58163.74528,1476.15566,7.547169811,99097.87972,0.583705139,0.014878958,7.79893E-05,0.39902439,0.023067402,60,16
D:0| T0: 0.17| T1: 16.00| R0: 0.0| R1: 0.0| WTP: 0,0,0.173076923,16,0,0,0,0,0,-2025002388,1902565669,10735.68454,1488218161,148821816.1,2,87274,3961,799,1783,984,799,87274,984,1783,129.7532808,1.992125984,4.543307087,70763.34383,879.9868766,6.632545932,99461.45407,0.708415573,0.008852236,6.81858E-05,0.551878856,0.02042991,55,16
D:0| T0: 0.17| T1: 16.00| R0: 0.0| R1: 0.0| WTP: 0,0,0.173076923,16,0,0,0,0,0,-1413891858,1984179288,198.6784526,1403957935,140395793.5,1,1788,69,33,33,0,33,1788,0,33,5.296511628,0.087209302,0.087209302,98850.1686,78.55813953,0.284883721,99982.40116,0.988690847,0.000783459,3.81563E-06,0,0.018456376,25,16
D:0| T0: 0.17| T1: 16.00| R0: 0.0| R1: 0.0| WTP: 0,0,0.173076923,16,0,0,0,0,0,-2065211233,677377223,11576.20673,1486400896,148640089.6,2,87718,3788,1700,1923,223,1700,87718,223,1923,112.0166271,3.850356295,4.361045131,45893.82898,1691.648456,8.425178147,98889.65321,0.461919774,0.017038508,8.66844E-05,0.115964639,0.021922524,60,16
D:0| T0: 0.17| T1: 16.00| R0: 0.0| R1: 0.0| WTP: 0,0,0.173076923,16,0,0,0,0,0,-2065782632,973583301,11487.54443,1491405410,149140541,2,93169,4111,1205,1908,703,1205,93169,703,1908,135.0159574,3.058510638,4.89893617,52413.94415,2009.058511,8.103723404,99102.77926,0.525704185,0.020222983,8.33288E-05,0.368448637,0.020478915,54,16
D:0| T0: 0.17| T1: 16.00| R0: 0.0| R1: 0.0| WTP: 0,0,0.173076923,16,0,0,0,0,0,-1978362735,781062938,9686.720087,1494026731,149402673.1,2,88106,4237,1070,1608,538,1070,88106,538,1608,139.0341207,2.648293963,4.018372703,61511.41995,1061.632546,6.850393701,99350.53281,0.616858993,0.010673511,7.06479E-05,0.334577114,0.018250743,55,16
D:0| T0: 0.17| T1: 16.00| R0: 0.0| R1: 0.0| WTP: 0,0,0.173076923,16,0,0,0,0,0,-2058937187,338783425,11254.77763,1496198305,149619830.5,2,94441,4301,923,1869,946,923,94441,946,1869,137.7073791,2.20610687,4.58778626,56802.77099,1963.870229,6.941475827,99219.46565,0.568850686,0.019767913,7.15121E-05,0.506153023,0.019790134,57,16
D:0| T0: 0.17| T1: 16.00| R0: 0.0| R1: 0.0| WTP: 0,0,0.173076923,16,0,0,0,0,0,-2002321957,1027579040,10368.04218,1483919847,148391984.7,2,84511,3757,984,1722,738,984,84511,738,1722,95.22040816,1.92244898,3.412244898,67553.07347,1307.089796,5.408163265,99389.29592,0.676611548,0.013155718,5.55874E-05,0.428571429,0.020376046,69,16
D:0| T0: 0.17| T1: 16.00| R0: 0.0| R1: 0.0| WTP: 0,0,0.173076923,16,0,0,0,0,0,-2069006395,764973813,11565.38067,1490737362,149073736.2,2,91913,4015,1144,1921,777,1144,91913,777,1921,127.3863636,2.744949495,4.666666667,56978.81061,1585.563131,7.547979798,99161.84343,0.571558149,0.015966005,7.79103E-05,0.404476835,0.020900199,56,16
D:0| T0: 0.17| T1: 16.00| R0: 0.0| R1: 0.0| WTP: 0,0,0.173076923,16,0,0,0,0,0,-2094929796,1245753446,12034.68772,1493195410,149319541,2,93368,4130,1337,1999,662,1337,93368,662,1999,135.4094488,3.385826772,5.089238845,47654.11286,1671.713911,8.564304462,98944.27559,0.479219797,0.016841137,8.81898E-05,0.331165583,0.021409905,55,16
D:0| T0: 0.17| T1: 16.00| R0: 0.0| R1: 0.0| WTP: 0,0,0.173076923,16,0,0,0,0,0,-2042485793,1013177794,11226.02416,1481184585,148118458.5,2,84703,3555,1239,1865,626,1239,84703,626,1865,113.6403061,3.00255102,4.573979592,59004.7449,902.8418367,7.739795918,99142.83929,0.59300683,0.009090687,7.97008E-05,0.335656836,0.02201811,56,16
D:0| T0: 0.17| T1: 16.00| R0: 0.0| R1: 0.0| WTP: 0,0,0.173076923,16,0,0,0,0,0,-1405947845,1395089249,54.31437069,1403232127,140323212.7,2,867,37,9,9,0,9,867,0,9,2.642105263,0.010526316,0.010526316,99400.07895,24.06315789,0.052631579,99994.11053,0.994069425,0.000241844,9.42445E-07,0,0.010380623,28,16
D:0| T0: 0.17| T1: 16.00| R0: 0.0| R1: 0.0| WTP: 0,0,0.173076923,16,0,0,0,0,0,-438852878.3,1339545835,12.01008238,438252374.2,43825237.42,1,66,0,2,2,0,2,66,0,2,0,0,0,99962.31579,4.557894737,0.021052632,99998.72632,0.99963791,4.76049E-05,4.16669E-07,0,0.03030303,14,5
D:0| T0: 0.17| T1: 16.00| R0: 0.0| R1: 0.0| WTP: 0,0,0.173076923,16,0,0,0,0,0,-1803808453,219139554,11410.78146,1233269380,123326938,1,95408,4273,467,1895,1428,467,95408,1428,1895,366.147651,3.060402685,12.57718121,32898,1681.52349,15.7114094,98779.59732,0.331041421,0.016848896,0.000158928,0.753562005,0.019862066,22,13
D:0| T0: 0.17| T1: 16.00| R0: 0.0| R1: 0.0| WTP: 0,0,0.173076923,16,0,0,0,0,0,-1428864147,1336508942,451.6680232,1406280746,140628074.6,1,3698,167,75,75,0,75,3698,0,75,13.33727811,0.284023669,0.284023669,97760.78107,87.67455621,0.75739645,99962.23077,0.977996639,0.00087437,8.82671E-06,0,0.020281233,25,16
D:0| T0: 0.17| T1: 16.00| R0: 0.0| R1: 0.0| WTP: 0,0,0.173076923,16,0,0,0,0,0,-703999557.1,448559423,54.07595311,701295759.4,70129575.94,1,162,4,9,9,0,9,162,0,9,0.434782609,0.017391304,0.017391304,99910.31304,10.29565217,0.095652174,99997.29565,0.999132373,0.000104226,1.55178E-06,0,0.055555556,17,8
D:0| T0: 0.17| T1: 16.00| R0: 0.0| R1: 0.0| WTP: 0,0,0.173076923,16,0,0,0,0,0,-2076580947,2110028840,11733.20043,1489920926,148992092.6,2,90553,3977,965,1949,984,965,90553,984,1949,124.6243781,2.273631841,4.699004975,61616.98507,1099.514925,7.094527363,99239.10945,0.617514563,0.011071246,7.29899E-05,0.504874295,0.021523307,58,16
D:0| T0: 0.17| T1: 16.00| R0: 0.0| R1: 0.0| WTP: 0,0,0.173076923,16,0,0,0,0,0,-2145798292,1982030155,13155.89066,1488003759,148800375.9,2,91127,3787,1041,2186,1145,1041,91127,1145,2186,114.2682353,2.312941176,4.964705882,54673.49176,1419.023529,7.418823529,98980.18118,0.548342463,0.014308702,7.65589E-05,0.52378774,0.0239885,61,16
D:0| T0: 0.17| T1: 16.00| R0: 0.0| R1: 0.0| WTP: 0,0,0.173076923,16,0,0,0,0,0,-2053175721,696219407,11406.71337,1482840053,148284005.3,2,84939,3651,1219,1895,676,1219,84939,676,1895,129.7179487,3.307692308,5.205128205,59866.34188,804.4957265,8.692307692,99149.8433,0.601290829,0.008098717,8.92571E-05,0.356728232,0.022310128,51,16
D:0| T0: 0.17| T1: 16.00| R0: 0.0| R1: 0.0| WTP: 0,0,0.173076923,16,0,0,0,0,0,-1990826146,1402539442,10104.21028,1485615632,148561563.2,1,84628,3787,549,1678,1129,549,84628,1129,1678,283.7705882,3.147058824,9.741176471,44141.80588,2280.270588,12.94117647,99002.20588,0.443936197,0.022846769,0.000131338,0.672824791,0.019827953,25,16
D:0| T0: 0.17| T1: 16.00| R0: 0.0| R1: 0.0| WTP: 0,0,0.173076923,16,0,0,0,0,0,-1994857532,1319833493,10276.87562,1481013751,148101375.1,2,82058,3679,610,1707,1097,610,82058,1097,1707,238.2210526,3.126315789,8.857894737,43280.44737,2916.078947,12.05263158,98936.47895,0.435733895,0.029241979,0.000122354,0.64264792,0.020802359,28,16
D:0| T0: 0.17| T1: 16.00| R0: 0.0| R1: 0.0| WTP: 0,0,0.173076923,16,0,0,0,0,0,-2052146240,663608076,11323.54074,1485969202,148596920.2,2,87387,3837,968,1881,913,968,87387,913,1881,120.5959596,2.308080808,4.575757576,66271.38384,1326.222222,7.005050505,99329.03788,0.664007604,0.013353153,7.24275E-05,0.485380117,0.021524941,57,16
D:0| T0: 0.17| T1: 16.00| R0: 0.0| R1: 0.0| WTP: 0,0,0.173076923,16,0,0,0,0,0,-1997842251,414696500,10342.97871,1480693315,148069331.5,2,81525,3565,997,1718,721,997,81525,721,1718,94.10947368,1.995789474,3.484210526,70556.42947,1189.587368,5.581052632,99426.99579,0.706715321,0.011972343,5.75265E-05,0.41967404,0.02107329,67,16
D:0| T0: 0.17| T1: 16.00| R0: 0.0| R1: 0.0| WTP: 0,0,0.173076923,16,0,0,0,0,0,-1235681494,1249738535,150.4741011,1228157789,122815778.9,1,990,45,25,25,0,25,990,0,25,3.826086957,0.068322981,0.068322981,99391.55901,24.61490683,0.211180124,99987.7205,0.994045566,0.000246872,3.08678E-06,0,0.025252525,23,14
D:0| T0: 0.17| T1: 16.00| R0: 0.0| R1: 0.0| WTP: 0,0,0.173076923,16,0,0,0,0,0,-2023800780,614415382,10900.85863,1478757848,147875784.8,2,81120,3428,984,1811,827,984,81120,827,1811,96.45777778,2.088888889,3.895555556,67364.14,1147.866667,6.071111111,99325.59556,0.675116555,0.011556358,6.25325E-05,0.456653782,0.022324951,65,16
D:0| T0: 0.17| T1: 16.00| R0: 0.0| R1: 0.0| WTP: 0,0,0.173076923,16,0,0,0,0,0,-1404375012,524899953,30.17289825,1402866368,140286636.8,2,477,28,5,5,0,5,477,0,5,1.573033708,0,0,99685.44382,15.26966292,0.028089888,99996.79213,0.996892156,0.000154194,5.5867E-07,0,0.01048218,26,16
D:0| T0: 0.17| T1: 16.00| R0: 0.0| R1: 0.0| WTP: 0,0,0.173076923,16,0,0,0,0,0,-1868528488,1338977757,12660.58602,1235499187,123549918.7,1,98967,4419,403,2103,1700,403,98967,1700,2103,361.6623377,2.545454545,13.53896104,26152.23377,1689.824675,16.16233766,98549.27273,0.263361216,0.016945494,0.000163349,0.808368997,0.021249507,22,13
D:0| T0: 0.17| T1: 16.00| R0: 0.0| R1: 0.0| WTP: 0,0,0.173076923,16,0,0,0,0,0,-1996311524,341384587,10377.79317,1477421866,147742186.6,2,78975,3373,518,1724,1206,518,78975,1206,1724,230.9679144,2.695187166,9.096256684,43613.90909,1431.032086,11.86631016,98861.60428,0.439601863,0.01434678,0.000120265,0.699535963,0.021829693,27,16
D:0| T0: 0.17| T1: 16.00| R0: 0.0| R1: 0.0| WTP: 0,0,0.173076923,16,0,0,0,0,0,-2107406307,2032000160,12404.97879,1487157367,148715736.7,2,90264,3884,1181,2061,880,1181,90264,880,2061,120.2807018,2.817042607,4.98245614,55353.6792,1534.884712,7.939849624,99050.59148,0.555451829,0.015467415,8.18511E-05,0.426977196,0.022833023,57,16
D:0| T0: 0.17| T1: 16.00| R0: 0.0| R1: 0.0| WTP: 0,0,0.173076923,16,0,0,0,0,0,-1961443818,779488939,9722.526551,1475317491,147531749.1,2,76035,3316,566,1615,1049,566,76035,1049,1615,185.0264317,2.387665198,6.95154185,44765.9207,1272.709251,9.466960352,98909.29956,0.451206509,0.012766123,9.64439E-05,0.649535604,0.021240218,33,16
D:0| T0: 0.17| T1: 16.00| R0: 0.0| R1: 0.0| WTP: 0,0,0.173076923,16,0,0,0,0,0,-2057138161,1449019578,11514.23924,1481426199,148142619.9,2,86427,3663,985,1913,928,985,86427,928,1913,108.4130435,2.248792271,4.456521739,66057.80435,1305.270531,6.835748792,99302.6087,0.661903968,0.013145324,7.04917E-05,0.485101934,0.022134287,59,16
D:0| T0: 0.17| T1: 16.00| R0: 0.0| R1: 0.0| WTP: 0,0,0.173076923,16,0,0,0,0,0,-1231066491,351952211,66.26538164,1227753222,122775322.2,1,521,28,11,11,0,11,521,0,11,2.541935484,0.006451613,0.006451613,99682.72903,14.9483871,0.096774194,99994.78065,0.996884685,0.000151096,1.41033E-06,0,0.021113244,23,14
D:0| T0: 0.17| T1: 16.00| R0: 0.0| R1: 0.0| WTP: 0,0,0.173076923,16,0,0,0,0,0,-1405671142,486595046,60.13217012,1402664534,140266453.4,2,387,16,10,10,0,10,387,0,10,0.782828283,0,0,99788.40404,15.40909091,0.050505051,99995.34848,0.99793291,0.000155585,1.00507E-06,0,0.025839793,27,16
D:0| T0: 0.17| T1: 16.00| R0: 0.0| R1: 0.0| WTP: 0,0,0.173076923,16,0,0,0,0,0,-2043923457,296745624,11196.90049,1484078432,148407843.2,2,87132,3805,1216,1860,644,1216,87132,644,1860,104.5598194,2.60496614,4.027088036,48446.33409,967.8781038,6.769751693,98950.39729,0.48796034,0.009748285,6.99404E-05,0.346236559,0.021346922,64,16
D:0| T0: 0.17| T1: 16.00| R0: 0.0| R1: 0.0| WTP: 0,0,0.173076923,16,0,0,0,0,0,-1962676581,1671484194,9711.225507,1477115305,147711530.5,2,78487,3471,963,1613,650,963,78487,650,1613,92.34415584,1.976190476,3.352813853,67800.90476,872.7012987,5.435064935,99375.74026,0.679666809,0.008779014,5.60787E-05,0.402975821,0.020551174,66,16
D:0| T0: 0.17| T1: 16.00| R0: 0.0| R1: 0.0| WTP: 0,0,0.173076923,16,0,0,0,0,0,-2090180578,422157396,11879.18551,1496221303,149622130.3,2,98334,4369,476,1973,1497,476,98334,1497,1973,303.9050279,2.592178771,10.92178771,26113.46927,2049.960894,13.58100559,98631.15642,0.262861855,0.020571472,0.000137384,0.758743031,0.020064271,26,16
D:0| T0: 0.17| T1: 16.00| R0: 0.0| R1: 0.0| WTP: 0,0,0.173076923,16,0,0,0,0,0,-1963423376,1916599091,12816.58979,1322593886,132259388.6,1,98431,4258,447,2129,1682,447,98431,1682,2129,350.1329114,2.753164557,13.34810127,27640.51899,2168.949367,16.1835443,98569.12025,0.278220405,0.021755487,0.000163717,0.790042273,0.021629365,23,14
D:0| T0: 0.17| T1: 16.00| R0: 0.0| R1: 0.0| WTP: 0,0,0.173076923,16,0,0,0,0,0,-1846254200,1005953941,12216.23243,1235442578,123544257.8,1,98342,4312,495,2029,1534,495,98342,1534,2029,368.8013245,3.225165563,13.32450331,30384.56954,2637.046358,16.58940397,98711.46358,0.305556772,0.026435801,0.000167715,0.756037457,0.02063208,22,13
D:0| T0: 0.17| T1: 16.00| R0: 0.0| R1: 0.0| WTP: 0,0,0.173076923,16,0,0,0,0,0,-1922051942,1422765615,12241.99292,1309952296,130995229.6,1,88872,3789,548,2034,1486,548,88872,1486,2034,297.05,3.31875,12.5375,40028.55,1926.55,16.00625,98767.19375,0.402835345,0.019329845,0.000161992,0.730580138,0.022886849,23,14
D:0| T0: 0.17| T1: 16.00| R0: 0.0| R1: 0.0| WTP: 0,0,0.173076923,16,0,0,0,0,0,-1141173493,699740192,30.09482132,1139668752,113966875.2,1,339,16,5,5,0,5,339,0,5,0.805194805,0.012987013,0.012987013,99795.20779,13.00649351,0.045454545,99997.74026,0.997978703,0.000131615,6.45172E-07,0,0.014749263,22,13
D:0| T0: 0.17| T1: 16.00| R0: 0.0| R1: 0.0| WTP: 0,0,0.173076923,16,0,0,0,0,0,-877077009.2,240885764,6.0931291,876772352.8,87677235.28,1,99,9,1,1,0,1,99,0,1,1.3046875,0,0,99939.54688,3.9609375,0.0078125,99999.63281,0.999401857,4.1628E-05,1.55039E-07,0,0.01010101,19,10
D:0| T0: 0.17| T1: 16.00| R0: 0.0| R1: 0.0| WTP: 0,0,0.173076923,16,0,0,0,0,0,-1751226524,2023806564,7473.239389,1377564554,137756455.4,1,64820,2923,579,1241,662,579,64820,662,1241,217.0898204,3.335329341,7.251497006,57969.91018,1628.628743,10.71856287,99283.88024,0.582960091,0.016284955,0.000109006,0.533440774,0.019145326,24,15
D:0| T0: 0.17| T1: 16.00| R0: 0.0| R1: 0.0| WTP: 0,0,0.173076923,16,0,0,0,0,0,-1409573787,1907493879,132.2933622,1402959119,140295911.9,1,938,34,22,22,0,22,938,0,22,1.761363636,0.051136364,0.051136364,99451.4375,32.5625,0.176136364,99987.76705,0.994641665,0.000326367,2.48613E-06,0,0.023454158,25,16
D:0| T0: 0.17| T1: 16.00| R0: 0.0| R1: 0.0| WTP: 0,0,0.173076923,16,0,0,0,0,0,-2099403606,1565815291,12290.11518,1484897847,148489784.7,2,91330,3831,1139,2042,903,1139,91330,903,2042,123.7718833,2.864721485,5.222811671,56559.21485,1947.169761,8.228116711,99112.25199,0.567177203,0.01961001,8.49831E-05,0.442430181,0.022347531,54,16
D:0| T0: 0.17| T1: 16.00| R0: 0.0| R1: 0.0| WTP: 0,0,0.173076923,16,0,0,0,0,0,-1893304586,784442364,8459.952924,1470306940,147030694,2,70142,3076,1079,1405,326,1079,70142,326,1405,74.69111969,1.955598456,2.561776062,71618.5888,714.9517375,4.638996139,99464.21042,0.718068364,0.007186757,4.81932E-05,0.23202847,0.020030795,73,16
D:0| T0: 0.17| T1: 16.00| R0: 0.0| R1: 0.0| WTP: 0,0,0.173076923,16,0,0,0,0,0,-1938372279,206369745,9224.662745,1477139142,147713914.2,2,76953,3443,550,1532,982,550,76953,982,1532,238.8176796,2.928176796,8.303867403,48480.9116,1774.883978,11.3480663,99067.62431,0.487857087,0.017778876,0.00011528,0.640992167,0.019908256,26,16
D:0| T0: 0.17| T1: 16.00| R0: 0.0| R1: 0.0| WTP: 0,0,0.173076923,16,0,0,0,0,0,-2082281117,2087235992,11811.70151,1491696042,149169604.2,2,94449,4081,555,1962,1407,555,94449,1407,1962,284.9779006,2.983425414,10.68508287,32573.52486,2271.955801,13.75138122,98736.20994,0.327710743,0.022793562,0.00013965,0.717125382,0.020773116,26,16
D:0| T0: 0.17| T1: 16.00| R0: 0.0| R1: 0.0| WTP: 0,0,0.173076923,16,0,0,0,0,0,-2043431996,1019092536,11066.64176,1490099908,149009990.8,2,89847,4041,947,1838,891,947,89847,891,1838,125.605985,2.234413965,4.421446384,63370.86284,1242.802993,6.773067332,99320.12718,0.634859428,0.012507484,6.9899E-05,0.48476605,0.020456999,58,16
D:0| T0: 0.17| T1: 16.00| R0: 0.0| R1: 0.0| WTP: 0,0,0.173076923,16,0,0,0,0,0,-1987282053,1885906113,10251.06159,1474728973,147472897.3,2,77301,3298,1280,1703,423,1280,77301,423,1703,92.8428246,2.751708428,3.69476082,57691.16401,536.8952164,6.619589977,99113.3303,0.580282726,0.005403783,6.83602E-05,0.248385203,0.022031048,63,16
D:0| T0: 0.17| T1: 16.00| R0: 0.0| R1: 0.0| WTP: 0,0,0.173076923,16,0,0,0,0,0,-1475893206,2028637200,1264.513638,1412667524,141266752.4,1,11082,498,207,210,3,207,11082,3,210,33.42528736,1.051724138,1.063218391,92742.43678,248.8793103,2.229885057,99875.66667,0.928634903,0.002479365,2.38523E-05,0.014285714,0.018951358,25,16
D:0| T0: 0.17| T1: 16.00| R0: 0.0| R1: 0.0| WTP: 0,0,0.173076923,16,0,0,0,0,0,-2018360798,181476086,10709.8204,1482869778,148286977.8,2,86739,3824,537,1779,1242,537,86739,1242,1779,249.2956989,2.806451613,9.424731183,39414.52688,2185.919355,12.32258065,98865.46237,0.396737754,0.021924178,0.000124957,0.698145025,0.020509805,27,16
D:0| T0: 0.17| T1: 16.00| R0: 0.0| R1: 0.0| WTP: 0,0,0.173076923,16,0,0,0,0,0,-2028041858,2097578470,10842.9697,1485893373,148589337.3,2,85558,3814,584,1801,1217,584,85558,1217,1801,259.1290323,3.059139785,9.548387097,40090.06452,2490.709677,12.67204301,98856.64516,0.403672229,0.024981195,0.000128687,0.675735702,0.021050048,27,16
D:0| T0: 0.17| T1: 16.00| R0: 0.0| R1: 0.0| WTP: 0,0,0.173076923,16,0,0,0,0,0,-2077300355,119646392,11863.44451,1484128130,148412813,2,87339,3710,999,1971,972,999,87339,972,1971,120.7428571,2.444155844,4.932467532,63339.96104,1433.475325,7.506493506,99236.22857,0.634819844,0.014436333,7.76876E-05,0.493150685,0.022567238,55,16
D:0| T0: 0.17| T1: 16.00| R0: 0.0| R1: 0.0| WTP: 0,0,0.173076923,16,0,0,0,0,0,-1822268896,1298895859,11824.44223,1231046784,123104678.4,1,95331,4196,512,1964,1452,512,95331,1452,1964,353.56,3.333333333,12.93333333,35246.99333,2644.933333,16.35333333,98804.68,0.354356787,0.026513078,0.000165562,0.739307536,0.020601903,22,13
D:0| T0: 0.17| T1: 16.00| R0: 0.0| R1: 0.0| WTP: 0,0,0.173076923,16,0,0,0,0,0,-2011986463,1489316290,10625.0589,1480733518,148073351.8,2,82534,3668,529,1765,1236,529,82534,1236,1765,211.7887324,2.403755869,8.154929577,38400.00469,1348.258216,10.63849765,98764.79343,0.387276667,0.013528474,0.000108127,0.700283286,0.021385126,31,16
D:0| T0: 0.17| T1: 16.00| R0: 0.0| R1: 0.0| WTP: 0,0,0.173076923,16,0,0,0,0,0,-2191662122,855602142,14009.49354,1491187445,149118744.5,2,96194,3955,472,2328,1856,472,96194,1856,2328,236.6604651,2.153488372,10.74883721,26336.70233,1594.795349,12.94418605,98322.34419,0.265324005,0.016043383,0.000131127,0.797250859,0.024201094,31,16
D:0| T0: 0.17| T1: 16.00| R0: 0.0| R1: 0.0| WTP: 0,0,0.173076923,16,0,0,0,0,0,-2060740029,1438649896,11515.50069,1484964995,148496499.5,2,89386,3860,1284,1913,629,1284,89386,629,1913,108.0972222,2.835648148,4.259259259,54038.30556,1055.113426,7.217592593,99072.71065,0.542976076,0.010626884,7.45185E-05,0.328802927,0.021401562,61,16
D:0| T0: 0.17| T1: 16.00| R0: 0.0| R1: 0.0| WTP: 0,0,0.173076923,16,0,0,0,0,0,-2033970745,952489126,11217.34564,1473103463,147310346.3,2,77931,3237,1126,1864,738,1126,77931,738,1864,71.88043478,1.94384058,3.255434783,69525.7808,1083.628623,5.298913043,99322.11957,0.696931139,0.01091601,5.4574E-05,0.395922747,0.023918595,79,16
D:0| T0: 0.17| T1: 16.00| R0: 0.0| R1: 0.0| WTP: 0,0,0.173076923,16,0,0,0,0,0,-1687488373,1550779155,12652.83926,1054846410,105484641,1,99140,4210,405,2102,1697,405,99140,1697,2102,388.0444444,2.925925926,15.45185185,25772.78519,2053.718519,18.45185185,98562.6,0.259796048,0.020577355,0.00018625,0.807326356,0.02120234,20,11
D:0| T0: 0.17| T1: 16.00| R0: 0.0| R1: 0.0| WTP: 0,0,0.173076923,16,0,0,0,0,0,-1955511194,607323321,9567.139835,1477154202,147715420.2,2,76923,3395,981,1589,608,981,76923,608,1589,93.05446623,2.045751634,3.337690632,72910.1634,814.4727669,5.45751634,99483.59695,0.730390782,0.008191806,5.63128E-05,0.382630585,0.020657558,66,16
D:0| T0: 0.17| T1: 16.00| R0: 0.0| R1: 0.0| WTP: 0,0,0.173076923,16,0,0,0,0,0,-1763967924,2103646485,6320.595797,1447938134,144793813.4,1,48476,2088,518,1050,532,518,48476,532,1050,152.8176471,2.923529412,6.017647059,68788.1,861.6882353,9.047058824,99382.15294,0.691607142,0.008609496,9.21735E-05,0.506666667,0.021660203,25,16
D:0| T0: 0.17| T1: 16.00| R0: 0.0| R1: 0.0| WTP: 0,0,0.173076923,16,0,0,0,0,0,-1967351175,258120157,11146.97866,1410002242,141000224.2,1,97711,4438,441,1851,1410,441,97711,1410,1851,336.3151515,2.6,11.09090909,25085.55152,1505.909091,13.77575758,98682.07273,0.25287235,0.015096437,0.000139335,0.761750405,0.018943619,24,15
D:0| T0: 0.17| T1: 16.00| R0: 0.0| R1: 0.0| WTP: 0,0,0.173076923,16,0,0,0,0,0,-1443298600,1068951401,674.9467064,1409551264,140955126.4,2,6848,326,112,112,0,112,6848,0,112,19.8708134,0.435406699,0.435406699,95174.23445,127.6172249,0.976076555,99927.33971,0.952488261,0.001272629,1.06723E-05,0,0.01635514,30,16
D:0| T0: 0.17| T1: 16.00| R0: 0.0| R1: 0.0| WTP: 0,0,0.173076923,16,0,0,0,0,0,-2028256501,635956235,10878.60931,1484326036,148432603.6,2,85992,3771,961,1807,846,961,85992,846,1807,108.6890951,2.113689095,4.039443155,67720.76102,1513.199536,6.262180974,99382.66821,0.678222629,0.015230436,6.46519E-05,0.468179303,0.021013583,61,16
D:0| T0: 0.17| T1: 16.00| R0: 0.0| R1: 0.0| WTP: 0,0,0.173076923,16,0,0,0,0,0,-1056481164,1346693470,78.31500247,1052565414,105256541.4,1,830,35,13,13,0,13,830,0,13,3.167832168,0.034965035,0.034965035,99510.42657,29.68531469,0.104895105,99993.27972,0.995177696,0.00029731,1.80566E-06,0,0.015662651,21,12
D:0| T0: 0.17| T1: 16.00| R0: 0.0| R1: 0.0| WTP: 0,0,0.173076923,16,0,0,0,0,0,-2053644038,847102011,12959.21789,1405683144,140568314.4,1,98233,4205,472,2153,1681,472,98233,1681,2153,319.4573171,2.817073171,13,28185.04878,2044.310976,15.8597561,98563.80488,0.283633893,0.020520756,0.000160784,0.780771017,0.021917278,24,15
D:0| T0: 0.17| T1: 16.00| R0: 0.0| R1: 0.0| WTP: 0,0,0.173076923,16,0,0,0,0,0,-2126135463,812083272,12795.25932,1486372497,148637249.7,2,90577,3736,1576,2126,550,1576,90577,550,2126,127.3468835,4.119241192,5.552845528,50829.63957,1501.769648,9.845528455,98923.13821,0.510798381,0.015137296,0.000101076,0.258701787,0.023471742,53,16
D:0| T0: 0.17| T1: 16.00| R0: 0.0| R1: 0.0| WTP: 0,0,0.173076923,16,0,0,0,0,0,-2086149501,2146825809,11771.51154,1497573924,149757392.4,2,98874,4500,465,1955,1490,465,98874,1490,1955,310.3202247,2.556179775,10.8988764,22618.65169,1755.179775,13.51123596,98579.26404,0.228024452,0.017605376,0.000136496,0.762148338,0.01977264,26,16
D:0| T0: 0.17| T1: 16.00| R0: 0.0| R1: 0.0| WTP: 0,0,0.173076923,16,0,0,0,0,0,-2049126291,226186520,12851.40519,1406556032,140655603.2,1,97214,4231,468,2135,1667,468,97214,1667,2135,315.2619048,2.726190476,12.57738095,29346.85714,1687.755952,15.35714286,98566.32143,0.29534006,0.016944885,0.00015565,0.780796253,0.021961857,24,15
D:0| T0: 0.17| T1: 16.00| R0: 0.0| R1: 0.0| WTP: 0,0,0.173076923,16,0,0,0,0,0,-2121986602,1110225441,12616.51679,1491160762,149116076.2,2,93733,4026,1275,2096,821,1275,93733,821,2096,138.5674931,3.366391185,5.584022039,54042.13774,2002.760331,9.104683196,99066.10744,0.541893923,0.02017928,9.35384E-05,0.391698473,0.022361627,52,16
D:0| T0: 0.17| T1: 16.00| R0: 0.0| R1: 0.0| WTP: 0,0,0.173076923,16,0,0,0,0,0,-1987567460,1190767082,9884.692097,1493332855,149333285.5,2,92349,4222,1112,1641,529,1112,92349,529,1641,142.0867209,2.856368564,4.262872629,54071.36856,1338.00542,7.281842818,99238.17344,0.54262877,0.013452865,7.49865E-05,0.322364412,0.017769548,53,16
D:0| T0: 0.17| T1: 16.00| R0: 0.0| R1: 0.0| WTP: 0,0,0.173076923,16,0,0,0,0,0,-2008110417,2108234095,10582.61482,1478979676,147897967.6,2,81339,3571,1018,1758,740,1018,81339,740,1758,98.12612613,2.146396396,3.786036036,68115.28604,1123.137387,6.09009009,99350.96847,0.68276246,0.011305843,6.29242E-05,0.420932878,0.021613248,64,16
D:0| T0: 0.17| T1: 16.00| R0: 0.0| R1: 0.0| WTP: 0,0,0.173076923,16,0,0,0,0,0,-2062506633,465621985,13044.7896,1410267153,141026715.3,1,98735,4381,480,2167,1687,480,98735,1687,2167,334.5272727,2.83030303,13.01212121,26112.41818,2058.369697,15.90909091,98516.55758,0.262930085,0.020662792,0.000161171,0.778495616,0.021947638,24,15
D:0| T0: 0.17| T1: 16.00| R0: 0.0| R1: 0.0| WTP: 0,0,0.173076923,16,0,0,0,0,0,-1470907198,1487072553,1168.372375,1412488579,141248857.9,1,11183,472,192,194,2,192,11183,2,194,33.1849711,1,1.011560694,93079.32948,235.1213873,2.115606936,99890.27746,0.931853345,0.00234256,2.22045E-05,0.010309278,0.017350863,25,16
D:0| T0: 0.17| T1: 16.00| R0: 0.0| R1: 0.0| WTP: 0,0,0.173076923,16,0,0,0,0,0,-2004058776,1213733847,10563.76674,1475870439,147587043.9,2,80931,3410,1445,1755,310,1445,80931,310,1755,93.34920635,3.12244898,3.784580499,51419.31293,776.0385488,7.06122449,99002.7619,0.517897653,0.007810877,7.30491E-05,0.176638177,0.021685139,63,16
D:0| T0: 0.17| T1: 16.00| R0: 0.0| R1: 0.0| WTP: 0,0,0.173076923,16,0,0,0,0,0,-2040224356,2003658337,11178.04847,1481321932,148132193.2,2,84149,3646,1333,1857,524,1333,84149,524,1857,100.2162162,2.862612613,4.022522523,47433.16441,770.6396396,7.015765766,98889.47297,0.47823167,0.007761047,7.23821E-05,0.282175552,0.022068261,64,16
D:0| T0: 0.17| T1: 16.00| R0: 0.0| R1: 0.0| WTP: 0,0,0.173076923,16,0,0,0,0,0,-1056628393,1170868072,84.26888432,1052414949,105241494.9,1,737,34,14,14,0,14,737,0,14,2.5,0.027777778,0.027777778,99553.38889,29.02777778,0.111111111,99993.40972,0.995606114,0.000290569,1.93116E-06,0,0.018995929,21,12
D:0| T0: 0.17| T1: 16.00| R0: 0.0| R1: 0.0| WTP: 0,0,0.173076923,16,0,0,0,0,0,-2093899947,569919592,11915.80294,1498109800,149810980,2,99253,4499,426,1979,1553,426,99253,1553,1979,291.0471204,2.178010471,10.28272251,19861.66492,1353.65445,12.51308901,98501.8377,0.200403918,0.013586368,0.000126488,0.784739768,0.019938944,28,16
D:0| T0: 0.17| T1: 16.00| R0: 0.0| R1: 0.0| WTP: 0,0,0.173076923,16,0,0,0,0,0,-1946811888,1833180623,9144.857979,1489568989,148956898.9,2,83467,3921,1206,1518,312,1206,83467,312,1518,112.2008929,2.522321429,3.1875,49400.62277,859.65625,5.890625,99129.35714,0.497219897,0.008642618,6.11429E-05,0.205533597,0.018186828,64,16
D:0| T0: 0.17| T1: 16.00| R0: 0.0| R1: 0.0| WTP: 0,0,0.173076923,16,0,0,0,0,0,-2162777809,1123666637,13397.49232,1492903193,149290319.3,2,97045,4088,484,2226,1742,484,97045,1742,2226,292.4382022,2.646067416,12.37640449,26979.19101,1643.123596,15.08988764,98445.79213,0.271790086,0.016507599,0.000153066,0.782569632,0.022937812,26,16
D:0| T0: 0.17| T1: 16.00| R0: 0.0| R1: 0.0| WTP: 0,0,0.173076923,16,0,0,0,0,0,-1989138699,1682024981,10186.46636,1479815381,147981538.1,2,80454,3519,927,1692,765,927,80454,765,1692,52.14084507,0.95657277,1.83685446,30132.68427,772.8521127,2.92370892,98560.34977,0.305111156,0.007783791,3.09798E-05,0.45212766,0.021030651,121,16
D:0| T0: 0.17| T1: 16.00| R0: 0.0| R1: 0.0| WTP: 0,0,0.173076923,16,0,0,0,0,0,-2058752043,1687523543,11426.13526,1487445280,148744528,2,91121,3899,1019,1898,879,1019,91121,879,1898,126.8328982,2.522193211,4.783289817,56731.20627,907.7937337,7.449086162,99153.73368,0.568961287,0.009140211,7.66483E-05,0.463119073,0.020829447,55,16
D:0| T0: 0.17| T1: 16.00| R0: 0.0| R1: 0.0| WTP: 0,0,0.173076923,16,0,0,0,0,0,-2098517827,178034412,12141.87123,1491424265,149142426.5,1,94595,4091,473,2017,1544,473,94595,1544,2017,302.4882353,2.705882353,11.71176471,32179.84706,1957.470588,14.5,98671.00588,0.323884412,0.01964123,0.000147066,0.765493307,0.02132248,25,16
D:0| T0: 0.17| T1: 16.00| R0: 0.0| R1: 0.0| WTP: 0,0,0.173076923,16,0,0,0,0,0,-1965558549,739490003,11252.80218,1402918440,140291844,1,93004,4063,472,1869,1397,472,93004,1397,1869,315.3580247,2.858024691,11.41358025,35432.75926,1602.95679,14.30864198,98812.0679,0.356447524,0.016067527,0.000144941,0.747458534,0.02009591,24,15
D:0| T0: 0.17| T1: 16.00| R0: 0.0| R1: 0.0| WTP: 0,0,0.173076923,16,0,0,0,0,0,-1886084458,178482706,8510.628926,1460553012,146055301.2,2,63172,2774,540,1414,874,540,63172,874,1414,187.3446328,2.95480226,7.836158192,57986.71186,1529.644068,10.87570621,99144.86441,0.58376196,0.01531079,0.000110547,0.618104668,0.022383334,26,16
D:0| T0: 0.17| T1: 16.00| R0: 0.0| R1: 0.0| WTP: 0,0,0.173076923,16,0,0,0,0,0,-2113206666,1919366370,12578.22923,1484295205,148429520.5,2,89853,3663,1173,2090,917,1173,89853,917,2090,120.9842932,2.945026178,5.303664921,57037.8822,812.2303665,8.379581152,99072.41361,0.572972022,0.008184463,8.60498E-05,0.438755981,0.023260214,55,16
D:0| T0: 0.17| T1: 16.00| R0: 0.0| R1: 0.0| WTP: 0,0,0.173076923,16,0,0,0,0,0,-1981487002,1819796913,11429.23864,1410025070,141002507,1,97451,4460,447,1898,1451,447,97451,1451,1898,331.8562874,2.622754491,11.25149701,29956.10778,2402.502994,13.91616766,98757.13174,0.301268217,0.024087167,0.000140892,0.764488936,0.019476455,24,15
D:0| T0: 0.17| T1: 16.00| R0: 0.0| R1: 0.0| WTP: 0,0,0.173076923,16,0,0,0,0,0,-2114168816,1866591913,12418.85052,1493226290,149322629,2,95975,4151,890,2063,1173,890,95975,1173,2063,145.7927171,2.366946779,5.610644258,60413.36134,2212.137255,8.103641457,99239.81232,0.604618092,0.022282743,8.33301E-05,0.568589433,0.021495181,51,16
D:0| T0: 0.17| T1: 16.00| R0: 0.0| R1: 0.0| WTP: 0,0,0.173076923,16,0,0,0,0,0,-1854053111,1219425989,12401.84865,1233960679,123396067.9,1,99237,4466,445,2060,1615,445,99237,1615,2060,367.2281879,2.899328859,13.69798658,25378.61074,1725.073826,16.67785235,98582.61074,0.255690659,0.017298075,0.000168699,0.783980583,0.020758386,22,13
D:0| T0: 0.17| T1: 16.00| R0: 0.0| R1: 0.0| WTP: 0,0,0.173076923,16,0,0,0,0,0,-2081001749,502409586,11734.42741,1494280379,149428037.9,1,97438,4267,475,1949,1474,475,97438,1474,1949,306.0287356,2.655172414,11.08045977,28094.3908,2257.413793,13.83333333,98682,0.282737,0.022643698,0.00013985,0.756285274,0.020002463,25,16
D:0| T0: 0.17| T1: 16.00| R0: 0.0| R1: 0.0| WTP: 0,0,0.173076923,16,0,0,0,0,0,-1956592972,1405887957,9608.669848,1476159480,147615948,1,76415,3438,512,1596,1084,512,76415,1084,1596,251.7869822,2.940828402,9.313609467,49101.85207,1371.710059,12.32544379,99030.04142,0.494238164,0.013737337,0.000124981,0.679197995,0.020885952,25,16
D:0| T0: 0.17| T1: 16.00| R0: 0.0| R1: 0.0| WTP: 0,0,0.173076923,16,0,0,0,0,0,-2094420002,283033753,12288.32318,1480003843,148000384.3,1,87277,3583,531,2042,1511,531,87277,1511,2042,255.9884393,2.994219653,11.67052023,38554.0578,1341.491329,14.74566474,98675.24855,0.388482073,0.013467474,0.000149366,0.739960823,0.023396771,25,16
D:0| T0: 0.17| T1: 16.00| R0: 0.0| R1: 0.0| WTP: 0,0,0.173076923,16,0,0,0,0,0,-2059594563,1083157068,11544.74917,1482357105,148235710.5,2,85622,3605,1417,1918,501,1417,85622,501,1918,90.94141414,2.711111111,3.692929293,46922.20606,879.7494949,6.561616162,98866.23434,0.47321879,0.008864083,6.79135E-05,0.261209593,0.022400785,71,16
D:0| T0: 0.17| T1: 16.00| R0: 0.0| R1: 0.0| WTP: 0,0,0.173076923,16,0,0,0,0,0,-2056606167,1988704626,11555.58589,1478826873,147882687.3,2,81726,3398,1268,1920,652,1268,81726,652,1920,112.8110236,3.202099738,4.868766404,61989.26772,550.7926509,8.194225722,99148.50394,0.623029925,0.005548127,8.42289E-05,0.339583333,0.023493423,55,16
D:0| T0: 0.17| T1: 16.00| R0: 0.0| R1: 0.0| WTP: 0,0,0.173076923,16,0,0,0,0,0,-1782919123,884761309,12743.97338,1145720455,114572045.5,1,99069,4387,436,2117,1681,436,99069,1681,2117,369.3673469,2.911564626,14.29251701,24302.81633,1752.081633,17.2585034,98511.2381,0.245066138,0.017571463,0.00017431,0.794048181,0.021368945,21,12
D:0| T0: 0.17| T1: 16.00| R0: 0.0| R1: 0.0| WTP: 0,0,0.173076923,16,0,0,0,0,0,-1357033682,533485933,716.7577695,1321195794,132119579.4,1,6560,306,119,119,0,119,6560,0,119,22.79012346,0.617283951,0.617283951,95949.82099,110.5246914,1.351851852,99933.99383,0.960166,0.001101319,1.46094E-05,0,0.018140244,24,15
D:0| T0: 0.17| T1: 16.00| R0: 0.0| R1: 0.0| WTP: 0,0,0.173076923,16,0,0,0,0,0,-1454059797,632196071,897.0507331,1409207260,140920726,2,7021,309,148,149,1,148,7021,1,149,21.58988764,0.724719101,0.730337079,95478.33708,102.4719101,1.584269663,99911.10674,0.955670981,0.001022034,1.66039E-05,0.006711409,0.021222048,26,16
D:0| T0: 0.17| T1: 16.00| R0: 0.0| R1: 0.0| WTP: 0,0,0.173076923,16,0,0,0,0,0,-2132995666,393400457,12797.00807,1493145262,149314526.2,1,96342,4175,447,2126,1679,447,96342,1679,2126,304.3430233,2.540697674,12.26162791,30650.72093,1753.767442,14.8372093,98579.56395,0.30840584,0.017605094,0.000150281,0.789746002,0.022067219,25,16
D:0| T0: 0.17| T1: 16.00| R0: 0.0| R1: 0.0| WTP: 0,0,0.173076923,16,0,0,0,0,0,-1929437168,398973227,10756.71502,1391601417,139160141.7,1,82399,3546,541,1787,1246,541,82399,1246,1787,262.9107143,3.136904762,10.48809524,44001.22024,1467.214286,13.69642857,98895.46429,0.443037157,0.014703408,0.000138964,0.697257974,0.021687156,24,15
D:0| T0: 0.17| T1: 16.00| R0: 0.0| R1: 0.0| WTP: 0,0,0.173076923,16,0,0,0,0,0,-2022708223,1402256491,10747.06127,1485355159,148535515.9,2,86828,3838,1561,1785,224,1561,86828,224,1785,120.0179487,3.841025641,4.379487179,49213.37436,1408.758974,8.38974359,99012.43077,0.494922912,0.014179221,8.63278E-05,0.125490196,0.020557885,56,16
D:0| T0: 0.17| T1: 16.00| R0: 0.0| R1: 0.0| WTP: 0,0,0.173076923,16,0,0,0,0,0,-2016058618,2102527413,10697.31225,1481193005,148119300.5,2,80164,3568,779,1777,998,779,80164,998,1777,36.8261576,0.54021121,1.345247766,26067.342,376.6929326,1.975629569,98388.48578,0.264585316,0.003797497,2.09398E-05,0.561620709,0.022167611,176,16
D:0| T0: 0.17| T1: 16.00| R0: 0.0| R1: 0.0| WTP: 0,0,0.173076923,16,0,0,0,0,0,-2048563508,1748031099,11322.31507,1482447755,148244775.5,2,84820,3584,627,1881,1254,627,84820,1254,1881,249.6793478,3.331521739,10.09782609,42318.53804,2486.804348,13.48369565,98840.16304,0.42603791,0.024958767,0.000136848,0.666666667,0.022176373,27,16
D:0| T0: 0.17| T1: 16.00| R0: 0.0| R1: 0.0| WTP: 0,0,0.173076923,16,0,0,0,0,0,-2021604374,1946754629,10746.44858,1484281945,148428194.5,2,86711,3739,886,1785,899,886,86711,899,1785,126.2311828,2.233870968,4.615591398,66197.11559,893.3629032,7.005376344,99347.39785,0.663408373,0.008990649,7.22278E-05,0.503641457,0.020585624,54,16
D:0| T0: 0.17| T1: 16.00| R0: 0.0| R1: 0.0| WTP: 0,0,0.173076923,16,0,0,0,0,0,-2006762061,2097712204,10458.11658,1483856231,148385623.1,2,84914,3763,1072,1737,665,1072,84914,665,1737,126.1138211,2.737127371,4.509485095,64578.19241,717.498645,7.430894309,99325.45257,0.647902093,0.007218084,7.65479E-05,0.382843984,0.020455991,53,16
D:0| T0: 0.17| T1: 16.00| R0: 0.0| R1: 0.0| WTP: 0,0,0.173076923,16,0,0,0,0,0,-2039217056,1198827119,11148.03174,1481815469,148181546.9,2,84794,3600,928,1852,924,928,84794,924,1852,96.39148936,1.865957447,3.793617021,63511.50638,1155.146809,5.787234043,99254.22553,0.63644477,0.011632287,5.95701E-05,0.498920086,0.021841168,68,16
D:0| T0: 0.17| T1: 16.00| R0: 0.0| R1: 0.0| WTP: 0,0,0.173076923,16,0,0,0,0,0,-1404184043,109253198,30.1143433,1402678326,140267832.6,1,294,12,5,5,0,5,294,0,5,0.91160221,0.005524862,0.005524862,99818.67956,11.40331492,0.027624309,99997,0.998220311,0.000115882,5.49461E-07,0,0.017064846,25,16
D:0| T0: 0.17| T1: 16.00| R0: 0.0| R1: 0.0| WTP: 0,0,0.173076923,16,0,0,0,0,0,-1438170899,314481292,614.2164209,1407460078,140746007.8,1,4927,215,102,102,0,102,4927,0,102,17.11242604,0.49704142,0.49704142,96855.05917,87.1183432,1.100591716,99941.61538,0.969148319,0.000868848,1.20058E-05,0,0.020702253,25,16
D:0| T0: 0.17| T1: 20.00| R0: 0.0| R1: 0.0| WTP: 0,0,0.173076923,20,0,0,0,0,0,-1491858231,1178568022,30.12067847,1490352197,149035219.7,1,312,15,5,5,0,5,312,0,5,0.978378378,0,0,99803.43784,8.740540541,0.027027027,99996.95676,0.998068409,8.91422E-05,5.37645E-07,0,0.01607717,26,17
D:0| T0: 0.17| T1: 20.00| R0: 0.0| R1: 0.0| WTP: 0,0,0.173076923,20,0,0,0,0,0,-1906711473,2029998696,11746.56513,1319383216,131938321.6,1,95757,4310,471,1951,1480,471,95757,1480,1951,338.5,2.917721519,12.23417722,34133.97468,2047.259494,15.20253165,98787.36076,0.343134047,0.020521127,0.000153792,0.758585341,0.02037449,23,14
D:0| T0: 0.17| T1: 20.00| R0: 0.0| R1: 0.0| WTP: 0,0,0.173076923,20,0,0,0,0,0,-2353905681,776062361,10592.82305,1824264528,182426452.8,2,78228,3339,743,1760,1017,743,78228,1017,1760,176.2130435,3.130434783,7.5,47130.36087,2110.717391,10.73043478,98916.4087,0.47456726,0.021194146,0.00010934,0.577840909,0.022498338,32,20
D:0| T0: 0.17| T1: 20.00| R0: 0.0| R1: 0.0| WTP: 0,0,0.173076923,20,0,0,0,0,0,-1494647557,1813046880,78.28705192,1490733204,149073320.4,1,566,31,13,13,0,13,566,0,13,2.232044199,0.022099448,0.022099448,99628.38674,18.9558011,0.093922652,99992.45856,0.996365391,0.000191001,1.42865E-06,0,0.022968198,26,17
D:0| T0: 0.17| T1: 20.00| R0: 0.0| R1: 0.0| WTP: 0,0,0.173076923,20,0,0,0,0,0,-1432585441,2032407216,2029.219858,1331124449,133112444.9,1,17270,787,311,337,26,311,17270,26,337,56.13333333,1.757575758,1.903030303,89330.33939,364.8,3.793939394,99814.11515,0.894983692,0.003633692,3.90999E-05,0.077151335,0.019513607,24,15
D:0| T0: 0.17| T1: 20.00| R0: 0.0| R1: 0.0| WTP: 0,0,0.173076923,20,0,0,0,0,0,-789830023.7,1507873352,18.03885983,788928080.7,78892808.07,1,53,5,3,3,0,3,53,0,3,0.346153846,0,0,99969.92308,3.353846154,0.023076923,99999.23846,0.999708164,3.52674E-05,4.5802E-07,0,0.056603774,18,9
D:0| T0: 0.17| T1: 20.00| R0: 0.0| R1: 0.0| WTP: 0,0,0.173076923,20,0,0,0,0,0,-968754026.9,1855899401,78.28915632,964839569,96483956.9,1,825,38,13,13,0,13,825,0,13,2.927536232,0.036231884,0.036231884,99516.06522,21.85507246,0.115942029,99992.72464,0.995239322,0.000219585,1.87061E-06,0,0.015757576,20,11
D:0| T0: 0.17| T1: 20.00| R0: 0.0| R1: 0.0| WTP: 0,0,0.173076923,20,0,0,0,0,0,-2191793940,1819459251,7663.077644,1808640058,180864005.8,2,60030,2612,568,1273,705,568,60030,705,1273,154.3495146,2.669902913,6.04368932,58086.92233,1047.548544,8.82038835,99174.00971,0.584913616,0.010488404,8.9509E-05,0.553809898,0.021206064,30,20
D:0| T0: 0.17| T1: 20.00| R0: 0.0| R1: 0.0| WTP: 0,0,0.173076923,20,0,0,0,0,0,-879717430.9,909791748,48.30141192,877302360.3,87730236.03,1,712,35,8,8,0,8,712,0,8,3.715384615,0.023076923,0.023076923,99597.11538,18.2,0.092307692,99996.43846,0.996011817,0.000183516,1.22141E-06,0,0.011235955,19,10
D:0| T0: 0.17| T1: 20.00| R0: 0.0| R1: 0.0| WTP: 0,0,0.173076923,20,0,0,0,0,0,-2067673178,1339092841,5566.97975,1789324191,178932419.1,2,38470,1611,616,925,309,616,38470,309,925,87.58798283,2.519313305,3.811158798,73172.87124,594.2746781,6.463519313,99392.75966,0.735924975,0.00594557,6.6165E-05,0.334054054,0.02404471,34,20
D:0| T0: 0.17| T1: 20.00| R0: 0.0| R1: 0.0| WTP: 0,0,0.173076923,20,0,0,0,0,0,-2030729947,1365866345,12461.40314,1407659790,140765979,1,97538,4342,473,2070,1597,473,97538,1597,2070,323.5361446,2.777108434,12.3313253,30129.07229,1838.403614,15.18674699,98646.18072,0.303029949,0.018449069,0.000153835,0.771497585,0.021222498,24,15
D:0| T0: 0.17| T1: 20.00| R0: 0.0| R1: 0.0| WTP: 0,0,0.173076923,20,0,0,0,0,0,-2358432884,825453433,10440.83813,1836390978,183639097.8,2,86093,3854,1377,1734,357,1377,86093,357,1734,96.54175153,2.641547862,3.346232179,48808.10591,891.3441955,6.175152749,99028.97149,0.491032739,0.008971509,6.37717E-05,0.205882353,0.02014101,71,20
D:0| T0: 0.17| T1: 20.00| R0: 0.0| R1: 0.0| WTP: 0,0,0.173076923,20,0,0,0,0,0,-1951386180,939711378,12599.97694,1321387333,132138733.3,1,97565,4337,449,2093,1644,449,97565,1644,2093,352.1225806,2.806451613,13.36129032,32566.96774,2472.883871,16.23870968,98693.54839,0.327314107,0.024802877,0.000164638,0.785475394,0.021452365,23,14
D:0| T0: 0.17| T1: 20.00| R0: 0.0| R1: 0.0| WTP: 0,0,0.173076923,20,0,0,0,0,0,-2399011065,638950699,11180.5504,1839983545,183998354.5,2,90613,4074,1108,1857,749,1108,90613,749,1857,119.7975904,2.508433735,4.281927711,62260.7012,1388.877108,6.956626506,99277.31807,0.624267202,0.01398365,7.19094E-05,0.403338718,0.020493748,60,20
D:0| T0: 0.17| T1: 20.00| R0: 0.0| R1: 0.0| WTP: 0,0,0.173076923,20,0,0,0,0,0,-1811116201,938699148,1005.479527,1760842225,176084222.5,2,7896,374,167,167,0,167,7896,0,167,21.0521327,0.663507109,0.663507109,94547.03318,125.6635071,1.45971564,99893.94787,0.946523397,0.001253847,1.57674E-05,0,0.021149949,31,20
D:0| T0: 0.17| T1: 20.00| R0: 0.0| R1: 0.0| WTP: 0,0,0.173076923,20,0,0,0,0,0,-1754032212,121790188,18.05415653,1753129504,175312950.4,2,194,10,3,3,0,3,194,0,3,0.349056604,0,0,99886.25,7.735849057,0.014150943,99998.73585,0.998877348,7.92026E-05,2.81693E-07,0,0.015463918,30,20
D:0| T0: 0.17| T1: 20.00| R0: 0.0| R1: 0.0| WTP: 0,0,0.173076923,20,0,0,0,0,0,-2293880894,1331335240,9421.309407,1822815423,182281542.3,2,74200,3238,773,1565,792,773,74200,792,1565,68.24957265,1.251282051,2.582905983,35122.69231,833.7025641,3.899145299,98669.84615,0.355344957,0.008386464,4.02211E-05,0.506070288,0.021091928,84,20
D:0| T0: 0.17| T1: 20.00| R0: 0.0| R1: 0.0| WTP: 0,0,0.173076923,20,0,0,0,0,0,-2163737738,470935411,13362.35035,1495620221,149562022.1,1,98775,4173,475,2220,1745,475,98775,1745,2220,312.5,2.697674419,12.81395349,24473.4186,1485.94186,15.54651163,98426.86628,0.246574405,0.014924275,0.000157498,0.786036036,0.022475323,25,16
D:0| T0: 0.17| T1: 20.00| R0: 0.0| R1: 0.0| WTP: 0,0,0.173076923,20,0,0,0,0,0,-2469053927,823434397,12591.61342,1839473256,183947325.6,2,90213,3982,985,2092,1107,985,90213,1107,2092,126.2461538,2.374358974,5.171794872,68807.58974,1182.6,7.692307692,99339.88462,0.689340099,0.011919709,7.94913E-05,0.5291587,0.023189562,56,20
D:0| T0: 0.17| T1: 20.00| R0: 0.0| R1: 0.0| WTP: 0,0,0.173076923,20,0,0,0,0,0,-1147243496,493045351,132.4932633,1140618833,114061883.3,1,1358,62,22,22,0,22,1358,0,22,4.570469799,0.073825503,0.073825503,99178.87919,23.2147651,0.228187919,99988.9396,0.991908714,0.000233087,2.93363E-06,0,0.016212233,22,13
D:0| T0: 0.17| T1: 20.00| R0: 0.0| R1: 0.0| WTP: 0,0,0.173076923,20,0,0,0,0,0,-2339595139,1700216563,9973.713289,1840909475,184090947.5,2,86872,4048,905,1656,751,905,86872,751,1656,126.3880597,2.111940299,3.952736318,67436.11692,1162.793532,6.191542289,99429.51244,0.675344653,0.01169182,6.40656E-05,0.453502415,0.019062529,58,20
D:0| T0: 0.17| T1: 20.00| R0: 0.0| R1: 0.0| WTP: 0,0,0.173076923,20,0,0,0,0,0,-1699750614,1744119059,3565.528496,1521474189,152147418.9,1,31573,1438,445,592,147,445,31573,147,592,99.06043956,2.307692308,3.093406593,79206.44505,480.7417582,5.543956044,99645.01648,0.794821436,0.004795986,5.68324E-05,0.248310811,0.018750198,26,17
D:0| T0: 0.17| T1: 20.00| R0: 0.0| R1: 0.0| WTP: 0,0,0.173076923,20,0,0,0,0,0,-2394069423,2036906360,11220.32824,1833053011,183305301.1,2,84780,3707,1012,1864,852,1012,84780,852,1864,92.54878049,1.963414634,3.664634146,71775.45528,1206.069106,5.717479675,99433.31911,0.718694108,0.012147156,5.8879E-05,0.457081545,0.021986318,70,20
D:0| T0: 0.17| T1: 20.00| R0: 0.0| R1: 0.0| WTP: 0,0,0.173076923,20,0,0,0,0,0,-2363421528,809704121,10460.03673,1840419692,184041969.2,2,87952,3993,1031,1737,706,1031,87952,706,1737,122.6390244,2.351219512,4.041463415,65220.32195,1103.373171,6.573170732,99362.15366,0.653718478,0.011100814,6.79107E-05,0.406447899,0.019749409,58,20
D:0| T0: 0.17| T1: 20.00| R0: 0.0| R1: 0.0| WTP: 0,0,0.173076923,20,0,0,0,0,0,-2316420413,1219866412,9706.242733,1831108277,183110827.7,2,80701,3567,885,1612,727,885,80701,727,1612,38.00844595,0.651182432,1.258445946,27902.89105,560.4619932,2.010135135,98581.61402,0.282720424,0.005645236,2.12509E-05,0.450992556,0.019974969,170,20
D:0| T0: 0.17| T1: 20.00| R0: 0.0| R1: 0.0| WTP: 0,0,0.173076923,20,0,0,0,0,0,-880548875.2,843498920,72.19973601,876938888.4,87693888.84,1,647,29,12,12,0,12,647,0,12,1.92481203,0.015037594,0.015037594,99623.25564,22.4887218,0.127819549,99993.54887,0.996302547,0.000225537,1.79114E-06,0,0.018547141,19,10
D:0| T0: 0.17| T1: 20.00| R0: 0.0| R1: 0.0| WTP: 0,0,0.173076923,20,0,0,0,0,0,-2522523340,107351963,13766.99291,1834173695,183417369.5,2,92426,3740,1085,2288,1203,1085,92426,1203,2288,95.33472803,2.163179916,4.640167364,60155.53138,1347.209205,6.89748954,99081.88075,0.603052871,0.013595682,7.12066E-05,0.525786713,0.024754939,69,20
D:0| T0: 0.17| T1: 20.00| R0: 0.0| R1: 0.0| WTP: 0,0,0.173076923,20,0,0,0,0,0,-2441112312,773789021,11991.7468,1841524972,184152497.2,2,91425,4028,973,1992,1019,973,91425,1019,1992,120.0758294,2.158767773,4.545023697,63474.20616,1463.300948,6.860189573,99272.20379,0.635925465,0.0147412,7.07738E-05,0.511546185,0.021788351,61,20
D:0| T0: 0.17| T1: 20.00| R0: 0.0| R1: 0.0| WTP: 0,0,0.173076923,20,0,0,0,0,0,-2442981775,850936611,12216.95552,1832134000,183213400,2,88225,3651,1142,2030,888,1142,88225,888,2030,111.6,2.6775,4.8675,64108.8375,1166.4525,7.75,99226.925,0.643163695,0.011753479,7.98707E-05,0.437654017,0.022998016,58,20
D:0| T0: 0.17| T1: 20.00| R0: 0.0| R1: 0.0| WTP: 0,0,0.173076923,20,0,0,0,0,0,-2121011486,1701318364,6440.879931,1798967490,179896749,2,48546,2066,593,1070,477,593,48546,477,1070,128.1617647,2.799019608,5.098039216,66123.78431,1013.656863,8.014705882,99316.60294,0.665356634,0.010138231,8.15597E-05,0.445794393,0.022040951,30,20
D:0| T0: 0.17| T1: 20.00| R0: 0.0| R1: 0.0| WTP: 0,0,0.173076923,20,0,0,0,0,0,-1140198407,778708269,12.05544501,1139595635,113959563.5,1,160,9,2,2,0,2,160,0,2,0.577181208,0,0,99907.56376,7.577181208,0.013422819,99999.52349,0.999082926,7.74669E-05,2.66668E-07,0,0.012578616,22,13
D:0| T0: 0.17| T1: 20.00| R0: 0.0| R1: 0.0| WTP: 0,0,0.173076923,20,0,0,0,0,0,-1581914065,1391938506,1619.063448,1500960893,150096089.3,1,12213,490,265,269,4,265,12213,4,269,34.41242938,1.322033898,1.333333333,91991.17514,246.559322,2.870056497,99838.23164,0.921450195,0.002457106,3.00386E-05,0.014869888,0.02202571,26,17
D:0| T0: 0.17| T1: 20.00| R0: 0.0| R1: 0.0| WTP: 0,0,0.173076923,20,0,0,0,0,0,-966359998.7,43418681,36.15789548,964552103.9,96455210.39,1,448,22,6,6,0,6,448,0,6,1.766423358,0,0,99738.22628,18.38686131,0.04379562,99996.93431,0.997417343,0.000185078,8.69587E-07,0,0.013392857,20,11
D:0| T0: 0.17| T1: 20.00| R0: 0.0| R1: 0.0| WTP: 0,0,0.173076923,20,0,0,0,0,0,-2494584305,817384966,13042.80165,1842444222,184244422.2,2,97822,4117,441,2167,1726,441,97822,1726,2167,235.1506849,1.96803653,9.808219178,20561.99087,1216.515982,11.82648402,98330.76712,0.207488953,0.012227703,0.000119801,0.796492847,0.022152481,32,20
D:0| T0: 0.17| T1: 20.00| R0: 0.0| R1: 0.0| WTP: 0,0,0.173076923,20,0,0,0,0,0,-1933910598,762053968,12269.39796,1320440700,132044070,1,95458,4290,497,2038,1541,497,95458,1541,2038,339.6918239,3.062893082,12.68553459,32651.35849,1878.163522,15.80503145,98698.81761,0.328496954,0.018836603,0.000160036,0.756133464,0.021349704,23,14
D:0| T0: 0.17| T1: 20.00| R0: 0.0| R1: 0.0| WTP: 0,0,0.173076923,20,0,0,0,0,0,-2340525544,1692506311,10033.11007,1838870041,183887004.1,2,90045,3980,935,1666,731,935,90045,731,1666,108.0764192,1.919213974,3.480349345,65477.88428,1312.334061,5.524017467,99416.63319,0.655699911,0.01320174,5.7131E-05,0.43877551,0.01850186,65,20
D:0| T0: 0.17| T1: 20.00| R0: 0.0| R1: 0.0| WTP: 0,0,0.173076923,20,0,0,0,0,0,-615459852.2,1037620300,36.0634779,613656678.3,61365667.83,1,189,3,6,6,0,6,189,0,6,0.5625,0,0,99899.99107,6.258928571,0.0625,99997.875,0.999023061,6.41604E-05,1.06197E-06,0,0.031746032,16,7
D:0| T0: 0.17| T1: 20.00| R0: 0.0| R1: 0.0| WTP: 0,0,0.173076923,20,0,0,0,0,0,-1528169582,301400999,656.3266049,1495353251,149535325.1,1,5263,243,109,109,0,109,5263,0,109,16.64835165,0.467032967,0.467032967,96524.47802,120.7802198,1.054945055,99935.81319,0.965902233,0.001204021,1.19188E-05,0,0.020710621,26,17
D:0| T0: 0.17| T1: 20.00| R0: 0.0| R1: 0.0| WTP: 0,0,0.173076923,20,0,0,0,0,0,-2247108979,1868336855,8579.025629,1818157697,181815769.7,2,67252,2898,610,1425,815,610,67252,815,1425,171.0182648,2.689497717,6.365296804,52262.28311,1195.570776,9.155251142,99064.35616,0.526522568,0.011982025,9.31687E-05,0.571929825,0.021188961,32,20
D:0| T0: 0.17| T1: 20.00| R0: 0.0| R1: 0.0| WTP: 0,0,0.173076923,20,0,0,0,0,0,-2224097217,1868498144,8223.015062,1812946464,181294646.4,1,62583,2729,635,1366,731,635,62583,731,1366,168.8325123,3.019704433,6.581280788,57170.52709,1278.660099,9.684729064,99143.84236,0.575684899,0.012807541,9.877E-05,0.535139092,0.021827014,29,20
D:0| T0: 0.17| T1: 20.00| R0: 0.0| R1: 0.0| WTP: 0,0,0.173076923,20,0,0,0,0,0,-1763860154,2101566889,192.5684389,1754231732,175423173.2,2,1307,54,32,32,0,32,1307,0,32,3.470588235,0.078431373,0.078431373,99127.97059,35.24019608,0.230392157,99980.40686,0.991485172,0.000352835,3.12242E-06,0,0.02448355,30,20
D:0| T0: 0.17| T1: 20.00| R0: 0.0| R1: 0.0| WTP: 0,0,0.173076923,20,0,0,0,0,0,-1968416855,1665097450,13001.34028,1318349841,131834984.1,1,98303,4245,438,2160,1722,438,98303,1722,2160,335.0573248,2.732484076,13.63694268,28653.10191,2147.821656,16.41401274,98558.82803,0.28833457,0.021555904,0.000166186,0.797222222,0.02197288,23,14
D:0| T0: 0.17| T1: 20.00| R0: 0.0| R1: 0.0| WTP: 0,0,0.173076923,20,0,0,0,0,0,-1883626195,1716179948,11242.80387,1321486001,132148600.1,1,98040,4376,478,1867,1389,478,98040,1389,1867,349.6815287,2.98089172,11.75159236,31126.16561,2151.77707,14.78343949,98819.96815,0.312876334,0.021562003,0.000149784,0.74397429,0.019043248,23,14
D:0| T0: 0.17| T1: 20.00| R0: 0.0| R1: 0.0| WTP: 0,0,0.173076923,20,0,0,0,0,0,-1161076997,1560278715,391.0284409,1141525574,114152557.4,1,2287,99,65,65,0,65,2287,0,65,7.272151899,0.284810127,0.284810127,98698.41139,47.56962025,0.696202532,99967.28481,0.987315533,0.000475487,8.17863E-06,0,0.028421513,22,13
D:0| T0: 0.17| T1: 20.00| R0: 0.0| R1: 0.0| WTP: 0,0,0.173076923,20,0,0,0,0,0,-2330459506,991019385,10124.37815,1824240598,182424059.8,1,75581,3192,610,1682,1072,610,75581,1072,1682,207.2182741,3.015228426,8.401015228,47832.03046,2275.329949,11.49238579,98948.60914,0.48181966,0.02281456,0.000116747,0.637336504,0.02225427,29,20
D:0| T0: 0.17| T1: 20.00| R0: 0.0| R1: 0.0| WTP: 0,0,0.173076923,20,0,0,0,0,0,-2398957355,118052103,11228.07227,1837553741,183755374.1,2,86940,3787,1666,1865,199,1666,86940,199,1865,106.5190157,3.570469799,3.988814318,46403.40492,979.4742729,7.706935123,98912.6868,0.467239355,0.009864074,7.95571E-05,0.106702413,0.021451576,64,20
D:0| T0: 0.17| T1: 20.00| R0: 0.0| R1: 0.0| WTP: 0,0,0.173076923,20,0,0,0,0,0,-2018243144,1209758844,12487.00953,1393892667,139389266.7,1,88204,3609,528,2075,1547,528,88204,1547,2075,273.9515152,3.139393939,12.44848485,40211.76364,1568.357576,15.62424242,98708.38788,0.404832705,0.015744512,0.000158423,0.745542169,0.02352501,24,15
D:0| T0: 0.17| T1: 20.00| R0: 0.0| R1: 0.0| WTP: 0,0,0.173076923,20,0,0,0,0,0,-971295411.4,70671723,132.287538,964681034.5,96468103.45,1,879,37,22,22,0,22,879,0,22,2.096296296,0.096296296,0.096296296,99502.6,40.9037037,0.251851852,99989.91111,0.995132145,0.000408641,3.23562E-06,0,0.025028441,20,11
D:0| T0: 0.17| T1: 20.00| R0: 0.0| R1: 0.0| WTP: 0,0,0.173076923,20,0,0,0,0,0,-615724590.1,1722612191,42.05585974,613621797.1,61362179.71,1,154,7,7,7,0,7,154,0,7,0.339130435,0,0,99925.90435,6.269565217,0.069565217,99997.8,0.999282038,6.45706E-05,1.20693E-06,0,0.045454545,16,7
D:0| T0: 0.17| T1: 20.00| R0: 0.0| R1: 0.0| WTP: 0,0,0.173076923,20,0,0,0,0,0,-2240948107,1968291596,8352.573023,1823319456,182331945.6,2,71672,3301,950,1387,437,950,71672,437,1387,78.98235294,1.760784314,2.588235294,77388.27647,562.9215686,4.454901961,99597.41373,0.775012894,0.005657707,4.60501E-05,0.315068493,0.019352318,73,20
D:0| T0: 0.17| T1: 20.00| R0: 0.0| R1: 0.0| WTP: 0,0,0.173076923,20,0,0,0,0,0,-2081251979,1877569084,13494.00386,1406551787,140655178.7,1,98396,4145,476,2242,1766,476,98396,1766,2242,326.0802469,2.895061728,13.75308642,28298.09259,1940.851852,16.66666667,98508.96296,0.284748422,0.019488655,0.000168597,0.787689563,0.022785479,24,15
D:0| T0: 0.17| T1: 20.00| R0: 0.0| R1: 0.0| WTP: 0,0,0.173076923,20,0,0,0,0,0,-2068572054,1726322189,13306.75095,1403234506,140323450.6,1,96304,4112,524,2211,1687,524,96304,1687,2211,307.5030303,3.109090909,13.26060606,31480.65455,1982.472727,16.44848485,98571.98788,0.316751669,0.019905308,0.000166567,0.763003166,0.022958548,24,15
D:0| T0: 0.17| T1: 20.00| R0: 0.0| R1: 0.0| WTP: 0,0,0.173076923,20,0,0,0,0,0,-1886903744,307848836,11497.9627,1312005608,131200560.8,1,90240,3972,507,1910,1403,507,90240,1403,1910,304.1552795,3.062111801,11.72049689,39548.54658,1977.285714,14.86956522,98843.35404,0.397740099,0.019823457,0.000150608,0.734554974,0.02116578,23,14
D:0| T0: 0.17| T1: 20.00| R0: 0.0| R1: 0.0| WTP: 0,0,0.173076923,20,0,0,0,0,0,-1835977801,1154000220,12035.59302,1234198150,123419815,1,98939,4480,439,1999,1560,439,98939,1560,1999,356.8766234,2.753246753,12.83766234,25431.02597,1673.532468,15.72077922,98620.52597,0.256197708,0.016774105,0.000158844,0.780390195,0.020204368,22,13
D:0| T0: 0.17| T1: 20.00| R0: 0.0| R1: 0.0| WTP: 0,0,0.173076923,20,0,0,0,0,0,-1761243398,2028661055,150.3633374,1753725231,175372523.1,2,905,37,25,25,0,25,905,0,25,2,0.048780488,0.048780488,99380.10732,23.08292683,0.165853659,99985.20976,0.993956921,0.000232011,2.42747E-06,0,0.027624309,30,20
D:0| T0: 0.17| T1: 20.00| R0: 0.0| R1: 0.0| WTP: 0,0,0.173076923,20,0,0,0,0,0,-2428516351,1629114640,11769.18927,1840056888,184005688.8,2,91558,3998,1293,1955,662,1293,91558,662,1955,109.8755556,2.711111111,4.16,51874.73778,1258.064444,7.055555556,99047.14889,0.521012056,0.012673949,7.26907E-05,0.338618926,0.021352585,65,20
D:0| T0: 0.17| T1: 20.00| R0: 0.0| R1: 0.0| WTP: 0,0,0.173076923,20,0,0,0,0,0,-1964457217,1439048174,12952.84406,1316815014,131681501.4,1,97218,4091,501,2152,1651,501,97218,1651,2152,320.6583851,3.049689441,13.26708075,31550.6646,2571.826087,16.38509317,98626.93789,0.317283489,0.025819004,0.000165513,0.767193309,0.022135818,23,14
D:0| T0: 0.17| T1: 20.00| R0: 0.0| R1: 0.0| WTP: 0,0,0.173076923,20,0,0,0,0,0,-2518544111,865227006,13487.76317,1844155953,184415595.3,2,99171,4141,440,2241,1801,440,99171,1801,2241,253.4975845,2.062801932,10.73429952,18111.4058,1287.507246,12.87439614,98252.28502,0.182903911,0.012941058,0.000130328,0.803659081,0.022597332,30,20
D:0| T0: 0.17| T1: 20.00| R0: 0.0| R1: 0.0| WTP: 0,0,0.173076923,20,0,0,0,0,0,-2347507400,890479738,10259.98401,1834508199,183450819.9,2,81813,3649,1198,1704,506,1198,81813,506,1704,71.06707317,1.653963415,2.407012195,35533.13415,891.2926829,4.236280488,98696.53201,0.35921119,0.008976108,4.45692E-05,0.296948357,0.02082824,94,20
D:0| T0: 0.17| T1: 20.00| R0: 0.0| R1: 0.0| WTP: 0,0,0.173076923,20,0,0,0,0,0,-1260009283,1017049163,571.924303,1231413068,123141306.8,1,4882,218,95,95,0,95,4882,0,95,15.35220126,0.471698113,0.471698113,97010.84906,111.0251572,1.088050314,99947.66667,0.970643074,0.001106399,1.18804E-05,0,0.019459238,23,14
D:0| T0: 0.17| T1: 20.00| R0: 0.0| R1: 0.0| WTP: 0,0,0.173076923,20,0,0,0,0,0,-1316046176,1707305064,18.14171148,1315139090,131513909,1,304,12,3,3,0,3,304,0,3,1.43902439,0.006097561,0.006097561,99809.40854,9.384146341,0.018292683,99998.14634,0.998116373,9.53351E-05,3.63639E-07,0,0.009868421,24,15
D:0| T0: 0.17| T1: 20.00| R0: 0.0| R1: 0.0| WTP: 0,0,0.173076923,20,0,0,0,0,0,-2256163780,400145663,13458.37785,1583244887,158324488.7,1,99063,4296,416,2236,1820,416,99063,1820,2236,305.3125,2.301136364,12.61363636,21244.23864,1511.471591,14.97727273,98336.77273,0.214354435,0.015179205,0.000151496,0.813953488,0.022571495,26,17
D:0| T0: 0.17| T1: 20.00| R0: 0.0| R1: 0.0| WTP: 0,0,0.173076923,20,0,0,0,0,0,-1146840749,1662654181,120.5449117,1140813503,114081350.3,1,1480,66,20,20,0,20,1480,0,20,5.25974026,0.051948052,0.051948052,99114.72078,38.96753247,0.168831169,99989.98701,0.991256664,0.000389447,2.58088E-06,0,0.013513514,22,13
D:0| T0: 0.17| T1: 20.00| R0: 0.0| R1: 0.0| WTP: 0,0,0.173076923,20,0,0,0,0,0,-2028784179,182136456,12413.50839,1408108760,140810876,1,98235,4374,473,2062,1589,473,98235,1589,2062,333.2037037,2.87037037,12.62345679,28120.00617,2101.364198,15.5308642,98623.17284,0.282984097,0.021080113,0.000157104,0.770611057,0.020990482,24,15
D:0| T0: 0.17| T1: 20.00| R0: 0.0| R1: 0.0| WTP: 0,0,0.173076923,20,0,0,0,0,0,-1403902093,979575387,24.11458233,1402696364,140269636.4,1,290,12,4,4,0,4,290,0,4,1.046783626,0,0,99823.53216,11.45614035,0.023391813,99998.20468,0.99825693,0.000116223,4.65123E-07,0,0.013793103,25,16
D:0| T0: 0.17| T1: 20.00| R0: 0.0| R1: 0.0| WTP: 0,0,0.173076923,20,0,0,0,0,0,-2114530231,2142525414,10984.42846,1565308808,156530880.8,1,81403,3435,588,1825,1237,588,81403,1237,1825,240.7653631,3.201117318,10.05027933,45963.01676,1782.201117,13.33519553,98902.11732,0.462652857,0.017876666,0.000135287,0.677808219,0.022419321,26,17
D:0| T0: 0.17| T1: 20.00| R0: 0.0| R1: 0.0| WTP: 0,0,0.173076923,20,0,0,0,0,0,-2348150050,1464057597,10295.81212,1833359444,183335944.4,2,83337,3648,1548,1710,162,1548,83337,162,1710,100.4181416,3.252212389,3.581858407,49215.2677,688.5641593,7.024336283,99001.63717,0.495556775,0.00693134,7.25403E-05,0.094736842,0.020519097,65,20
D:0| T0: 0.17| T1: 20.00| R0: 0.0| R1: 0.0| WTP: 0,0,0.173076923,20,0,0,0,0,0,-2062133212,364562610,11580.68812,1483098806,148309880.6,1,87956,3757,530,1924,1394,530,87956,1394,1924,266.3275862,2.965517241,10.93678161,39138.09195,1709.189655,14,98782.65517,0.394011626,0.017143152,0.000141569,0.724532225,0.021874574,25,16
D:0| T0: 0.17| T1: 20.00| R0: 0.0| R1: 0.0| WTP: 0,0,0.173076923,20,0,0,0,0,0,-2257783547,40350784,10400.98761,1737734166,173773416.6,1,77125,3268,605,1728,1123,605,77125,1123,1728,212.625641,3.01025641,8.717948718,47288.47692,1529.682051,11.81538462,98915.11282,0.476332949,0.015341981,0.000120075,0.649884259,0.022405186,28,19
D:0| T0: 0.17| T1: 20.00| R0: 0.0| R1: 0.0| WTP: 0,0,0.173076923,20,0,0,0,0,0,-2074109977,804064356,9890.023559,1579608799,157960879.9,1,89264,4116,438,1642,1204,438,89264,1204,1642,292.2011173,2.379888268,9.072625698,36867.4581,1444.03352,11.50837989,98925.40223,0.370984933,0.014467612,0.000116487,0.733252132,0.018394874,26,17
D:0| T0: 0.17| T1: 20.00| R0: 0.0| R1: 0.0| WTP: 0,0,0.173076923,20,0,0,0,0,0,-1628227273,2125493986,5507.451387,1352854703,135285470.3,1,39738,1695,465,915,450,465,39738,450,915,129.0059524,2.654761905,5.303571429,74078.57738,742.8690476,8.041666667,99455.19643,0.744512211,0.007417016,8.20256E-05,0.491803279,0.023025819,24,15
D:0| T0: 0.17| T1: 20.00| R0: 0.0| R1: 0.0| WTP: 0,0,0.173076923,20,0,0,0,0,0,-2022145136,23154253,7499.412326,1647174520,164717452,1,69083,3146,519,1245,726,519,69083,726,1245,219.8315217,2.695652174,6.60326087,53171.11413,1000.472826,9.461956522,99223.38043,0.53493693,0.010008325,9.59413E-05,0.58313253,0.0180218,27,18
D:0| T0: 0.17| T1: 20.00| R0: 0.0| R1: 0.0| WTP: 0,0,0.173076923,20,0,0,0,0,0,-2319118216,1391367689,9884.475009,1824894465,182489446.5,2,74674,3223,946,1642,696,946,74674,696,1642,88.49028078,1.920086393,3.388768898,75481.57883,544.6155508,5.438444924,99498.75594,0.756284312,0.005479274,5.62247E-05,0.423873325,0.021988912,67,20
D:0| T0: 0.17| T1: 20.00| R0: 0.0| R1: 0.0| WTP: 0,0,0.173076923,20,0,0,0,0,0,-2417506201,574142276,11594.24925,1837793738,183779373.8,2,87610,3798,1094,1926,832,1094,87610,832,1926,123.6214834,2.654731458,4.744245524,66288.31714,1033.792839,7.537084399,99315.51662,0.664907038,0.010410134,7.77462E-05,0.431983385,0.021983792,56,20
D:0| T0: 0.17| T1: 20.00| R0: 0.0| R1: 0.0| WTP: 0,0,0.173076923,20,0,0,0,0,0,-701611202.7,898736779,6.039854375,701309210,70130921,1,92,4,1,1,0,1,92,0,1,0.578947368,0,0,99953.01754,5.789473684,0.00877193,99999.17544,0.999539648,5.9218E-05,1.73913E-07,0,0.010869565,17,8
D:0| T0: 0.17| T1: 20.00| R0: 0.0| R1: 0.0| WTP: 0,0,0.173076923,20,0,0,0,0,0,-2341100136,346473503,9873.896836,1847405294,184740529.4,2,90907,4299,1297,1639,342,1297,90907,342,1639,117.4686825,2.669546436,3.377969762,44964.59611,1120.468683,6.17062635,99059.9568,0.452346105,0.011271917,6.37954E-05,0.208663819,0.018029415,67,20
D:0| T0: 0.17| T1: 20.00| R0: 0.0| R1: 0.0| WTP: 0,0,0.173076923,20,0,0,0,0,0,-2395704118,445552282,11203.2711,1835540563,183554056.3,2,88553,3791,1403,1861,458,1403,88553,458,1861,95.01425662,2.725050916,3.627291242,49014.83096,1032.380855,6.486761711,98963.1446,0.493228402,0.010400906,6.69562E-05,0.246104245,0.021015663,70,20
D:0| T0: 0.17| T1: 20.00| R0: 0.0| R1: 0.0| WTP: 0,0,0.173076923,20,0,0,0,0,0,-1746013496,911758476,11946.23269,1148701861,114870186.1,1,99146,4479,437,1984,1547,437,99146,1547,1984,396.7676056,2.985915493,13.83098592,27636.58451,1954.535211,16.9084507,98686.9507,0.278200211,0.019581078,0.000170959,0.779737903,0.020010893,21,12
D:0| T0: 0.17| T1: 20.00| R0: 0.0| R1: 0.0| WTP: 0,0,0.173076923,20,0,0,0,0,0,-2141479453,1464197940,11111.20923,1585918992,158591899.2,1,93996,4382,552,1845,1293,552,93996,1293,1845,311.6256983,3.005586592,10.18994413,33594.05028,3063.877095,13.24581006,98820.50279,0.337879763,0.03073005,0.000134389,0.700813008,0.019628495,26,17
D:0| T0: 0.17| T1: 20.00| R0: 0.0| R1: 0.0| WTP: 0,0,0.173076923,20,0,0,0,0,0,-1687163374,500405854,1908.361708,1591745289,159174528.9,1,13849,600,307,317,10,307,13849,10,317,42.3315508,1.465240642,1.524064171,91001.3262,304.6149733,3.160427807,99814.31551,0.911740735,0.003036852,3.32424E-05,0.031545741,0.022894699,27,18
D:0| T0: 0.17| T1: 20.00| R0: 0.0| R1: 0.0| WTP: 0,0,0.173076923,20,0,0,0,0,0,-2004424760,772037341,12110.26047,1398911737,139891173.7,1,92766,3897,464,2012,1548,464,92766,1548,2012,293.5333333,2.739393939,12.06666667,35320.81818,1842.612121,14.87272727,98710.27879,0.355418127,0.018482671,0.000150624,0.769383698,0.021688981,24,15
D:0| T0: 0.17| T1: 20.00| R0: 0.0| R1: 0.0| WTP: 0,0,0.173076923,20,0,0,0,0,0,-967790505.6,1543158763,66.16145856,964482432.7,96448243.27,1,464,23,11,11,0,11,464,0,11,1.379562044,0.02189781,0.02189781,99731.39416,15.99270073,0.102189781,99993.85401,0.997379249,0.000161025,1.59428E-06,0,0.023706897,20,11
D:0| T0: 0.17| T1: 20.00| R0: 0.0| R1: 0.0| WTP: 0,0,0.173076923,20,0,0,0,0,0,-1832721565,1604932531,13782.2358,1143609775,114360977.5,1,98721,4189,442,2290,1848,442,98721,1848,2290,361.6438356,2.938356164,15.55479452,28998.41781,1995.582192,18.5890411,98497.54795,0.291808024,0.020024328,0.000187945,0.8069869,0.023196686,21,12
D:0| T0: 0.17| T1: 20.00| R0: 0.0| R1: 0.0| WTP: 0,0,0.173076923,20,0,0,0,0,0,-2343438696,539051477,10270.37881,1829919756,182991975.6,2,77417,3439,689,1706,1017,689,77417,1017,1706,201.8538813,3.0456621,7.634703196,45062.67123,2028.141553,10.77625571,98897.97717,0.454101643,0.020352278,0.000109822,0.596131301,0.022036504,32,20
D:0| T0: 0.17| T1: 20.00| R0: 0.0| R1: 0.0| WTP: 0,0,0.173076923,20,0,0,0,0,0,-1235046152,1743124675,144.3604116,1227828131,122782813.1,1,733,30,24,24,0,24,733,0,24,2.662420382,0.057324841,0.057324841,99529.2293,15.29299363,0.21656051,99986.01911,0.99543861,0.000153751,3.03832E-06,0,0.032742156,23,14
D:0| T0: 0.17| T1: 20.00| R0: 0.0| R1: 0.0| WTP: 0,0,0.173076923,20,0,0,0,0,0,-2415123416,1965983789,11587.52862,1835746985,183574698.5,2,88041,3811,1050,1925,875,1050,88041,875,1925,114.0847458,2.372881356,4.464891041,64458.49637,1242.300242,6.995157385,99277.09685,0.646018314,0.012512521,7.2532E-05,0.454545455,0.021864813,59,20
D:0| T0: 0.17| T1: 20.00| R0: 0.0| R1: 0.0| WTP: 0,0,0.173076923,20,0,0,0,0,0,-2373343424,516774280,10794.12045,1833637402,183363740.2,2,86201,3708,981,1793,812,981,86201,812,1793,90.66929134,1.820866142,3.391732283,68307.64961,1097.523622,5.32480315,99388.48819,0.684367682,0.011049337,5.49797E-05,0.452872281,0.020800223,72,20
D:0| T0: 0.17| T1: 20.00| R0: 0.0| R1: 0.0| WTP: 0,0,0.173076923,20,0,0,0,0,0,-2296715272,86603142,12497.83911,1671823317,167182331.7,1,98877,4264,422,2076,1654,422,98877,1654,2076,296.4565217,2.239130435,11.19565217,20627.42391,1394.456522,13.48913043,98429.9837,0.20817992,0.013998365,0.000136404,0.79672447,0.020995783,27,18
D:0| T0: 0.17| T1: 20.00| R0: 0.0| R1: 0.0| WTP: 0,0,0.173076923,20,0,0,0,0,0,-965989593.7,1431870609,30.13122792,964483032.3,96448303.23,1,447,16,5,5,0,5,447,0,5,1.467153285,0,0,99737.33577,22.10948905,0.03649635,99997.13139,0.997406558,0.000221746,7.24652E-07,0,0.011185682,20,11
D:0| T0: 0.17| T1: 20.00| R0: 0.0| R1: 0.0| WTP: 0,0,0.173076923,20,0,0,0,0,0,-2325948479,1592383984,9910.462614,1830425348,183042534.8,2,79922,3434,1358,1646,288,1358,79922,288,1646,92.25,2.710084034,3.285714286,54209.48739,489.1197479,6.142857143,99086.20378,0.545883239,0.004923058,6.35077E-05,0.174969623,0.02059508,68,20
D:0| T0: 0.17| T1: 20.00| R0: 0.0| R1: 0.0| WTP: 0,0,0.173076923,20,0,0,0,0,0,-2375143015,1440183867,10706.10224,1839837903,183983790.3,2,86445,3977,1086,1778,692,1086,86445,692,1778,119.6274038,2.487980769,4.112980769,64235.96635,1001.175481,6.692307692,99326.87981,0.644222803,0.010075865,6.92694E-05,0.38920135,0.020567991,60,20
D:0| T0: 0.17| T1: 20.00| R0: 0.0| R1: 0.0| WTP: 0,0,0.173076923,20,0,0,0,0,0,-2434401817,1696510588,11942.25535,1837289050,183728905,2,91050,3864,770,1984,1214,770,91050,1214,1984,116.5942029,1.758454106,4.652173913,67913.75604,1037.202899,6.516908213,99362.71014,0.67985956,0.01044621,6.70102E-05,0.611895161,0.021790225,60,20
D:0| T0: 0.17| T1: 20.00| R0: 0.0| R1: 0.0| WTP: 0,0,0.173076923,20,0,0,0,0,0,-2298715397,895039877,11046.3651,1746397142,174639714.2,1,84956,3665,584,1835,1251,584,84956,1251,1835,240.5206186,2.93814433,9.319587629,39528.04124,2295.494845,12.31443299,98817.30412,0.398154226,0.02302829,0.000125193,0.681743869,0.021599416,28,19
D:0| T0: 0.17| T1: 20.00| R0: 0.0| R1: 0.0| WTP: 0,0,0.173076923,20,0,0,0,0,0,-2450289459,129565953,12313.87987,1834595465,183459546.5,2,89150,3725,1228,2046,818,1228,89150,818,2046,106.6018519,2.671296296,4.532407407,63801.62269,1459.976852,7.386574074,99229.68519,0.639988432,0.014713993,7.63568E-05,0.399804497,0.022950599,61,20
D:0| T0: 0.17| T1: 20.00| R0: 0.0| R1: 0.0| WTP: 0,0,0.173076923,20,0,0,0,0,0,-1777538034,1902565669,415.5966057,1756758204,175675820.4,2,4219,196,69,69,0,69,4219,0,69,10.41545894,0.256038647,0.256038647,97168.86473,75.99033816,0.574879227,99955.94203,0.972147651,0.000759016,6.63677E-06,0,0.016362343,30,20
D:0| T0: 0.17| T1: 20.00| R0: 0.0| R1: 0.0| WTP: 0,0,0.173076923,20,0,0,0,0,0,-1413891858,1984179288,198.6784526,1403957935,140395793.5,1,1788,69,33,33,0,33,1788,0,33,5.296511628,0.087209302,0.087209302,98850.1686,78.55813953,0.284883721,99982.40116,0.988690847,0.000783459,3.81563E-06,0,0.018456376,25,16
D:0| T0: 0.17| T1: 20.00| R0: 0.0| R1: 0.0| WTP: 0,0,0.173076923,20,0,0,0,0,0,-2404982612,677377223,11371.84915,1836390154,183639015.4,2,86354,3695,1744,1889,145,1744,86354,145,1889,93.83166333,3.318637275,3.593186373,44670,1407.266533,7.106212425,98853.38677,0.450005402,0.014177817,7.33576E-05,0.076760191,0.021875072,71,20
D:0| T0: 0.17| T1: 20.00| R0: 0.0| R1: 0.0| WTP: 0,0,0.173076923,20,0,0,0,0,0,-2412187748,973583301,11415.33185,1841421156,184142115.6,2,92245,4030,1302,1896,594,1302,92245,594,1896,123.7100737,3.041769042,4.466830467,54313.90909,1841.427518,7.658476658,99130.34152,0.544935989,0.018541666,7.90909E-05,0.313291139,0.02055396,59,20
D:0| T0: 0.17| T1: 20.00| R0: 0.0| R1: 0.0| WTP: 0,0,0.173076923,20,0,0,0,0,0,-2328076976,781062938,9710.076694,1842573141,184257314.1,2,88250,4126,1063,1612,549,1063,88250,549,1612,116.2157303,2.249438202,3.456179775,64493.22921,912.047191,5.851685393,99399.15056,0.646707611,0.009172579,6.04439E-05,0.34057072,0.018266289,64,20
D:0| T0: 0.17| T1: 20.00| R0: 0.0| R1: 0.0| WTP: 0,0,0.173076923,20,0,0,0,0,0,-2400689823,338783425,11104.21903,1845478872,184547887.2,2,94307,4300,985,1844,859,985,94307,859,1844,118.3711111,2.044444444,3.924444444,56600.18222,1703.96,6.102222222,99215.15778,0.56690777,0.017156392,6.32945E-05,0.465835141,0.019553161,65,20
D:0| T0: 0.17| T1: 20.00| R0: 0.0| R1: 0.0| WTP: 0,0,0.173076923,20,0,0,0,0,0,-1496594806,1027579040,114.3679034,1490876411,149087641.1,1,917,39,19,19,0,19,917,0,19,2.531914894,0.053191489,0.053191489,99416.66489,37.12234043,0.154255319,99988.96809,0.994283973,0.000371146,2.01075E-06,0,0.020765027,26,17
D:0| T0: 0.17| T1: 20.00| R0: 0.0| R1: 0.0| WTP: 0,0,0.173076923,20,0,0,0,0,0,-2428460100,764973813,11727.76407,1842071896,184207189.6,2,91781,4063,1168,1948,780,1168,91781,780,1948,122.5060241,2.657831325,4.503614458,61601.92289,1505.636145,7.313253012,99242.32048,0.617842641,0.015167456,7.56013E-05,0.400410678,0.021224436,59,20
D:0| T0: 0.17| T1: 20.00| R0: 0.0| R1: 0.0| WTP: 0,0,0.173076923,20,0,0,0,0,0,-2442609140,1245753446,12016.03634,1841807323,184180732.3,2,93277,4083,1396,1996,600,1396,93277,600,1996,121.4903382,3.246376812,4.65942029,50007.86473,1537.538647,8.002415459,98992.95894,0.502981984,0.015491668,8.25467E-05,0.300601202,0.02139863,60,20
D:0| T0: 0.17| T1: 20.00| R0: 0.0| R1: 0.0| WTP: 0,0,0.173076923,20,0,0,0,0,0,-2396554675,1013177794,11303.93777,1831357787,183135778.7,2,84440,3601,1238,1878,640,1238,84440,640,1878,97.46475771,2.588105727,3.964757709,60698.36784,779.0704846,6.707048458,99167.28634,0.610087296,0.007847372,6.91079E-05,0.340788072,0.022240908,65,20
D:0| T0: 0.17| T1: 20.00| R0: 0.0| R1: 0.0| WTP: 0,0,0.173076923,20,0,0,0,0,0,-1668898538,1395089249,54.31437069,1666182819,166618281.9,1,867,37,9,9,0,9,867,0,9,2.642105263,0.010526316,0.010526316,99400.07895,24.06315789,0.052631579,99994.11053,0.994069425,0.000241844,9.42445E-07,0,0.010380623,28,19
D:0| T0: 0.17| T1: 20.00| R0: 0.0| R1: 0.0| WTP: 0,0,0.173076923,20,0,0,0,0,0,-438852878.3,1339545835,12.01008238,438252374.2,43825237.42,1,66,0,2,2,0,2,66,0,2,0,0,0,99962.31579,4.557894737,0.021052632,99998.72632,0.99963791,4.76049E-05,4.16669E-07,0,0.03030303,14,5
D:0| T0: 0.17| T1: 20.00| R0: 0.0| R1: 0.0| WTP: 0,0,0.173076923,20,0,0,0,0,0,-1803808453,219139554,11410.78146,1233269380,123326938,1,95408,4273,467,1895,1428,467,95408,1428,1895,366.147651,3.060402685,12.57718121,32898,1681.52349,15.7114094,98779.59732,0.331041421,0.016848896,0.000158928,0.753562005,0.019862066,22,13
D:0| T0: 0.17| T1: 20.00| R0: 0.0| R1: 0.0| WTP: 0,0,0.173076923,20,0,0,0,0,0,-1428864147,1336508942,451.6680232,1406280746,140628074.6,1,3698,167,75,75,0,75,3698,0,75,13.33727811,0.284023669,0.284023669,97760.78107,87.67455621,0.75739645,99962.23077,0.977996639,0.00087437,8.82671E-06,0,0.020281233,25,16
D:0| T0: 0.17| T1: 20.00| R0: 0.0| R1: 0.0| WTP: 0,0,0.173076923,20,0,0,0,0,0,-703999557.1,448559423,54.07595311,701295759.4,70129575.94,1,162,4,9,9,0,9,162,0,9,0.434782609,0.017391304,0.017391304,99910.31304,10.29565217,0.095652174,99997.29565,0.999132373,0.000104226,1.55178E-06,0,0.055555556,17,8
D:0| T0: 0.17| T1: 20.00| R0: 0.0| R1: 0.0| WTP: 0,0,0.173076923,20,0,0,0,0,0,-2432310423,2110028840,11823.44805,1841138021,184113802.1,2,90791,4100,941,1964,1023,941,90791,1023,1964,115.1986301,2.025114155,4.337899543,64950.33562,1014.810502,6.49086758,99302.69178,0.650776778,0.010221813,6.68047E-05,0.520875764,0.0216321,63,20
D:0| T0: 0.17| T1: 20.00| R0: 0.0| R1: 0.0| WTP: 0,0,0.173076923,20,0,0,0,0,0,-2498438009,1982030155,13239.26593,1836474712,183647471.2,2,91216,3778,1067,2200,1133,1067,91216,1133,2200,117.057072,2.493796526,5.270471464,64325.75434,1496.210918,7.920595533,99211.2531,0.644617061,0.015085319,8.17306E-05,0.515,0.024118576,58,20
D:0| T0: 0.17| T1: 20.00| R0: 0.0| R1: 0.0| WTP: 0,0,0.173076923,20,0,0,0,0,0,-2414094437,696219407,11605.02574,1833843150,183384315,2,84352,3643,1247,1928,681,1247,84352,681,1928,121.643617,3.125,4.914893617,63031.54255,741.7340426,8.257978723,99195.19415,0.633105676,0.007471329,8.49877E-05,0.353215768,0.022856601,54,20
D:0| T0: 0.17| T1: 20.00| R0: 0.0| R1: 0.0| WTP: 0,0,0.173076923,20,0,0,0,0,0,-1990826146,1402539442,10104.21028,1485615632,148561563.2,1,84628,3787,549,1678,1129,549,84628,1129,1678,283.7705882,3.147058824,9.741176471,44141.80588,2280.270588,12.94117647,99002.20588,0.443936197,0.022846769,0.000131338,0.672824791,0.019827953,25,16
D:0| T0: 0.17| T1: 20.00| R0: 0.0| R1: 0.0| WTP: 0,0,0.173076923,20,0,0,0,0,0,-2170138711,1319833493,10276.86929,1656295247,165629524.7,1,82058,3679,610,1707,1097,610,82058,1097,1707,240.6914894,3.159574468,8.95212766,43550.01596,2947.164894,12.18085106,98943.32447,0.438413347,0.029552063,0.000123649,0.64264792,0.020802359,27,18
D:0| T0: 0.17| T1: 20.00| R0: 0.0| R1: 0.0| WTP: 0,0,0.173076923,20,0,0,0,0,0,-1797401963,663608076,788.3451044,1757984708,175798470.8,2,5676,235,131,131,0,131,5676,0,131,13.57560976,0.502439024,0.502439024,96326.76585,165.702439,1.107317073,99923.73171,0.964032521,0.00165234,1.27265E-05,0,0.023079634,30,20
D:0| T0: 0.17| T1: 20.00| R0: 0.0| R1: 0.0| WTP: 0,0,0.173076923,20,0,0,0,0,0,-2355621148,414696500,10469.39249,1832151523,183215152.3,2,81371,3544,1011,1739,728,1011,81371,728,1739,82.02177858,1.760435572,3.047186933,69727.77677,1019.46461,4.871143376,99394.17604,0.69851385,0.010264764,5.02518E-05,0.418631397,0.02137125,78,20
D:0| T0: 0.17| T1: 20.00| R0: 0.0| R1: 0.0| WTP: 0,0,0.173076923,20,0,0,0,0,0,-1235681494,1249738535,150.4741011,1228157789,122815778.9,1,990,45,25,25,0,25,990,0,25,3.826086957,0.068322981,0.068322981,99391.55901,24.61490683,0.211180124,99987.7205,0.994045566,0.000246872,3.08678E-06,0,0.025252525,23,14
D:0| T0: 0.17| T1: 20.00| R0: 0.0| R1: 0.0| WTP: 0,0,0.173076923,20,0,0,0,0,0,-2343210970,614415382,10282.21098,1829100421,182910042.1,2,80435,3464,995,1708,713,995,80435,713,1708,89.98340249,1.96473029,3.404564315,72160.93154,1057.317427,5.470954357,99458.22407,0.722770394,0.010640269,5.64384E-05,0.417691857,0.021222105,69,20
D:0| T0: 0.17| T1: 20.00| R0: 0.0| R1: 0.0| WTP: 0,0,0.173076923,20,0,0,0,0,0,-1667325705,524899953,30.17289825,1665817060,166581706,1,480,28,5,5,0,5,480,0,5,1.458333333,0,0,99673.375,14.23958333,0.026041667,99996.66146,0.996772967,0.00014389,5.18145E-07,0,0.010438413,28,19
D:0| T0: 0.17| T1: 20.00| R0: 0.0| R1: 0.0| WTP: 0,0,0.173076923,20,0,0,0,0,0,-1868528488,1338977757,12660.58602,1235499187,123549918.7,1,98967,4419,403,2103,1700,403,98967,1700,2103,361.6623377,2.545454545,13.53896104,26152.23377,1689.824675,16.16233766,98549.27273,0.263361216,0.016945494,0.000163349,0.808368997,0.021249507,22,13
D:0| T0: 0.17| T1: 20.00| R0: 0.0| R1: 0.0| WTP: 0,0,0.173076923,20,0,0,0,0,0,-2171611986,341384587,10377.79317,1652722327,165272232.7,1,78975,3373,518,1724,1206,518,78975,1206,1724,230.9679144,2.695187166,9.096256684,43613.90909,1431.032086,11.86631016,98861.60428,0.439601863,0.01434678,0.000120265,0.699535963,0.021829693,27,18
D:0| T0: 0.17| T1: 20.00| R0: 0.0| R1: 0.0| WTP: 0,0,0.173076923,20,0,0,0,0,0,-2458315463,2032000160,12387.36397,1838947265,183894726.5,2,90099,3897,1217,2058,841,1217,90099,841,2058,119.9975369,2.834975369,4.869458128,60356.90394,1502.103448,7.881773399,99161.06158,0.605481043,0.015139667,8.12641E-05,0.408649174,0.022841541,58,20
D:0| T0: 0.17| T1: 20.00| R0: 0.0| R1: 0.0| WTP: 0,0,0.173076923,20,0,0,0,0,0,-2311998142,779488939,9722.511255,1825872580,182587258,1,76020,3316,566,1615,1049,566,76020,1049,1615,207.7821782,2.683168317,7.811881188,47341.05446,1430.034653,10.63861386,98974.18812,0.47678371,0.014336003,0.000108321,0.649535604,0.021244409,29,20
D:0| T0: 0.17| T1: 20.00| R0: 0.0| R1: 0.0| WTP: 0,0,0.173076923,20,0,0,0,0,0,-2421481847,1449019578,11760.90847,1833436424,183343642.4,2,86269,3716,983,1954,971,983,86269,971,1954,96.05462185,1.928571429,3.943277311,65686.59454,1131.432773,6.029411765,99270.28782,0.658286303,0.011400514,6.21625E-05,0.496929376,0.022650083,67,20
D:0| T0: 0.17| T1: 20.00| R0: 0.0| R1: 0.0| WTP: 0,0,0.173076923,20,0,0,0,0,0,-1231066491,351952211,66.26538164,1227753222,122775322.2,1,521,28,11,11,0,11,521,0,11,2.541935484,0.006451613,0.006451613,99682.72903,14.9483871,0.096774194,99994.78065,0.996884685,0.000151096,1.41033E-06,0,0.021113244,23,14
D:0| T0: 0.17| T1: 20.00| R0: 0.0| R1: 0.0| WTP: 0,0,0.173076923,20,0,0,0,0,0,-1493321373,486595046,60.13217012,1490314765,149031476.5,1,385,16,10,10,0,10,385,0,10,0.798969072,0,0,99792.07732,15.70103093,0.051546392,99995.45876,0.997968414,0.000158418,1.02569E-06,0,0.026041667,26,17
D:0| T0: 0.17| T1: 20.00| R0: 0.0| R1: 0.0| WTP: 0,0,0.173076923,20,0,0,0,0,0,-2037782249,296745624,4954.595422,1790052477,179005247.7,1,39226,1736,481,823,342,481,39226,342,823,107.213198,2.294416244,4.005076142,73475.38579,975.6294416,6.446700508,99485.8731,0.738318974,0.00974749,6.6131E-05,0.415552855,0.020980982,29,20
D:0| T0: 0.17| T1: 20.00| R0: 0.0| R1: 0.0| WTP: 0,0,0.173076923,20,0,0,0,0,0,-1689278952,1671484194,409.4919052,1668804357,166880435.7,1,3384,161,68,68,0,68,3384,0,68,10.31606218,0.243523316,0.243523316,97859.04145,89.84974093,0.606217617,99960.7772,0.978995441,0.000896637,7.0126E-06,0,0.020106446,28,19
D:0| T0: 0.17| T1: 20.00| R0: 0.0| R1: 0.0| WTP: 0,0,0.173076923,20,0,0,0,0,0,-2177830809,422157396,11879.18551,1583871533,158387153.3,1,98334,4369,476,1973,1497,476,98334,1497,1973,303.9050279,2.592178771,10.92178771,26113.46927,2049.960894,13.58100559,98631.15642,0.262861855,0.020571472,0.000137384,0.758743031,0.020064271,26,17
D:0| T0: 0.17| T1: 20.00| R0: 0.0| R1: 0.0| WTP: 0,0,0.173076923,20,0,0,0,0,0,-1963423376,1916599091,12816.58979,1322593886,132259388.6,1,98431,4258,447,2129,1682,447,98431,1682,2129,350.1329114,2.753164557,13.34810127,27640.51899,2168.949367,16.1835443,98569.12025,0.278220405,0.021755487,0.000163717,0.790042273,0.021629365,23,14
D:0| T0: 0.17| T1: 20.00| R0: 0.0| R1: 0.0| WTP: 0,0,0.173076923,20,0,0,0,0,0,-1846254200,1005953941,12216.23243,1235442578,123544257.8,1,98342,4312,495,2029,1534,495,98342,1534,2029,368.8013245,3.225165563,13.32450331,30384.56954,2637.046358,16.58940397,98711.46358,0.305556772,0.026435801,0.000167715,0.756037457,0.02063208,22,13
D:0| T0: 0.17| T1: 20.00| R0: 0.0| R1: 0.0| WTP: 0,0,0.173076923,20,0,0,0,0,0,-1922051942,1422765615,12241.99292,1309952296,130995229.6,1,88872,3789,548,2034,1486,548,88872,1486,2034,297.05,3.31875,12.5375,40028.55,1926.55,16.00625,98767.19375,0.402835345,0.019329845,0.000161992,0.730580138,0.022886849,23,14
D:0| T0: 0.17| T1: 20.00| R0: 0.0| R1: 0.0| WTP: 0,0,0.173076923,20,0,0,0,0,0,-1141173493,699740192,30.09482132,1139668752,113966875.2,1,339,16,5,5,0,5,339,0,5,0.805194805,0.012987013,0.012987013,99795.20779,13.00649351,0.045454545,99997.74026,0.997978703,0.000131615,6.45172E-07,0,0.014749263,22,13
D:0| T0: 0.17| T1: 20.00| R0: 0.0| R1: 0.0| WTP: 0,0,0.173076923,20,0,0,0,0,0,-877077009.2,240885764,6.0931291,876772352.8,87677235.28,1,99,9,1,1,0,1,99,0,1,1.3046875,0,0,99939.54688,3.9609375,0.0078125,99999.63281,0.999401857,4.1628E-05,1.55039E-07,0,0.01010101,19,10
D:0| T0: 0.17| T1: 20.00| R0: 0.0| R1: 0.0| WTP: 0,0,0.173076923,20,0,0,0,0,0,-1751226524,2023806564,7473.239389,1377564554,137756455.4,1,64820,2923,579,1241,662,579,64820,662,1241,217.0898204,3.335329341,7.251497006,57969.91018,1628.628743,10.71856287,99283.88024,0.582960091,0.016284955,0.000109006,0.533440774,0.019145326,24,15
D:0| T0: 0.17| T1: 20.00| R0: 0.0| R1: 0.0| WTP: 0,0,0.173076923,20,0,0,0,0,0,-1409573787,1907493879,132.2933622,1402959119,140295911.9,1,938,34,22,22,0,22,938,0,22,1.761363636,0.051136364,0.051136364,99451.4375,32.5625,0.176136364,99987.76705,0.994641665,0.000326367,2.48613E-06,0,0.023454158,25,16
D:0| T0: 0.17| T1: 20.00| R0: 0.0| R1: 0.0| WTP: 0,0,0.173076923,20,0,0,0,0,0,-2442290605,1565815291,12110.3996,1836770625,183677062.5,2,90795,3812,1202,2012,810,1202,90795,810,2012,118.3591022,2.825436409,4.810473815,59922.2818,1815.411471,7.80798005,99182.58354,0.600914577,0.01829038,8.07255E-05,0.402584493,0.022159811,58,20
D:0| T0: 0.17| T1: 20.00| R0: 0.0| R1: 0.0| WTP: 0,0,0.173076923,20,0,0,0,0,0,-1772682733,784442364,343.1211169,1755526677,175552667.7,1,2611,121,57,57,0,57,2611,0,57,7.09223301,0.145631068,0.145631068,98276.67476,65.99029126,0.412621359,99967.82039,0.983102311,0.000659235,5.50875E-06,0,0.021830716,29,20
D:0| T0: 0.17| T1: 20.00| R0: 0.0| R1: 0.0| WTP: 0,0,0.173076923,20,0,0,0,0,0,-2026022510,206369745,9224.662745,1564789373,156478937.3,1,76953,3443,550,1532,982,550,76953,982,1532,238.8176796,2.928176796,8.303867403,48480.9116,1774.883978,11.3480663,99067.62431,0.487857087,0.017778876,0.00011528,0.640992167,0.019908256,26,17
D:0| T0: 0.17| T1: 20.00| R0: 0.0| R1: 0.0| WTP: 0,0,0.173076923,20,0,0,0,0,0,-2169931348,2087235992,11811.70151,1579346272,157934627.2,1,94449,4081,555,1962,1407,555,94449,1407,1962,284.9779006,2.983425414,10.68508287,32573.52486,2271.955801,13.75138122,98736.20994,0.327710743,0.022793562,0.00013965,0.717125382,0.020773116,26,17
D:0| T0: 0.17| T1: 20.00| R0: 0.0| R1: 0.0| WTP: 0,0,0.173076923,20,0,0,0,0,0,-2405171234,1019092536,11330.22099,1838660185,183866018.5,2,89908,3921,951,1882,931,951,89908,931,1882,114.0976744,2.086046512,4.223255814,68771.46744,1160.965116,6.425581395,99415.85814,0.688731265,0.011688904,6.6338E-05,0.494686504,0.020932742,62,20
D:0| T0: 0.17| T1: 20.00| R0: 0.0| R1: 0.0| WTP: 0,0,0.173076923,20,0,0,0,0,0,-2322271589,1885906113,9956.500342,1824446572,182444657.2,2,77554,3310,1264,1654,390,1264,77554,390,1654,96.10501193,2.863961814,3.76372315,63836.32936,567.1026253,6.77326969,99270.39379,0.641489634,0.005705839,7.00384E-05,0.235792019,0.02132735,60,20
D:0| T0: 0.17| T1: 20.00| R0: 0.0| R1: 0.0| WTP: 0,0,0.173076923,20,0,0,0,0,0,-1475893206,2028637200,1264.513638,1412667524,141266752.4,1,11082,498,207,210,3,207,11082,3,210,33.42528736,1.051724138,1.063218391,92742.43678,248.8793103,2.229885057,99875.66667,0.928634903,0.002479365,2.38523E-05,0.014285714,0.018951358,25,16
D:0| T0: 0.17| T1: 20.00| R0: 0.0| R1: 0.0| WTP: 0,0,0.173076923,20,0,0,0,0,0,-2193661260,181476086,10709.8204,1658170240,165817024,1,86739,3824,537,1779,1242,537,86739,1242,1779,249.2956989,2.806451613,9.424731183,39414.52688,2185.919355,12.32258065,98865.46237,0.396737754,0.021924178,0.000124957,0.698145025,0.020509805,27,18
D:0| T0: 0.17| T1: 20.00| R0: 0.0| R1: 0.0| WTP: 0,0,0.173076923,20,0,0,0,0,0,-2203342319,2097578470,10842.9697,1661193834,166119383.4,1,85558,3814,584,1801,1217,584,85558,1217,1801,259.1290323,3.059139785,9.548387097,40090.06452,2490.709677,12.67204301,98856.64516,0.403672229,0.024981195,0.000128687,0.675735702,0.021050048,27,18
D:0| T0: 0.17| T1: 20.00| R0: 0.0| R1: 0.0| WTP: 0,0,0.173076923,20,0,0,0,0,0,-2432608151,119646392,11906.35109,1837290597,183729059.7,2,86919,3696,1036,1978,942,1036,86919,942,1978,108.0179775,2.186516854,4.274157303,62069.00225,1229.588764,6.597752809,99190.87416,0.622279906,0.012389832,6.82376E-05,0.476238625,0.02275682,64,20
D:0| T0: 0.17| T1: 20.00| R0: 0.0| R1: 0.0| WTP: 0,0,0.173076923,20,0,0,0,0,0,-1822268896,1298895859,11824.44223,1231046784,123104678.4,1,95331,4196,512,1964,1452,512,95331,1452,1964,353.56,3.333333333,12.93333333,35246.99333,2644.933333,16.35333333,98804.68,0.354356787,0.026513078,0.000165562,0.739307536,0.020601903,22,13
D:0| T0: 0.17| T1: 20.00| R0: 0.0| R1: 0.0| WTP: 0,0,0.173076923,20,0,0,0,0,0,-2362587386,1489316290,10625.0589,1831334441,183133444.1,2,82534,3668,529,1765,1236,529,82534,1236,1765,211.7887324,2.403755869,8.154929577,38400.00469,1348.258216,10.63849765,98764.79343,0.387276667,0.013528474,0.000108127,0.700283286,0.021385126,31,20
D:0| T0: 0.17| T1: 20.00| R0: 0.0| R1: 0.0| WTP: 0,0,0.173076923,20,0,0,0,0,0,-2542263045,855602142,14009.49354,1841788368,184178836.8,2,96194,3955,472,2328,1856,472,96194,1856,2328,236.6604651,2.153488372,10.74883721,26336.70233,1594.795349,12.94418605,98322.34419,0.265324005,0.016043383,0.000131127,0.797250859,0.024201094,31,20
D:0| T0: 0.17| T1: 20.00| R0: 0.0| R1: 0.0| WTP: 0,0,0.173076923,20,0,0,0,0,0,-2423559447,1438649896,11708.52217,1838133339,183813333.9,2,89520,3941,1301,1945,644,1301,89520,644,1945,98.81352459,2.549180328,3.842213115,54488.13525,937.1290984,6.5,99059.97951,0.547602694,0.009444433,6.70066E-05,0.331105398,0.021726988,69,20
D:0| T0: 0.17| T1: 20.00| R0: 0.0| R1: 0.0| WTP: 0,0,0.173076923,20,0,0,0,0,0,-1667490841,952489126,36.13731856,1665683975,166568397.5,1,393,13,6,6,0,6,393,0,6,1.036458333,0.005208333,0.005208333,99749.71354,16.3125,0.03125,99997.29688,0.997528192,0.000164252,6.21777E-07,0,0.015267176,28,19
D:0| T0: 0.17| T1: 20.00| R0: 0.0| R1: 0.0| WTP: 0,0,0.173076923,20,0,0,0,0,0,-1687488373,1550779155,12652.83926,1054846410,105484641,1,99140,4210,405,2102,1697,405,99140,1697,2102,388.0444444,2.925925926,15.45185185,25772.78519,2053.718519,18.45185185,98562.6,0.259796048,0.020577355,0.00018625,0.807326356,0.02120234,20,11
D:0| T0: 0.17| T1: 20.00| R0: 0.0| R1: 0.0| WTP: 0,0,0.173076923,20,0,0,0,0,0,-1584538183,607323321,120.3671534,1578519826,157851982.6,1,958,46,20,20,0,20,958,0,20,2.515957447,0.042553191,0.042553191,99350.77128,24.48404255,0.138297872,99988.26596,0.993634788,0.000245896,2.1166E-06,0,0.019832985,27,18
D:0| T0: 0.17| T1: 20.00| R0: 0.0| R1: 0.0| WTP: 0,0,0.173076923,20,0,0,0,0,0,-1763967924,2103646485,6320.595797,1447938134,144793813.4,1,48476,2088,518,1050,532,518,48476,532,1050,152.8176471,2.923529412,6.017647059,68788.1,861.6882353,9.047058824,99382.15294,0.691607142,0.008609496,9.21735E-05,0.506666667,0.021660203,25,16
D:0| T0: 0.17| T1: 20.00| R0: 0.0| R1: 0.0| WTP: 0,0,0.173076923,20,0,0,0,0,0,-1967351175,258120157,11146.97866,1410002242,141000224.2,1,97711,4438,441,1851,1410,441,97711,1410,1851,336.3151515,2.6,11.09090909,25085.55152,1505.909091,13.77575758,98682.07273,0.25287235,0.015096437,0.000139335,0.761750405,0.018943619,24,15
D:0| T0: 0.17| T1: 20.00| R0: 0.0| R1: 0.0| WTP: 0,0,0.173076923,20,0,0,0,0,0,-1793899523,1068951401,674.9467064,1760152188,176015218.8,2,6848,326,112,112,0,112,6848,0,112,19.8708134,0.435406699,0.435406699,95174.23445,127.6172249,0.976076555,99927.33971,0.952488261,0.001272629,1.06723E-05,0,0.01635514,30,20
D:0| T0: 0.17| T1: 20.00| R0: 0.0| R1: 0.0| WTP: 0,0,0.173076923,20,0,0,0,0,0,-2400546032,635956235,11322.84962,1834403551,183440355.1,2,86124,3783,1018,1881,863,1018,86124,863,1881,100.0993521,2.082073434,3.913606911,69319.99352,1407.084233,6.110151188,99390.44276,0.694201314,0.014169513,6.30655E-05,0.458798511,0.021840602,66,20
D:0| T0: 0.17| T1: 20.00| R0: 0.0| R1: 0.0| WTP: 0,0,0.173076923,20,0,0,0,0,0,-1056481164,1346693470,78.31500247,1052565414,105256541.4,1,830,35,13,13,0,13,830,0,13,3.167832168,0.034965035,0.034965035,99510.42657,29.68531469,0.104895105,99993.27972,0.995177696,0.00029731,1.80566E-06,0,0.015662651,21,12
D:0| T0: 0.17| T1: 20.00| R0: 0.0| R1: 0.0| WTP: 0,0,0.173076923,20,0,0,0,0,0,-2053644038,847102011,12959.21789,1405683144,140568314.4,1,98233,4205,472,2153,1681,472,98233,1681,2153,319.4573171,2.817073171,13,28185.04878,2044.310976,15.8597561,98563.80488,0.283633893,0.020520756,0.000160784,0.780771017,0.021917278,24,15
D:0| T0: 0.17| T1: 20.00| R0: 0.0| R1: 0.0| WTP: 0,0,0.173076923,20,0,0,0,0,0,-2471392027,812083272,12716.76529,1835553762,183555376.2,2,89279,3655,1682,2113,431,1682,89279,431,2113,112.3,3.926829268,4.943902439,51417.2439,1333.834146,9.063414634,98922.57805,0.517043284,0.013447821,9.32828E-05,0.20397539,0.02366738,59,20
D:0| T0: 0.17| T1: 20.00| R0: 0.0| R1: 0.0| WTP: 0,0,0.173076923,20,0,0,0,0,0,-2173799732,2146825809,11771.51154,1585224155,158522415.5,1,98874,4500,465,1955,1490,465,98874,1490,1955,310.3202247,2.556179775,10.8988764,22618.65169,1755.179775,13.51123596,98579.26404,0.228024452,0.017605376,0.000136496,0.762148338,0.01977264,26,17
D:0| T0: 0.17| T1: 20.00| R0: 0.0| R1: 0.0| WTP: 0,0,0.173076923,20,0,0,0,0,0,-2049126291,226186520,12851.40519,1406556032,140655603.2,1,97214,4231,468,2135,1667,468,97214,1667,2135,315.2619048,2.726190476,12.57738095,29346.85714,1687.755952,15.35714286,98566.32143,0.29534006,0.016944885,0.00015565,0.780796253,0.021961857,24,15
D:0| T0: 0.17| T1: 20.00| R0: 0.0| R1: 0.0| WTP: 0,0,0.173076923,20,0,0,0,0,0,-2451304817,1110225441,12196.09158,1841500238,184150023.8,2,92495,4030,1378,2026,648,1378,92495,648,2026,121.6480583,3.196601942,4.742718447,53658.43447,1725.400485,8.072815534,99058.10194,0.538390915,0.017389771,8.32198E-05,0.319842053,0.021903887,59,20
D:0| T0: 0.17| T1: 20.00| R0: 0.0| R1: 0.0| WTP: 0,0,0.173076923,20,0,0,0,0,0,-2354514935,1190767082,10226.78817,1843175527,184317552.7,2,92116,4136,1180,1698,518,1180,92116,518,1698,131.2101266,2.837974684,4.116455696,57268.84051,1244.458228,7.111392405,99273.78734,0.574737515,0.012516545,7.32667E-05,0.305064782,0.01843328,57,20
D:0| T0: 0.17| T1: 20.00| R0: 0.0| R1: 0.0| WTP: 0,0,0.173076923,20,0,0,0,0,0,-2371434152,2108234095,10828.98231,1829985036,182998503.6,2,81217,3480,1014,1799,785,1014,81217,785,1799,91.28541667,1.966666667,3.579166667,69087.20208,1037.427083,5.697916667,99355.53958,0.692476268,0.010445046,5.90005E-05,0.43635353,0.022150535,69,20
D:0| T0: 0.17| T1: 20.00| R0: 0.0| R1: 0.0| WTP: 0,0,0.173076923,20,0,0,0,0,0,-2062506633,465621985,13044.7896,1410267153,141026715.3,1,98735,4381,480,2167,1687,480,98735,1687,2167,334.5272727,2.83030303,13.01212121,26112.41818,2058.369697,15.90909091,98516.55758,0.262930085,0.020662792,0.000161171,0.778495616,0.021947638,24,15
D:0| T0: 0.17| T1: 20.00| R0: 0.0| R1: 0.0| WTP: 0,0,0.173076923,20,0,0,0,0,0,-1470907198,1487072553,1168.372375,1412488579,141248857.9,1,11183,472,192,194,2,192,11183,2,194,33.1849711,1,1.011560694,93079.32948,235.1213873,2.115606936,99890.27746,0.931853345,0.00234256,2.22045E-05,0.010309278,0.017350863,25,16
D:0| T0: 0.17| T1: 20.00| R0: 0.0| R1: 0.0| WTP: 0,0,0.173076923,20,0,0,0,0,0,-2357832042,1213733847,10635.6775,1826048167,182604816.7,2,80815,3394,1433,1767,334,1433,80815,334,1767,89.75657895,2.962719298,3.666666667,53863.17105,747.9342105,6.802631579,99041.06579,0.542449445,0.007530458,7.06535E-05,0.189020939,0.021864753,66,20
D:0| T0: 0.17| T1: 20.00| R0: 0.0| R1: 0.0| WTP: 0,0,0.173076923,20,0,0,0,0,0,-2088936745,2003658337,5922.404251,1792816533,179281653.3,2,44758,1878,596,984,388,596,44758,388,984,92.74793388,2.359504132,3.94214876,67926.73967,749.4421488,6.400826446,99337.33058,0.683458884,0.007500423,6.53484E-05,0.394308943,0.021985879,35,20
D:0| T0: 0.17| T1: 20.00| R0: 0.0| R1: 0.0| WTP: 0,0,0.173076923,20,0,0,0,0,0,-1056628393,1170868072,84.26888432,1052414949,105241494.9,1,737,34,14,14,0,14,737,0,14,2.5,0.027777778,0.027777778,99553.38889,29.02777778,0.111111111,99993.40972,0.995606114,0.000290569,1.93116E-06,0,0.018995929,21,12
D:0| T0: 0.17| T1: 20.00| R0: 0.0| R1: 0.0| WTP: 0,0,0.173076923,20,0,0,0,0,0,-2356850640,569919592,11915.80294,1761060493,176106049.3,1,99253,4499,426,1979,1553,426,99253,1553,1979,291.0471204,2.178010471,10.28272251,19861.66492,1353.65445,12.51308901,98501.8377,0.200403918,0.013586368,0.000126488,0.784739768,0.019938944,28,19
D:0| T0: 0.17| T1: 20.00| R0: 0.0| R1: 0.0| WTP: 0,0,0.173076923,20,0,0,0,0,0,-2014155262,1833180623,4362.033463,1796053589,179605358.9,2,40935,1924,502,724,222,502,40935,222,724,121.7902439,2.292682927,3.336585366,71794.22439,925.3512195,5.795121951,99541.13171,0.721111515,0.009242055,5.97295E-05,0.306629834,0.017686576,30,20
D:0| T0: 0.17| T1: 20.00| R0: 0.0| R1: 0.0| WTP: 0,0,0.173076923,20,0,0,0,0,0,-2250428039,1123666637,13397.49232,1580553424,158055342.4,1,97045,4088,484,2226,1742,484,97045,1742,2226,292.4382022,2.646067416,12.37640449,26979.19101,1643.123596,15.08988764,98445.79213,0.271790086,0.016507599,0.000153066,0.782569632,0.022937812,26,17
D:0| T0: 0.17| T1: 20.00| R0: 0.0| R1: 0.0| WTP: 0,0,0.173076923,20,0,0,0,0,0,-2341195620,1682024981,10228.28962,1829781139,182978113.9,2,79765,3503,934,1699,765,934,79765,765,1699,41.420508,0.764816557,1.470366886,30250.78645,614.971778,2.357478833,98555.43838,0.306463535,0.006195061,2.49701E-05,0.450264862,0.021300069,151,20
D:0| T0: 0.17| T1: 20.00| R0: 0.0| R1: 0.0| WTP: 0,0,0.173076923,20,0,0,0,0,0,-2404818405,1687523543,11353.76991,1837129910,183712991,2,91009,3879,1032,1886,854,1032,91009,854,1886,110.6382488,2.244239631,4.18202765,57194.45161,797.1267281,6.562211982,99160.55069,0.573684694,0.008028028,6.76806E-05,0.45281018,0.020723225,62,20
D:0| T0: 0.17| T1: 20.00| R0: 0.0| R1: 0.0| WTP: 0,0,0.173076923,20,0,0,0,0,0,-2098517827,178034412,12141.87123,1491424265,149142426.5,1,94595,4091,473,2017,1544,473,94595,1544,2017,302.4882353,2.705882353,11.71176471,32179.84706,1957.470588,14.5,98671.00588,0.323884412,0.01964123,0.000147066,0.765493307,0.02132248,25,16
D:0| T0: 0.17| T1: 20.00| R0: 0.0| R1: 0.0| WTP: 0,0,0.173076923,20,0,0,0,0,0,-1965558549,739490003,11252.80218,1402918440,140291844,1,93004,4063,472,1869,1397,472,93004,1397,1869,315.3580247,2.858024691,11.41358025,35432.75926,1602.95679,14.30864198,98812.0679,0.356447524,0.016067527,0.000144941,0.747458534,0.02009591,24,15
D:0| T0: 0.17| T1: 20.00| R0: 0.0| R1: 0.0| WTP: 0,0,0.173076923,20,0,0,0,0,0,-1973734689,178482706,8510.628926,1548203243,154820324.3,1,63172,2774,540,1414,874,540,63172,874,1414,187.3446328,2.95480226,7.836158192,57986.71186,1529.644068,10.87570621,99144.86441,0.58376196,0.01531079,0.000110547,0.618104668,0.022383334,26,17
D:0| T0: 0.17| T1: 20.00| R0: 0.0| R1: 0.0| WTP: 0,0,0.173076923,20,0,0,0,0,0,-1934925871,1919366370,3196.185014,1775116620,177511662,2,24019,1000,446,531,85,446,24019,85,531,59.85990338,2.033816425,2.429951691,84146.26087,401.7536232,4.599033816,99674.77295,0.844168016,0.004010614,4.70942E-05,0.16007533,0.022109339,30,20
D:0| T0: 0.17| T1: 20.00| R0: 0.0| R1: 0.0| WTP: 0,0,0.173076923,20,0,0,0,0,0,-1981487002,1819796913,11429.23864,1410025070,141002507,1,97451,4460,447,1898,1451,447,97451,1451,1898,331.8562874,2.622754491,11.25149701,29956.10778,2402.502994,13.91616766,98757.13174,0.301268217,0.024087167,0.000140892,0.764488936,0.019476455,24,15
D:0| T0: 0.17| T1: 20.00| R0: 0.0| R1: 0.0| WTP: 0,0,0.173076923,20,0,0,0,0,0,-2465590414,1866591913,12425.04061,1844338383,184433838.3,2,95908,4150,933,2064,1131,933,95908,1131,2064,125.1889952,2.110047847,4.78708134,57943.13636,1889.796651,7.011961722,99173.38278,0.580072058,0.019042348,7.22534E-05,0.547965116,0.021520624,60,20
D:0| T0: 0.17| T1: 20.00| R0: 0.0| R1: 0.0| WTP: 0,0,0.173076923,20,0,0,0,0,0,-1854053111,1219425989,12401.84865,1233960679,123396067.9,1,99237,4466,445,2060,1615,445,99237,1615,2060,367.2281879,2.899328859,13.69798658,25378.61074,1725.073826,16.67785235,98582.61074,0.255690659,0.017298075,0.000168699,0.783980583,0.020758386,22,13
D:0| T0: 0.17| T1: 20.00| R0: 0.0| R1: 0.0| WTP: 0,0,0.173076923,20,0,0,0,0,0,-2081001749,502409586,11734.42741,1494280379,149428037.9,1,97438,4267,475,1949,1474,475,97438,1474,1949,306.0287356,2.655172414,11.08045977,28094.3908,2257.413793,13.83333333,98682,0.282737,0.022643698,0.00013985,0.756285274,0.020002463,25,16
D:0| T0: 0.17| T1: 20.00| R0: 0.0| R1: 0.0| WTP: 0,0,0.173076923,20,0,0,0,0,0,-1956592972,1405887957,9608.669848,1476159480,147615948,1,76415,3438,512,1596,1084,512,76415,1084,1596,251.7869822,2.940828402,9.313609467,49101.85207,1371.710059,12.32544379,99030.04142,0.494238164,0.013737337,0.000124981,0.679197995,0.020885952,25,16
D:0| T0: 0.17| T1: 20.00| R0: 0.0| R1: 0.0| WTP: 0,0,0.173076923,20,0,0,0,0,0,-2094420002,283033753,12288.32318,1480003843,148000384.3,1,87277,3583,531,2042,1511,531,87277,1511,2042,255.9884393,2.994219653,11.67052023,38554.0578,1341.491329,14.74566474,98675.24855,0.388482073,0.013467474,0.000149366,0.739960823,0.023396771,25,16
D:0| T0: 0.17| T1: 20.00| R0: 0.0| R1: 0.0| WTP: 0,0,0.173076923,20,0,0,0,0,0,-2422482449,1083157068,11725.97739,1836183580,183618358,2,86161,3673,1435,1948,513,1435,86161,513,1948,101.4557235,2.930885529,4.006479482,49369.75378,950.062635,7.118790497,98919.32181,0.497727331,0.00957228,7.3653E-05,0.263347023,0.022608837,67,20
D:0| T0: 0.17| T1: 20.00| R0: 0.0| R1: 0.0| WTP: 0,0,0.173076923,20,0,0,0,0,0,-2390919165,1988704626,11278.52345,1826992993,182699299.3,2,81455,3337,1246,1874,628,1246,81455,628,1874,98.507109,2.817535545,4.274881517,63659.62085,494.0853081,7.234597156,99187.90047,0.639806321,0.004978054,7.44221E-05,0.33511206,0.023006568,61,20
D:0| T0: 0.17| T1: 20.00| R0: 0.0| R1: 0.0| WTP: 0,0,0.173076923,20,0,0,0,0,0,-1782919123,884761309,12743.97338,1145720455,114572045.5,1,99069,4387,436,2117,1681,436,99069,1681,2117,369.3673469,2.911564626,14.29251701,24302.81633,1752.081633,17.2585034,98511.2381,0.245066138,0.017571463,0.00017431,0.794048181,0.021368945,21,12
D:0| T0: 0.17| T1: 20.00| R0: 0.0| R1: 0.0| WTP: 0,0,0.173076923,20,0,0,0,0,0,-1357033682,533485933,716.7577695,1321195794,132119579.4,1,6560,306,119,119,0,119,6560,0,119,22.79012346,0.617283951,0.617283951,95949.82099,110.5246914,1.351851852,99933.99383,0.960166,0.001101319,1.46094E-05,0,0.018140244,24,15
D:0| T0: 0.17| T1: 20.00| R0: 0.0| R1: 0.0| WTP: 0,0,0.173076923,20,0,0,0,0,0,-1541710028,632196071,897.0507331,1496857491,149685749.1,1,7021,309,148,149,1,148,7021,1,149,21.58988764,0.724719101,0.730337079,95478.35393,102.4719101,1.584269663,99911.10674,0.955671149,0.001022034,1.66039E-05,0.006711409,0.021222048,26,17
D:0| T0: 0.17| T1: 20.00| R0: 0.0| R1: 0.0| WTP: 0,0,0.173076923,20,0,0,0,0,0,-2132995666,393400457,12797.00807,1493145262,149314526.2,1,96342,4175,447,2126,1679,447,96342,1679,2126,304.3430233,2.540697674,12.26162791,30650.72093,1753.767442,14.8372093,98579.56395,0.30840584,0.017605094,0.000150281,0.789746002,0.022067219,25,16
D:0| T0: 0.17| T1: 20.00| R0: 0.0| R1: 0.0| WTP: 0,0,0.173076923,20,0,0,0,0,0,-1929437168,398973227,10756.71502,1391601417,139160141.7,1,82399,3546,541,1787,1246,541,82399,1246,1787,262.9107143,3.136904762,10.48809524,44001.22024,1467.214286,13.69642857,98895.46429,0.443037157,0.014703408,0.000138964,0.697257974,0.021687156,24,15
D:0| T0: 0.17| T1: 20.00| R0: 0.0| R1: 0.0| WTP: 0,0,0.173076923,20,0,0,0,0,0,-2373660967,1402256491,10800.39907,1833641013,183364101.3,2,85301,3687,1649,1794,145,1649,85301,145,1794,107.3364929,3.739336493,4.059241706,51753.88626,1276.111374,7.964454976,99039.90521,0.520696632,0.01284731,8.21212E-05,0.080824972,0.021031406,61,20
D:0| T0: 0.17| T1: 20.00| R0: 0.0| R1: 0.0| WTP: 0,0,0.173076923,20,0,0,0,0,0,-2323757768,2102527413,9944.961666,1826509685,182650968.5,2,75044,3333,654,1652,998,654,75044,998,1652,199.9952607,3,7.696682464,47394.34123,2057.260664,10.81042654,98944.08531,0.477515461,0.020634822,0.00010969,0.604116223,0.022013752,31,20
D:0| T0: 0.17| T1: 20.00| R0: 0.0| R1: 0.0| WTP: 0,0,0.173076923,20,0,0,0,0,0,-2223863970,1748031099,11322.31507,1657748216,165774821.6,1,84820,3584,627,1881,1254,627,84820,1254,1881,249.6793478,3.331521739,10.09782609,42318.53804,2486.804348,13.48369565,98840.16304,0.42603791,0.024958767,0.000136848,0.666666667,0.022176373,27,18
D:0| T0: 0.17| T1: 20.00| R0: 0.0| R1: 0.0| WTP: 0,0,0.173076923,20,0,0,0,0,0,-2376629621,1946754629,10836.51088,1834804077,183480407.7,2,87067,3758,923,1800,877,923,87067,877,1800,105.029148,1.941704036,3.872197309,62955.29596,752.0717489,5.966367713,99271.787,0.631155402,0.007572138,6.14481E-05,0.487222222,0.020673734,64,20
D:0| T0: 0.17| T1: 20.00| R0: 0.0| R1: 0.0| WTP: 0,0,0.173076923,20,0,0,0,0,0,-1878007065,2097712204,2149.709344,1770521597,177052159.7,2,17594,805,348,357,9,348,17594,9,357,43.7753304,1.374449339,1.422907489,87919.39207,239.784141,2.960352423,99771.59912,0.881246344,0.00239369,3.0975E-05,0.025210084,0.020291008,33,20
D:0| T0: 0.17| T1: 20.00| R0: 0.0| R1: 0.0| WTP: 0,0,0.173076923,20,0,0,0,0,0,-2384433967,1198827119,11063.57971,1831254982,183125498.2,2,84418,3647,962,1838,876,962,84418,876,1838,95.53004292,1.961373391,3.815450644,70071.1309,1160.905579,5.881974249,99396.97425,0.701741191,0.011690702,6.05033E-05,0.476605005,0.021772608,67,20
D:0| T0: 0.17| T1: 20.00| R0: 0.0| R1: 0.0| WTP: 0,0,0.173076923,20,0,0,0,0,0,-1404184043,109253198,30.1143433,1402678326,140267832.6,1,294,12,5,5,0,5,294,0,5,0.91160221,0.005524862,0.005524862,99818.67956,11.40331492,0.027624309,99997,0.998220311,0.000115882,5.49461E-07,0,0.017064846,25,16
D:0| T0: 0.17| T1: 20.00| R0: 0.0| R1: 0.0| WTP: 0,0,0.173076923,20,0,0,0,0,0,-1438170899,314481292,614.2164209,1407460078,140746007.8,1,4927,215,102,102,0,102,4927,0,102,17.11242604,0.49704142,0.49704142,96855.05917,87.1183432,1.100591716,99941.61538,0.969148319,0.000868848,1.20058E-05,0,0.020702253,25,16
D:0| T0: 0.17| T1: 24.00| R0: 0.0| R1: 0.0| WTP: 0,0,0.173076923,24,0,0,0,0,0,-1491858231,1178568022,30.12067847,1490352197,149035219.7,1,312,15,5,5,0,5,312,0,5,0.978378378,0,0,99803.43784,8.740540541,0.027027027,99996.95676,0.998068409,8.91422E-05,5.37645E-07,0,0.01607717,26,17
D:0| T0: 0.17| T1: 24.00| R0: 0.0| R1: 0.0| WTP: 0,0,0.173076923,24,0,0,0,0,0,-1906711473,2029998696,11746.56513,1319383216,131938321.6,1,95757,4310,471,1951,1480,471,95757,1480,1951,338.5,2.917721519,12.23417722,34133.97468,2047.259494,15.20253165,98787.36076,0.343134047,0.020521127,0.000153792,0.758585341,0.02037449,23,14
D:0| T0: 0.17| T1: 24.00| R0: 0.0| R1: 0.0| WTP: 0,0,0.173076923,24,0,0,0,0,0,-2704525886,776062361,10592.82938,2174884417,217488441.7,2,78227,3339,743,1760,1017,743,78227,1017,1760,168.219917,2.987551867,7.157676349,45972.9751,2014.377593,10.2406639,98885.53527,0.463070186,0.020230734,0.00010437,0.577840909,0.022498626,34,24
D:0| T0: 0.17| T1: 24.00| R0: 0.0| R1: 0.0| WTP: 0,0,0.173076923,24,0,0,0,0,0,-1494647557,1813046880,78.28705192,1490733204,149073320.4,1,566,31,13,13,0,13,566,0,13,2.232044199,0.022099448,0.022099448,99628.38674,18.9558011,0.093922652,99992.45856,0.996365391,0.000191001,1.42865E-06,0,0.022968198,26,17
D:0| T0: 0.17| T1: 24.00| R0: 0.0| R1: 0.0| WTP: 0,0,0.173076923,24,0,0,0,0,0,-1432585441,2032407216,2029.219858,1331124449,133112444.9,1,17270,787,311,337,26,311,17270,26,337,56.13333333,1.757575758,1.903030303,89330.33939,364.8,3.793939394,99814.11515,0.894983692,0.003633692,3.90999E-05,0.077151335,0.019513607,24,15
D:0| T0: 0.17| T1: 24.00| R0: 0.0| R1: 0.0| WTP: 0,0,0.173076923,24,0,0,0,0,0,-789830023.7,1507873352,18.03885983,788928080.7,78892808.07,1,53,5,3,3,0,3,53,0,3,0.346153846,0,0,99969.92308,3.353846154,0.023076923,99999.23846,0.999708164,3.52674E-05,4.5802E-07,0,0.056603774,18,9
D:0| T0: 0.17| T1: 24.00| R0: 0.0| R1: 0.0| WTP: 0,0,0.173076923,24,0,0,0,0,0,-968754026.9,1855899401,78.28915632,964839569,96483956.9,1,825,38,13,13,0,13,825,0,13,2.927536232,0.036231884,0.036231884,99516.06522,21.85507246,0.115942029,99992.72464,0.995239322,0.000219585,1.87061E-06,0,0.015757576,20,11
D:0| T0: 0.17| T1: 24.00| R0: 0.0| R1: 0.0| WTP: 0,0,0.173076923,24,0,0,0,0,0,-2279444171,1819459251,7663.077644,1896290289,189629028.9,1,60030,2612,568,1273,705,568,60030,705,1273,154.3495146,2.669902913,6.04368932,58086.92233,1047.548544,8.82038835,99174.00971,0.584913616,0.010488404,8.9509E-05,0.553809898,0.021206064,30,21
D:0| T0: 0.17| T1: 24.00| R0: 0.0| R1: 0.0| WTP: 0,0,0.173076923,24,0,0,0,0,0,-879717430.9,909791748,48.30141192,877302360.3,87730236.03,1,712,35,8,8,0,8,712,0,8,3.715384615,0.023076923,0.023076923,99597.11538,18.2,0.092307692,99996.43846,0.996011817,0.000183516,1.22141E-06,0,0.011235955,19,10
D:0| T0: 0.17| T1: 24.00| R0: 0.0| R1: 0.0| WTP: 0,0,0.173076923,24,0,0,0,0,0,-2699860527,1339092841,10520.66041,2173827507,217382750.7,2,74530,3156,1385,1748,363,1385,74530,363,1748,70.22142857,2.323214286,2.948214286,54191.85357,478.4535714,5.441071429,98943.56607,0.546665446,0.004820099,5.63588E-05,0.207665904,0.023453643,80,24
D:0| T0: 0.17| T1: 24.00| R0: 0.0| R1: 0.0| WTP: 0,0,0.173076923,24,0,0,0,0,0,-2030729947,1365866345,12461.40314,1407659790,140765979,1,97538,4342,473,2070,1597,473,97538,1597,2070,323.5361446,2.777108434,12.3313253,30129.07229,1838.403614,15.18674699,98646.18072,0.303029949,0.018449069,0.000153835,0.771497585,0.021222498,24,15
D:0| T0: 0.17| T1: 24.00| R0: 0.0| R1: 0.0| WTP: 0,0,0.173076923,24,0,0,0,0,0,-2700511854,825453433,10243.10705,2188356501,218835650.1,2,86085,3887,1377,1701,324,1377,86085,324,1701,103.8817204,2.782795699,3.455913978,55061.0129,942.9741935,6.423655914,99171.92043,0.553598818,0.00948858,6.66053E-05,0.19047619,0.01975954,67,24
D:0| T0: 0.17| T1: 24.00| R0: 0.0| R1: 0.0| WTP: 0,0,0.173076923,24,0,0,0,0,0,-1951386180,939711378,12599.97694,1321387333,132138733.3,1,97565,4337,449,2093,1644,449,97565,1644,2093,352.1225806,2.806451613,13.36129032,32566.96774,2472.883871,16.23870968,98693.54839,0.327314107,0.024802877,0.000164638,0.785475394,0.021452365,23,14
D:0| T0: 0.17| T1: 24.00| R0: 0.0| R1: 0.0| WTP: 0,0,0.173076923,24,0,0,0,0,0,-2763189090,638950699,11409.46125,2192716028,219271602.8,2,90791,4162,1140,1895,755,1140,90791,755,1895,115.7727273,2.434090909,4.129545455,65906.66136,1311.975,6.729545455,99336.60227,0.660740371,0.013215633,6.94525E-05,0.398416887,0.020872113,63,24
D:0| T0: 0.17| T1: 24.00| R0: 0.0| R1: 0.0| WTP: 0,0,0.173076923,24,0,0,0,0,0,-1898766432,938699148,1005.479527,1848492455,184849245.5,1,7893,374,167,167,0,167,7893,0,167,21.25358852,0.669856459,0.669856459,94570.48804,126.861244,1.473684211,99894.5311,0.946752186,0.001265693,1.59175E-05,0,0.021157988,30,21
D:0| T0: 0.17| T1: 24.00| R0: 0.0| R1: 0.0| WTP: 0,0,0.173076923,24,0,0,0,0,0,-1841682443,121790188,18.05415653,1840779735,184077973.5,1,194,10,3,3,0,3,194,0,3,0.349056604,0,0,99886.26415,7.735849057,0.014150943,99998.73585,0.998877489,7.92026E-05,2.81693E-07,0,0.015463918,30,21
D:0| T0: 0.17| T1: 24.00| R0: 0.0| R1: 0.0| WTP: 0,0,0.173076923,24,0,0,0,0,0,-2638975491,1331335240,9325.005643,2172725209,217272520.9,2,73333,3203,757,1549,792,757,73333,792,1549,168.8675214,3.115384615,6.444444444,48747.92735,2061.089744,9.670940171,99013.54274,0.491023269,0.020674628,9.89128E-05,0.511297611,0.021122823,34,24
D:0| T0: 0.17| T1: 24.00| R0: 0.0| R1: 0.0| WTP: 0,0,0.173076923,24,0,0,0,0,0,-2163737738,470935411,13362.35035,1495620221,149562022.1,1,98775,4173,475,2220,1745,475,98775,1745,2220,312.5,2.697674419,12.81395349,24473.4186,1485.94186,15.54651163,98426.86628,0.246574405,0.014924275,0.000157498,0.786036036,0.022475323,25,16
D:0| T0: 0.17| T1: 24.00| R0: 0.0| R1: 0.0| WTP: 0,0,0.173076923,24,0,0,0,0,0,-2807165645,823434397,12433.95124,2185468083,218546808.3,2,89984,3858,954,2066,1112,954,89984,1112,2066,105.5431818,2.031818182,4.536363636,67836.91364,1044.302273,6.695454545,99315.78182,0.679731602,0.0105278,6.91619E-05,0.538238141,0.022959637,63,24
D:0| T0: 0.17| T1: 24.00| R0: 0.0| R1: 0.0| WTP: 0,0,0.173076923,24,0,0,0,0,0,-1147243496,493045351,132.4932633,1140618833,114061883.3,1,1358,62,22,22,0,22,1358,0,22,4.570469799,0.073825503,0.073825503,99178.87919,23.2147651,0.228187919,99988.9396,0.991908714,0.000233087,2.93363E-06,0,0.016212233,22,13
D:0| T0: 0.17| T1: 24.00| R0: 0.0| R1: 0.0| WTP: 0,0,0.173076923,24,0,0,0,0,0,-2690207934,1700216563,9997.335863,2190341141,219034114.1,2,87414,3985,874,1660,786,874,87414,786,1660,115.0091743,1.855504587,3.633027523,68590.39679,1085.667431,5.637614679,99449.36927,0.686849605,0.0109182,5.84568E-05,0.473493976,0.018990093,63,24
D:0| T0: 0.17| T1: 24.00| R0: 0.0| R1: 0.0| WTP: 0,0,0.173076923,24,0,0,0,0,0,-1699750614,1744119059,3565.528496,1521474189,152147418.9,1,31573,1438,445,592,147,445,31573,147,592,99.06043956,2.307692308,3.093406593,79206.44505,480.7417582,5.543956044,99645.01648,0.794821436,0.004795986,5.68324E-05,0.248310811,0.018750198,26,17
D:0| T0: 0.17| T1: 24.00| R0: 0.0| R1: 0.0| WTP: 0,0,0.173076923,24,0,0,0,0,0,-2738002009,2036906360,11117.7452,2182114749,218211474.9,2,84419,3585,1022,1847,825,1022,84419,825,1847,82.81076067,1.799628942,3.296846011,71726.39518,1088.897959,5.187384045,99430.68275,0.718248374,0.010967558,5.3617E-05,0.446670276,0.021878961,76,24
D:0| T0: 0.17| T1: 24.00| R0: 0.0| R1: 0.0| WTP: 0,0,0.173076923,24,0,0,0,0,0,-2733491472,809704121,10856.27061,2190677941,219067794.1,2,88184,4029,1056,1803,747,1056,88184,747,1803,107.4215054,2.103225806,3.688172043,64962.95699,978.2516129,5.969892473,99329.07957,0.651272277,0.009849714,6.18836E-05,0.414309484,0.020445886,66,24
D:0| T0: 0.17| T1: 24.00| R0: 0.0| R1: 0.0| WTP: 0,0,0.173076923,24,0,0,0,0,0,-2608944164,1219866412,8689.013898,2174493469,217449346.9,2,72235,3207,716,1443,727,716,72235,727,1443,168.6735537,2.851239669,5.82231405,47027.10744,2452.42562,8.79338843,99033.02066,0.473864652,0.024589884,8.9506E-05,0.503811504,0.019976466,35,24
D:0| T0: 0.17| T1: 24.00| R0: 0.0| R1: 0.0| WTP: 0,0,0.173076923,24,0,0,0,0,0,-880548875.2,843498920,72.19973601,876938888.4,87693888.84,1,647,29,12,12,0,12,647,0,12,1.92481203,0.015037594,0.015037594,99623.25564,22.4887218,0.127819549,99993.54887,0.996302547,0.000225537,1.79114E-06,0,0.018547141,19,10
D:0| T0: 0.17| T1: 24.00| R0: 0.0| R1: 0.0| WTP: 0,0,0.173076923,24,0,0,0,0,0,-2850952173,107351963,13287.15696,2186594325,218659432.5,2,92539,3736,1055,2208,1153,1055,92539,1153,2208,97.86430063,2.083507307,4.463465553,70019.96033,1350.331942,6.647181628,99343.0167,0.701484745,0.013623386,6.87059E-05,0.522192029,0.02386021,69,24
D:0| T0: 0.17| T1: 24.00| R0: 0.0| R1: 0.0| WTP: 0,0,0.173076923,24,0,0,0,0,0,-2763731381,773789021,11468.66556,2190298103,219029810.3,2,91458,3975,950,1905,955,950,91458,955,1905,101.8381148,1.81147541,3.735655738,62075.91393,1269.881148,5.709016393,99263.59221,0.621998204,0.01279207,5.89259E-05,0.501312336,0.020829233,70,24
D:0| T0: 0.17| T1: 24.00| R0: 0.0| R1: 0.0| WTP: 0,0,0.173076923,24,0,0,0,0,0,-2795806993,850936611,12288.58555,2181377716,218137771.6,2,87907,3562,1156,2042,886,1156,87907,886,2042,95.41176471,2.355119826,4.252723312,63419.57952,1015.941176,6.816993464,99199.00436,0.636412839,0.010240556,7.02037E-05,0.434100931,0.023217983,66,24
D:0| T0: 0.17| T1: 24.00| R0: 0.0| R1: 0.0| WTP: 0,0,0.173076923,24,0,0,0,0,0,-2208661717,1701318364,6440.879931,1886617720,188661772,1,48546,2066,593,1070,477,593,48546,477,1070,128.1617647,2.799019608,5.098039216,66123.78431,1013.656863,8.014705882,99316.60294,0.665356634,0.010138231,8.15597E-05,0.445794393,0.022040951,30,21
D:0| T0: 0.17| T1: 24.00| R0: 0.0| R1: 0.0| WTP: 0,0,0.173076923,24,0,0,0,0,0,-1140198407,778708269,12.05544501,1139595635,113959563.5,1,160,9,2,2,0,2,160,0,2,0.577181208,0,0,99907.56376,7.577181208,0.013422819,99999.52349,0.999082926,7.74669E-05,2.66668E-07,0,0.012578616,22,13
D:0| T0: 0.17| T1: 24.00| R0: 0.0| R1: 0.0| WTP: 0,0,0.173076923,24,0,0,0,0,0,-1581914065,1391938506,1619.063448,1500960893,150096089.3,1,12213,490,265,269,4,265,12213,4,269,34.41242938,1.322033898,1.333333333,91991.17514,246.559322,2.870056497,99838.23164,0.921450195,0.002457106,3.00386E-05,0.014869888,0.02202571,26,17
D:0| T0: 0.17| T1: 24.00| R0: 0.0| R1: 0.0| WTP: 0,0,0.173076923,24,0,0,0,0,0,-966359998.7,43418681,36.15789548,964552103.9,96455210.39,1,448,22,6,6,0,6,448,0,6,1.766423358,0,0,99738.22628,18.38686131,0.04379562,99996.93431,0.997417343,0.000185078,8.69587E-07,0,0.013392857,20,11
D:0| T0: 0.17| T1: 24.00| R0: 0.0| R1: 0.0| WTP: 0,0,0.173076923,24,0,0,0,0,0,-2757534997,817384966,13042.80165,2105394915,210539491.5,1,97822,4117,441,2167,1726,441,97822,1726,2167,235.1506849,1.96803653,9.808219178,20561.99087,1216.515982,11.82648402,98330.76712,0.207488953,0.012227703,0.000119801,0.796492847,0.022152481,32,23
D:0| T0: 0.17| T1: 24.00| R0: 0.0| R1: 0.0| WTP: 0,0,0.173076923,24,0,0,0,0,0,-1933910598,762053968,12269.39796,1320440700,132044070,1,95458,4290,497,2038,1541,497,95458,1541,2038,339.6918239,3.062893082,12.68553459,32651.35849,1878.163522,15.80503145,98698.81761,0.328496954,0.018836603,0.000160036,0.756133464,0.021349704,23,14
D:0| T0: 0.17| T1: 24.00| R0: 0.0| R1: 0.0| WTP: 0,0,0.173076923,24,0,0,0,0,0,-2142242088,1692506311,638.7625143,2110303962,211030396.2,2,6140,287,106,106,0,106,6140,0,106,15.92276423,0.31300813,0.31300813,95928.36585,167.402439,0.743902439,99936.45122,0.959924774,0.001670444,8.58739E-06,0,0.017263844,35,24
D:0| T0: 0.17| T1: 24.00| R0: 0.0| R1: 0.0| WTP: 0,0,0.173076923,24,0,0,0,0,0,-615459852.2,1037620300,36.0634779,613656678.3,61365667.83,1,189,3,6,6,0,6,189,0,6,0.5625,0,0,99899.99107,6.258928571,0.0625,99997.875,0.999023061,6.41604E-05,1.06197E-06,0,0.031746032,16,7
D:0| T0: 0.17| T1: 24.00| R0: 0.0| R1: 0.0| WTP: 0,0,0.173076923,24,0,0,0,0,0,-1528169582,301400999,656.3266049,1495353251,149535325.1,1,5263,243,109,109,0,109,5263,0,109,16.64835165,0.467032967,0.467032967,96524.47802,120.7802198,1.054945055,99935.81319,0.965902233,0.001204021,1.19188E-05,0,0.020710621,26,17
D:0| T0: 0.17| T1: 24.00| R0: 0.0| R1: 0.0| WTP: 0,0,0.173076923,24,0,0,0,0,0,-2510059671,1868336855,8579.025629,2081108389,208110838.9,1,67252,2898,610,1425,815,610,67252,815,1425,171.0182648,2.689497717,6.365296804,52262.28311,1195.570776,9.155251142,99064.35616,0.526522568,0.011982025,9.31687E-05,0.571929825,0.021188961,32,23
D:0| T0: 0.17| T1: 24.00| R0: 0.0| R1: 0.0| WTP: 0,0,0.173076923,24,0,0,0,0,0,-2224097217,1868498144,8223.015062,1812946464,181294646.4,1,62583,2729,635,1366,731,635,62583,731,1366,168.8325123,3.019704433,6.581280788,57170.52709,1278.660099,9.684729064,99143.84236,0.575684899,0.012807541,9.877E-05,0.535139092,0.021827014,29,20
D:0| T0: 0.17| T1: 24.00| R0: 0.0| R1: 0.0| WTP: 0,0,0.173076923,24,0,0,0,0,0,-1851510385,2101566889,192.5684389,1841881963,184188196.3,1,1307,54,32,32,0,32,1307,0,32,3.470588235,0.078431373,0.078431373,99127.97059,35.24019608,0.230392157,99980.40686,0.991485172,0.000352835,3.12242E-06,0,0.02448355,30,21
D:0| T0: 0.17| T1: 24.00| R0: 0.0| R1: 0.0| WTP: 0,0,0.173076923,24,0,0,0,0,0,-1968416855,1665097450,13001.34028,1318349841,131834984.1,1,98303,4245,438,2160,1722,438,98303,1722,2160,335.0573248,2.732484076,13.63694268,28653.10191,2147.821656,16.41401274,98558.82803,0.28833457,0.021555904,0.000166186,0.797222222,0.02197288,23,14
D:0| T0: 0.17| T1: 24.00| R0: 0.0| R1: 0.0| WTP: 0,0,0.173076923,24,0,0,0,0,0,-1883626195,1716179948,11242.80387,1321486001,132148600.1,1,98040,4376,478,1867,1389,478,98040,1389,1867,349.6815287,2.98089172,11.75159236,31126.16561,2151.77707,14.78343949,98819.96815,0.312876334,0.021562003,0.000149784,0.74397429,0.019043248,23,14
D:0| T0: 0.17| T1: 24.00| R0: 0.0| R1: 0.0| WTP: 0,0,0.173076923,24,0,0,0,0,0,-1161076997,1560278715,391.0284409,1141525574,114152557.4,1,2287,99,65,65,0,65,2287,0,65,7.272151899,0.284810127,0.284810127,98698.41139,47.56962025,0.696202532,99967.28481,0.987315533,0.000475487,8.17863E-06,0,0.028421513,22,13
D:0| T0: 0.17| T1: 24.00| R0: 0.0| R1: 0.0| WTP: 0,0,0.173076923,24,0,0,0,0,0,-2330459506,991019385,10124.37815,1824240598,182424059.8,1,75581,3192,610,1682,1072,610,75581,1072,1682,207.2182741,3.015228426,8.401015228,47832.03046,2275.329949,11.49238579,98948.60914,0.48181966,0.02281456,0.000116747,0.637336504,0.02225427,29,20
D:0| T0: 0.17| T1: 24.00| R0: 0.0| R1: 0.0| WTP: 0,0,0.173076923,24,0,0,0,0,0,-2763782815,118052103,11539.90016,2186787807,218678780.7,2,86938,3752,1704,1917,213,1704,86938,213,1917,96.66045549,3.341614907,3.761904762,47853.51553,907.6190476,7.291925466,98927.20497,0.481979313,0.009143369,7.55352E-05,0.111111111,0.022050197,69,24
D:0| T0: 0.17| T1: 24.00| R0: 0.0| R1: 0.0| WTP: 0,0,0.173076923,24,0,0,0,0,0,-2018243144,1209758844,12487.00953,1393892667,139389266.7,1,88204,3609,528,2075,1547,528,88204,1547,2075,273.9515152,3.139393939,12.44848485,40211.76364,1568.357576,15.62424242,98708.38788,0.404832705,0.015744512,0.000158423,0.745542169,0.02352501,24,15
D:0| T0: 0.17| T1: 24.00| R0: 0.0| R1: 0.0| WTP: 0,0,0.173076923,24,0,0,0,0,0,-971295411.4,70671723,132.287538,964681034.5,96468103.45,1,879,37,22,22,0,22,879,0,22,2.096296296,0.096296296,0.096296296,99502.6,40.9037037,0.251851852,99989.91111,0.995132145,0.000408641,3.23562E-06,0,0.025028441,20,11
D:0| T0: 0.17| T1: 24.00| R0: 0.0| R1: 0.0| WTP: 0,0,0.173076923,24,0,0,0,0,0,-615724590.1,1722612191,42.05585974,613621797.1,61362179.71,1,154,7,7,7,0,7,154,0,7,0.339130435,0,0,99925.90435,6.269565217,0.069565217,99997.8,0.999282038,6.45706E-05,1.20693E-06,0,0.045454545,16,7
D:0| T0: 0.17| T1: 24.00| R0: 0.0| R1: 0.0| WTP: 0,0,0.173076923,24,0,0,0,0,0,-2019662922,1968291596,60.27458221,2016649193,201664919.3,1,480,31,10,10,0,10,480,0,10,1.887892377,0.004484305,0.004484305,99687.01794,8.713004484,0.049327354,99995.69507,0.99691812,8.91993E-05,8.92897E-07,0,0.020833333,32,23
D:0| T0: 0.17| T1: 24.00| R0: 0.0| R1: 0.0| WTP: 0,0,0.173076923,24,0,0,0,0,0,-2081251979,1877569084,13494.00386,1406551787,140655178.7,1,98396,4145,476,2242,1766,476,98396,1766,2242,326.0802469,2.895061728,13.75308642,28298.09259,1940.851852,16.66666667,98508.96296,0.284748422,0.019488655,0.000168597,0.787689563,0.022785479,24,15
D:0| T0: 0.17| T1: 24.00| R0: 0.0| R1: 0.0| WTP: 0,0,0.173076923,24,0,0,0,0,0,-2068572054,1726322189,13306.75095,1403234506,140323450.6,1,96304,4112,524,2211,1687,524,96304,1687,2211,307.5030303,3.109090909,13.26060606,31480.65455,1982.472727,16.44848485,98571.98788,0.316751669,0.019905308,0.000166567,0.763003166,0.022958548,24,15
D:0| T0: 0.17| T1: 24.00| R0: 0.0| R1: 0.0| WTP: 0,0,0.173076923,24,0,0,0,0,0,-1886903744,307848836,11497.9627,1312005608,131200560.8,1,90240,3972,507,1910,1403,507,90240,1403,1910,304.1552795,3.062111801,11.72049689,39548.54658,1977.285714,14.86956522,98843.35404,0.397740099,0.019823457,0.000150608,0.734554974,0.02116578,23,14
D:0| T0: 0.17| T1: 24.00| R0: 0.0| R1: 0.0| WTP: 0,0,0.173076923,24,0,0,0,0,0,-1835977801,1154000220,12035.59302,1234198150,123419815,1,98939,4480,439,1999,1560,439,98939,1560,1999,356.8766234,2.753246753,12.83766234,25431.02597,1673.532468,15.72077922,98620.52597,0.256197708,0.016774105,0.000158844,0.780390195,0.020204368,22,13
D:0| T0: 0.17| T1: 24.00| R0: 0.0| R1: 0.0| WTP: 0,0,0.173076923,24,0,0,0,0,0,-1848893629,2028661055,150.3633374,1841375462,184137546.2,1,905,37,25,25,0,25,905,0,25,2,0.048780488,0.048780488,99380.10732,23.08292683,0.165853659,99985.20976,0.993956921,0.000232011,2.42747E-06,0,0.027624309,30,21
D:0| T0: 0.17| T1: 24.00| R0: 0.0| R1: 0.0| WTP: 0,0,0.173076923,24,0,0,0,0,0,-2758005443,1629114640,11336.97628,2191156629,219115662.9,2,91577,3984,1311,1883,572,1311,91577,572,1883,113.5580866,2.810933941,4.091116173,58845.40774,1292.890661,7.082004556,99219.96583,0.590754485,0.013021808,7.32449E-05,0.303770579,0.020562156,63,24
D:0| T0: 0.17| T1: 24.00| R0: 0.0| R1: 0.0| WTP: 0,0,0.173076923,24,0,0,0,0,0,-1964457217,1439048174,12952.84406,1316815014,131681501.4,1,97218,4091,501,2152,1651,501,97218,1651,2152,320.6583851,3.049689441,13.26708075,31550.6646,2571.826087,16.38509317,98626.93789,0.317283489,0.025819004,0.000165513,0.767193309,0.022135818,23,14
D:0| T0: 0.17| T1: 24.00| R0: 0.0| R1: 0.0| WTP: 0,0,0.173076923,24,0,0,0,0,0,-2606194342,865227006,13487.76317,1931806183,193180618.3,1,99171,4141,440,2241,1801,440,99171,1801,2241,253.4975845,2.062801932,10.73429952,18111.4058,1287.507246,12.87439614,98252.28502,0.182903911,0.012941058,0.000130328,0.803659081,0.022597332,30,21
D:0| T0: 0.17| T1: 24.00| R0: 0.0| R1: 0.0| WTP: 0,0,0.173076923,24,0,0,0,0,0,-2695734237,890479738,10253.31329,2183068573,218306857.3,2,81508,3584,1197,1703,506,1197,81508,506,1703,60.14588859,1.441644562,2.096816976,35368.18037,772.2427056,3.671087533,98685.76393,0.357687836,0.007778632,3.87572E-05,0.297122725,0.020893911,108,24
D:0| T0: 0.17| T1: 24.00| R0: 0.0| R1: 0.0| WTP: 0,0,0.173076923,24,0,0,0,0,0,-1260009283,1017049163,571.924303,1231413068,123141306.8,1,4882,218,95,95,0,95,4882,0,95,15.35220126,0.471698113,0.471698113,97010.84906,111.0251572,1.088050314,99947.66667,0.970643074,0.001106399,1.18804E-05,0,0.019459238,23,14
D:0| T0: 0.17| T1: 24.00| R0: 0.0| R1: 0.0| WTP: 0,0,0.173076923,24,0,0,0,0,0,-1316046176,1707305064,18.14171148,1315139090,131513909,1,304,12,3,3,0,3,304,0,3,1.43902439,0.006097561,0.006097561,99809.40854,9.384146341,0.018292683,99998.14634,0.998116373,9.53351E-05,3.63639E-07,0,0.009868421,24,15
D:0| T0: 0.17| T1: 24.00| R0: 0.0| R1: 0.0| WTP: 0,0,0.173076923,24,0,0,0,0,0,-2256163780,400145663,13458.37785,1583244887,158324488.7,1,99063,4296,416,2236,1820,416,99063,1820,2236,305.3125,2.301136364,12.61363636,21244.23864,1511.471591,14.97727273,98336.77273,0.214354435,0.015179205,0.000151496,0.813953488,0.022571495,26,17
D:0| T0: 0.17| T1: 24.00| R0: 0.0| R1: 0.0| WTP: 0,0,0.173076923,24,0,0,0,0,0,-1146840749,1662654181,120.5449117,1140813503,114081350.3,1,1480,66,20,20,0,20,1480,0,20,5.25974026,0.051948052,0.051948052,99114.72078,38.96753247,0.168831169,99989.98701,0.991256664,0.000389447,2.58088E-06,0,0.013513514,22,13
D:0| T0: 0.17| T1: 24.00| R0: 0.0| R1: 0.0| WTP: 0,0,0.173076923,24,0,0,0,0,0,-2028784179,182136456,12413.50839,1408108760,140810876,1,98235,4374,473,2062,1589,473,98235,1589,2062,333.2037037,2.87037037,12.62345679,28120.00617,2101.364198,15.5308642,98623.17284,0.282984097,0.021080113,0.000157104,0.770611057,0.020990482,24,15
D:0| T0: 0.17| T1: 24.00| R0: 0.0| R1: 0.0| WTP: 0,0,0.173076923,24,0,0,0,0,0,-1403902093,979575387,24.11458233,1402696364,140269636.4,1,290,12,4,4,0,4,290,0,4,1.046783626,0,0,99823.53216,11.45614035,0.023391813,99998.20468,0.99825693,0.000116223,4.65123E-07,0,0.013793103,25,16
D:0| T0: 0.17| T1: 24.00| R0: 0.0| R1: 0.0| WTP: 0,0,0.173076923,24,0,0,0,0,0,-2114530231,2142525414,10984.42846,1565308808,156530880.8,1,81403,3435,588,1825,1237,588,81403,1237,1825,240.7653631,3.201117318,10.05027933,45963.01676,1782.201117,13.33519553,98902.11732,0.462652857,0.017876666,0.000135287,0.677808219,0.022419321,26,17
D:0| T0: 0.17| T1: 24.00| R0: 0.0| R1: 0.0| WTP: 0,0,0.173076923,24,0,0,0,0,0,-2716693868,1464057597,10626.58811,2185364462,218536446.2,2,82932,3668,1620,1765,145,1620,82932,145,1765,90.11914063,2.97265625,3.25,48925.8418,603.3964844,6.4296875,98967.39063,0.492890303,0.006076248,6.65738E-05,0.082152975,0.021282497,74,24
D:0| T0: 0.17| T1: 24.00| R0: 0.0| R1: 0.0| WTP: 0,0,0.173076923,24,0,0,0,0,0,-2062133212,364562610,11580.68812,1483098806,148309880.6,1,87956,3757,530,1924,1394,530,87956,1394,1924,266.3275862,2.965517241,10.93678161,39138.09195,1709.189655,14,98782.65517,0.394011626,0.017143152,0.000141569,0.724532225,0.021874574,25,16
D:0| T0: 0.17| T1: 24.00| R0: 0.0| R1: 0.0| WTP: 0,0,0.173076923,24,0,0,0,0,0,-2257783547,40350784,10400.98761,1737734166,173773416.6,1,77125,3268,605,1728,1123,605,77125,1123,1728,212.625641,3.01025641,8.717948718,47288.47692,1529.682051,11.81538462,98915.11282,0.476332949,0.015341981,0.000120075,0.649884259,0.022405186,28,19
D:0| T0: 0.17| T1: 24.00| R0: 0.0| R1: 0.0| WTP: 0,0,0.173076923,24,0,0,0,0,0,-2074109977,804064356,9890.023559,1579608799,157960879.9,1,89264,4116,438,1642,1204,438,89264,1204,1642,292.2011173,2.379888268,9.072625698,36867.4581,1444.03352,11.50837989,98925.40223,0.370984933,0.014467612,0.000116487,0.733252132,0.018394874,26,17
D:0| T0: 0.17| T1: 24.00| R0: 0.0| R1: 0.0| WTP: 0,0,0.173076923,24,0,0,0,0,0,-1628227273,2125493986,5507.451387,1352854703,135285470.3,1,39738,1695,465,915,450,465,39738,450,915,129.0059524,2.654761905,5.303571429,74078.57738,742.8690476,8.041666667,99455.19643,0.744512211,0.007417016,8.20256E-05,0.491803279,0.023025819,24,15
D:0| T0: 0.17| T1: 24.00| R0: 0.0| R1: 0.0| WTP: 0,0,0.173076923,24,0,0,0,0,0,-2022145136,23154253,7499.412326,1647174520,164717452,1,69083,3146,519,1245,726,519,69083,726,1245,219.8315217,2.695652174,6.60326087,53171.11413,1000.472826,9.461956522,99223.38043,0.53493693,0.010008325,9.59413E-05,0.58313253,0.0180218,27,18
D:0| T0: 0.17| T1: 24.00| R0: 0.0| R1: 0.0| WTP: 0,0,0.173076923,24,0,0,0,0,0,-2038013103,1391367689,385.2502514,2018750591,201875059.1,1,3102,138,64,64,0,64,3102,0,64,7.206278027,0.170403587,0.170403587,97810.30493,47.04932735,0.452914798,99958.0583,0.97853964,0.000470982,5.71604E-06,0,0.020638504,32,23
D:0| T0: 0.17| T1: 24.00| R0: 0.0| R1: 0.0| WTP: 0,0,0.173076923,24,0,0,0,0,0,-2744335926,574142276,11190.69271,2184801290,218480129,2,86913,3762,1100,1859,759,1100,86913,759,1859,101.7202643,2.27753304,3.922907489,66651.94493,876.654185,6.36123348,99330.09471,0.668670585,0.008828482,6.56095E-05,0.408284024,0.021389205,65,24
D:0| T0: 0.17| T1: 24.00| R0: 0.0| R1: 0.0| WTP: 0,0,0.173076923,24,0,0,0,0,0,-701611202.7,898736779,6.039854375,701309210,70130921,1,92,4,1,1,0,1,92,0,1,0.578947368,0,0,99953.01754,5.789473684,0.00877193,99999.17544,0.999539648,5.9218E-05,1.73913E-07,0,0.010869565,17,8
D:0| T0: 0.17| T1: 24.00| R0: 0.0| R1: 0.0| WTP: 0,0,0.173076923,24,0,0,0,0,0,-2694431650,346473503,9951.588908,2196852205,219685220.5,2,90956,4240,1309,1652,343,1309,90956,343,1652,110.2053388,2.544147844,3.215605749,47893.15811,1067.917864,5.899383984,99106.27105,0.481811953,0.010745171,6.11794E-05,0.207627119,0.018162628,70,24
D:0| T0: 0.17| T1: 24.00| R0: 0.0| R1: 0.0| WTP: 0,0,0.173076923,24,0,0,0,0,0,-2761110676,445552282,11479.81679,2187119837,218711983.7,2,88289,3872,1382,1907,525,1382,88289,525,1907,101.9589633,2.835853132,3.943844492,56284.99352,1091.181425,6.924406048,99100.97408,0.566108794,0.010993429,7.15537E-05,0.275301521,0.02159952,66,24
D:0| T0: 0.17| T1: 24.00| R0: 0.0| R1: 0.0| WTP: 0,0,0.173076923,24,0,0,0,0,0,-1746013496,911758476,11946.23269,1148701861,114870186.1,1,99146,4479,437,1984,1547,437,99146,1547,1984,396.7676056,2.985915493,13.83098592,27636.58451,1954.535211,16.9084507,98686.9507,0.278200211,0.019581078,0.000170959,0.779737903,0.020010893,21,12
D:0| T0: 0.17| T1: 24.00| R0: 0.0| R1: 0.0| WTP: 0,0,0.173076923,24,0,0,0,0,0,-2141479453,1464197940,11111.20923,1585918992,158591899.2,1,93996,4382,552,1845,1293,552,93996,1293,1845,311.6256983,3.005586592,10.18994413,33594.05028,3063.877095,13.24581006,98820.50279,0.337879763,0.03073005,0.000134389,0.700813008,0.019628495,26,17
D:0| T0: 0.17| T1: 24.00| R0: 0.0| R1: 0.0| WTP: 0,0,0.173076923,24,0,0,0,0,0,-1687163374,500405854,1908.361708,1591745289,159174528.9,1,13849,600,307,317,10,307,13849,10,317,42.3315508,1.465240642,1.524064171,91001.3262,304.6149733,3.160427807,99814.31551,0.911740735,0.003036852,3.32424E-05,0.031545741,0.022894699,27,18
D:0| T0: 0.17| T1: 24.00| R0: 0.0| R1: 0.0| WTP: 0,0,0.173076923,24,0,0,0,0,0,-2004424760,772037341,12110.26047,1398911737,139891173.7,1,92766,3897,464,2012,1548,464,92766,1548,2012,293.5333333,2.739393939,12.06666667,35320.81818,1842.612121,14.87272727,98710.27879,0.355418127,0.018482671,0.000150624,0.769383698,0.021688981,24,15
D:0| T0: 0.17| T1: 24.00| R0: 0.0| R1: 0.0| WTP: 0,0,0.173076923,24,0,0,0,0,0,-967790505.6,1543158763,66.16145856,964482432.7,96448243.27,1,464,23,11,11,0,11,464,0,11,1.379562044,0.02189781,0.02189781,99731.39416,15.99270073,0.102189781,99993.85401,0.997379249,0.000161025,1.59428E-06,0,0.023706897,20,11
D:0| T0: 0.17| T1: 24.00| R0: 0.0| R1: 0.0| WTP: 0,0,0.173076923,24,0,0,0,0,0,-1832721565,1604932531,13782.2358,1143609775,114360977.5,1,98721,4189,442,2290,1848,442,98721,1848,2290,361.6438356,2.938356164,15.55479452,28998.41781,1995.582192,18.5890411,98497.54795,0.291808024,0.020024328,0.000187945,0.8069869,0.023196686,21,12
D:0| T0: 0.17| T1: 24.00| R0: 0.0| R1: 0.0| WTP: 0,0,0.173076923,24,0,0,0,0,0,-2606397423,539051477,10270.38144,2092878350,209287835,1,77413,3439,689,1706,1017,689,77413,1017,1706,202.8027523,3.059633028,7.669724771,45165.97248,2037.399083,10.82568807,98900.74771,0.45512808,0.0204447,0.000110323,0.596131301,0.022037642,32,23
D:0| T0: 0.17| T1: 24.00| R0: 0.0| R1: 0.0| WTP: 0,0,0.173076923,24,0,0,0,0,0,-1235046152,1743124675,144.3604116,1227828131,122782813.1,1,733,30,24,24,0,24,733,0,24,2.662420382,0.057324841,0.057324841,99529.2293,15.29299363,0.21656051,99986.01911,0.99543861,0.000153751,3.03832E-06,0,0.032742156,23,14
D:0| T0: 0.17| T1: 24.00| R0: 0.0| R1: 0.0| WTP: 0,0,0.173076923,24,0,0,0,0,0,-2749167288,1965983789,11204.05695,2188964440,218896444,2,87614,3825,1078,1861,783,1078,87614,783,1861,113.5953488,2.323255814,4.109302326,67954.60465,1181.727907,6.620930233,99364.83256,0.680925822,0.011900698,6.88055E-05,0.420741537,0.021240898,62,24
D:0| T0: 0.17| T1: 24.00| R0: 0.0| R1: 0.0| WTP: 0,0,0.173076923,24,0,0,0,0,0,-2746403048,516774280,11220.90315,2185357891,218535789.1,2,85901,3700,1048,1864,816,1048,85901,816,1864,92.82071713,1.972111554,3.571713147,72250.18526,1105.545817,5.651394422,99447.68725,0.723725628,0.011135106,5.84229E-05,0.43776824,0.021699651,71,24
D:0| T0: 0.17| T1: 24.00| R0: 0.0| R1: 0.0| WTP: 0,0,0.173076923,24,0,0,0,0,0,-2296715272,86603142,12497.83911,1671823317,167182331.7,1,98877,4264,422,2076,1654,422,98877,1654,2076,296.4565217,2.239130435,11.19565217,20627.42391,1394.456522,13.48913043,98429.9837,0.20817992,0.013998365,0.000136404,0.79672447,0.020995783,27,18
D:0| T0: 0.17| T1: 24.00| R0: 0.0| R1: 0.0| WTP: 0,0,0.173076923,24,0,0,0,0,0,-965989593.7,1431870609,30.13122792,964483032.3,96448303.23,1,447,16,5,5,0,5,447,0,5,1.467153285,0,0,99737.33577,22.10948905,0.03649635,99997.13139,0.997406558,0.000221746,7.24652E-07,0,0.011185682,20,11
D:0| T0: 0.17| T1: 24.00| R0: 0.0| R1: 0.0| WTP: 0,0,0.173076923,24,0,0,0,0,0,-2675261860,1592383984,9868.684218,2181827649,218182764.9,2,80755,3481,1357,1639,282,1357,80755,282,1639,80.59528131,2.337568058,2.833030853,53701.89111,428.0417423,5.288566243,99077.89292,0.540881964,0.004309882,5.47312E-05,0.172056132,0.020295957,79,24
D:0| T0: 0.17| T1: 24.00| R0: 0.0| R1: 0.0| WTP: 0,0,0.173076923,24,0,0,0,0,0,-2679507900,1440183867,9804.892397,2189263280,218926328,2,86227,3981,1067,1628,561,1067,86227,561,1628,106.1681034,2.172413793,3.359913793,65773.23276,892.9137931,5.618534483,99395.47845,0.659571543,0.008982939,5.84102E-05,0.344594595,0.018880397,67,24
D:0| T0: 0.17| T1: 24.00| R0: 0.0| R1: 0.0| WTP: 0,0,0.173076923,24,0,0,0,0,0,-2814459911,1696510588,12465.79349,2191170237,219117023.7,2,90929,3959,770,2071,1301,770,90929,1301,2071,110.3230769,1.591208791,4.415384615,69446.29231,943.8307692,6.10989011,99363.18681,0.69520327,0.009513157,6.2939E-05,0.628198938,0.022776012,65,24
D:0| T0: 0.17| T1: 24.00| R0: 0.0| R1: 0.0| WTP: 0,0,0.173076923,24,0,0,0,0,0,-2298715397,895039877,11046.3651,1746397142,174639714.2,1,84956,3665,584,1835,1251,584,84956,1251,1835,240.5206186,2.93814433,9.319587629,39528.04124,2295.494845,12.31443299,98817.30412,0.398154226,0.02302829,0.000125193,0.681743869,0.021599416,28,19
D:0| T0: 0.17| T1: 24.00| R0: 0.0| R1: 0.0| WTP: 0,0,0.173076923,24,0,0,0,0,0,-2828132827,129565953,12848.54703,2185705475,218570547.5,2,89007,3746,1293,2135,842,1293,89007,842,2135,93.08669355,2.453629032,4.118951613,63724.52016,1267.977823,6.731854839,99186.57258,0.639395695,0.012789848,6.96836E-05,0.394379391,0.023986877,70,24
D:0| T0: 0.17| T1: 24.00| R0: 0.0| R1: 0.0| WTP: 0,0,0.173076923,24,0,0,0,0,0,-1865188265,1902565669,415.5966057,1844408435,184440843.5,1,4219,196,69,69,0,69,4219,0,69,10.41545894,0.256038647,0.256038647,97168.86473,75.99033816,0.574879227,99955.94203,0.972147651,0.000759016,6.63677E-06,0,0.016362343,30,21
D:0| T0: 0.17| T1: 24.00| R0: 0.0| R1: 0.0| WTP: 0,0,0.173076923,24,0,0,0,0,0,-1413891858,1984179288,198.6784526,1403957935,140395793.5,1,1788,69,33,33,0,33,1788,0,33,5.296511628,0.087209302,0.087209302,98850.1686,78.55813953,0.284883721,99982.40116,0.988690847,0.000783459,3.81563E-06,0,0.018456376,25,16
D:0| T0: 0.17| T1: 24.00| R0: 0.0| R1: 0.0| WTP: 0,0,0.173076923,24,0,0,0,0,0,-2750195780,677377223,11257.8263,2187304465,218730446.5,2,85850,3750,1733,1870,137,1733,85850,137,1870,84.18962433,2.921288014,3.157423971,44513.43828,1253.547406,6.266547406,98845.59213,0.448640904,0.012632092,6.49516E-05,0.073262032,0.021782178,79,24
D:0| T0: 0.17| T1: 24.00| R0: 0.0| R1: 0.0| WTP: 0,0,0.173076923,24,0,0,0,0,0,-2766444151,973583301,11469.72611,2192957846,219295784.6,2,91518,4064,1425,1905,480,1425,91518,480,1905,121.5167464,3.229665072,4.342105263,58110.52392,1775.409091,7.755980861,99193.25359,0.583116439,0.017882283,8.02043E-05,0.251968504,0.020815805,60,24
D:0| T0: 0.17| T1: 24.00| R0: 0.0| R1: 0.0| WTP: 0,0,0.173076923,24,0,0,0,0,0,-2037402907,781062938,1819.595345,1946423140,194642314,1,16669,807,300,302,2,300,16669,2,302,49.28301887,1.254716981,1.264150943,88793.16038,365.2264151,2.693396226,99814.68396,0.889631333,0.003642702,2.83044E-05,0.006622517,0.018117464,31,22
D:0| T0: 0.17| T1: 24.00| R0: 0.0| R1: 0.0| WTP: 0,0,0.173076923,24,0,0,0,0,0,-2741919784,338783425,10941.66265,2194836652,219483665.2,2,94317,4237,985,1817,832,985,94317,832,1817,121.1152074,2.099078341,3.98156682,64411.54378,1775.269585,6.258064516,99383.20507,0.64485103,0.017866272,6.49875E-05,0.457897633,0.01926482,62,24
D:0| T0: 0.17| T1: 24.00| R0: 0.0| R1: 0.0| WTP: 0,0,0.173076923,24,0,0,0,0,0,-1496594806,1027579040,114.3679034,1490876411,149087641.1,1,917,39,19,19,0,19,917,0,19,2.531914894,0.053191489,0.053191489,99416.66489,37.12234043,0.154255319,99988.96809,0.994283973,0.000371146,2.01075E-06,0,0.020765027,26,17
D:0| T0: 0.17| T1: 24.00| R0: 0.0| R1: 0.0| WTP: 0,0,0.173076923,24,0,0,0,0,0,-2765123503,764973813,11475.09367,2191368819,219136881.9,2,91740,4021,1126,1906,780,1126,91740,780,1906,102.1221996,2.15885947,3.718940937,58255.20367,1272.659878,6.016293279,99180.43585,0.58448008,0.012819227,6.21887E-05,0.409233998,0.020776106,70,24
D:0| T0: 0.17| T1: 24.00| R0: 0.0| R1: 0.0| WTP: 0,0,0.173076923,24,0,0,0,0,0,-2793349688,1245753446,12021.96873,2192251251,219225125.1,2,93111,4075,1354,1997,643,1354,93111,643,1997,111.1969027,2.867256637,4.261061947,51131.12389,1410.451327,7.236725664,99004.48894,0.514395698,0.014216283,7.47034E-05,0.321982974,0.02144752,65,24
D:0| T0: 0.17| T1: 24.00| R0: 0.0| R1: 0.0| WTP: 0,0,0.173076923,24,0,0,0,0,0,-2115271545,1013177794,3310.063447,1949768372,194976837.2,1,24433,1013,457,550,93,457,24433,93,550,56.13615023,1.981220657,2.408450704,83444.0892,480.6244131,4.577464789,99656.82629,0.837286831,0.004798261,4.71851E-05,0.169090909,0.022510539,31,22
D:0| T0: 0.17| T1: 24.00| R0: 0.0| R1: 0.0| WTP: 0,0,0.173076923,24,0,0,0,0,0,-1668898538,1395089249,54.31437069,1666182819,166618281.9,1,867,37,9,9,0,9,867,0,9,2.642105263,0.010526316,0.010526316,99400.07895,24.06315789,0.052631579,99994.11053,0.994069425,0.000241844,9.42445E-07,0,0.010380623,28,19
D:0| T0: 0.17| T1: 24.00| R0: 0.0| R1: 0.0| WTP: 0,0,0.173076923,24,0,0,0,0,0,-438852878.3,1339545835,12.01008238,438252374.2,43825237.42,1,66,0,2,2,0,2,66,0,2,0,0,0,99962.31579,4.557894737,0.021052632,99998.72632,0.99963791,4.76049E-05,4.16669E-07,0,0.03030303,14,5
D:0| T0: 0.17| T1: 24.00| R0: 0.0| R1: 0.0| WTP: 0,0,0.173076923,24,0,0,0,0,0,-1803808453,219139554,11410.78146,1233269380,123326938,1,95408,4273,467,1895,1428,467,95408,1428,1895,366.147651,3.060402685,12.57718121,32898,1681.52349,15.7114094,98779.59732,0.331041421,0.016848896,0.000158928,0.753562005,0.019862066,22,13
D:0| T0: 0.17| T1: 24.00| R0: 0.0| R1: 0.0| WTP: 0,0,0.173076923,24,0,0,0,0,0,-1428864147,1336508942,451.6680232,1406280746,140628074.6,1,3698,167,75,75,0,75,3698,0,75,13.33727811,0.284023669,0.284023669,97760.78107,87.67455621,0.75739645,99962.23077,0.977996639,0.00087437,8.82671E-06,0,0.020281233,25,16
D:0| T0: 0.17| T1: 24.00| R0: 0.0| R1: 0.0| WTP: 0,0,0.173076923,24,0,0,0,0,0,-703999557.1,448559423,54.07595311,701295759.4,70129575.94,1,162,4,9,9,0,9,162,0,9,0.434782609,0.017391304,0.017391304,99910.31304,10.29565217,0.095652174,99997.29565,0.999132373,0.000104226,1.55178E-06,0,0.055555556,17,8
D:0| T0: 0.17| T1: 24.00| R0: 0.0| R1: 0.0| WTP: 0,0,0.173076923,24,0,0,0,0,0,-2788774242,2110028840,11973.05706,2190121390,219012139,2,90808,4050,952,1989,1037,952,90808,1037,1989,98.22067594,1.78528827,3.827037773,64038.68787,882.4751491,5.713717694,99264.68986,0.641762654,0.008894619,5.89176E-05,0.521367521,0.021903357,72,24
D:0| T0: 0.17| T1: 24.00| R0: 0.0| R1: 0.0| WTP: 0,0,0.173076923,24,0,0,0,0,0,-2846607182,1982030155,13214.83812,2185865276,218586527.6,2,91057,3724,1044,2196,1152,1044,91057,1152,2196,100.3693305,2.112311015,4.570194384,63836.63931,1299.643629,6.822894168,99187.94816,0.639839371,0.013108961,7.0568E-05,0.524590164,0.024116762,67,24
D:0| T0: 0.17| T1: 24.00| R0: 0.0| R1: 0.0| WTP: 0,0,0.173076923,24,0,0,0,0,0,-2742510131,696219407,11160.62868,2184478697,218447869.7,2,84463,3666,1245,1854,609,1245,84463,609,1854,113.539604,2.891089109,4.371287129,64979.21535,692.799505,7.47029703,99255.43069,0.652619365,0.006978199,7.719E-05,0.328478964,0.02195044,58,24
D:0| T0: 0.17| T1: 24.00| R0: 0.0| R1: 0.0| WTP: 0,0,0.173076923,24,0,0,0,0,0,-1990826146,1402539442,10104.21028,1485615632,148561563.2,1,84628,3787,549,1678,1129,549,84628,1129,1678,283.7705882,3.147058824,9.741176471,44141.80588,2280.270588,12.94117647,99002.20588,0.443936197,0.022846769,0.000131338,0.672824791,0.019827953,25,16
D:0| T0: 0.17| T1: 24.00| R0: 0.0| R1: 0.0| WTP: 0,0,0.173076923,24,0,0,0,0,0,-2170138711,1319833493,10276.86929,1656295247,165629524.7,1,82058,3679,610,1707,1097,610,82058,1097,1707,240.6914894,3.159574468,8.95212766,43550.01596,2947.164894,12.18085106,98943.32447,0.438413347,0.029552063,0.000123649,0.64264792,0.020802359,27,18
D:0| T0: 0.17| T1: 24.00| R0: 0.0| R1: 0.0| WTP: 0,0,0.173076923,24,0,0,0,0,0,-1885052194,663608076,788.3451044,1845634939,184563493.9,1,5676,235,131,131,0,131,5676,0,131,13.57560976,0.502439024,0.502439024,96326.76585,165.702439,1.107317073,99923.73171,0.964032521,0.00165234,1.27265E-05,0,0.023079634,30,21
D:0| T0: 0.17| T1: 24.00| R0: 0.0| R1: 0.0| WTP: 0,0,0.173076923,24,0,0,0,0,0,-2020178004,414696500,72.25827997,2016565090,201656509,1,570,30,12,12,0,12,570,0,12,1.613333333,0.013333333,0.013333333,99633.01333,15.64444444,0.062222222,99993.08889,0.996404208,0.000158106,1.062E-06,0,0.021052632,32,23
D:0| T0: 0.17| T1: 24.00| R0: 0.0| R1: 0.0| WTP: 0,0,0.173076923,24,0,0,0,0,0,-1235681494,1249738535,150.4741011,1228157789,122815778.9,1,990,45,25,25,0,25,990,0,25,3.826086957,0.068322981,0.068322981,99391.55901,24.61490683,0.211180124,99987.7205,0.994045566,0.000246872,3.08678E-06,0,0.025252525,23,14
D:0| T0: 0.17| T1: 24.00| R0: 0.0| R1: 0.0| WTP: 0,0,0.173076923,24,0,0,0,0,0,-2025637172,614415382,168.55095,2017209625,201720962.5,1,1515,57,28,28,0,28,1515,0,28,3.399082569,0.041284404,0.041284404,99080.43119,44.09174312,0.174311927,99984.91284,0.990961812,0.000441702,2.55742E-06,0,0.018481848,32,23
D:0| T0: 0.17| T1: 24.00| R0: 0.0| R1: 0.0| WTP: 0,0,0.173076923,24,0,0,0,0,0,-1667325705,524899953,30.17289825,1665817060,166581706,1,480,28,5,5,0,5,480,0,5,1.458333333,0,0,99673.375,14.23958333,0.026041667,99996.66146,0.996772967,0.00014389,5.18145E-07,0,0.010438413,28,19
D:0| T0: 0.17| T1: 24.00| R0: 0.0| R1: 0.0| WTP: 0,0,0.173076923,24,0,0,0,0,0,-1868528488,1338977757,12660.58602,1235499187,123549918.7,1,98967,4419,403,2103,1700,403,98967,1700,2103,361.6623377,2.545454545,13.53896104,26152.23377,1689.824675,16.16233766,98549.27273,0.263361216,0.016945494,0.000163349,0.808368997,0.021249507,22,13
D:0| T0: 0.17| T1: 24.00| R0: 0.0| R1: 0.0| WTP: 0,0,0.173076923,24,0,0,0,0,0,-2171611986,341384587,10377.79317,1652722327,165272232.7,1,78975,3373,518,1724,1206,518,78975,1206,1724,230.9679144,2.695187166,9.096256684,43613.90909,1431.032086,11.86631016,98861.60428,0.439601863,0.01434678,0.000120265,0.699535963,0.021829693,27,18
D:0| T0: 0.17| T1: 24.00| R0: 0.0| R1: 0.0| WTP: 0,0,0.173076923,24,0,0,0,0,0,-2796576413,2032000160,12141.13989,2189519418,218951941.8,2,89929,3940,1264,2017,753,1264,89929,753,2017,107.7389381,2.634955752,4.272123894,60767.78097,1348.323009,7.066371681,99175.68584,0.609698776,0.013590757,7.31314E-05,0.373326723,0.022428805,65,24
D:0| T0: 0.17| T1: 24.00| R0: 0.0| R1: 0.0| WTP: 0,0,0.173076923,24,0,0,0,0,0,-2311998142,779488939,9722.511255,1825872580,182587258,1,76020,3316,566,1615,1049,566,76020,1049,1615,207.7821782,2.683168317,7.811881188,47341.05446,1430.034653,10.63861386,98974.18812,0.47678371,0.014336003,0.000108321,0.649535604,0.021244409,29,20
D:0| T0: 0.17| T1: 24.00| R0: 0.0| R1: 0.0| WTP: 0,0,0.173076923,24,0,0,0,0,0,-2796274720,1449019578,12235.50159,2184499640,218449964,2,86555,3703,1010,2033,1023,1010,86555,1023,2033,90.66007905,1.873517787,3.865612648,70545.62451,1068.031621,5.869565217,99358.64032,0.70670328,0.010765497,6.06231E-05,0.503197245,0.023487956,72,24
D:0| T0: 0.17| T1: 24.00| R0: 0.0| R1: 0.0| WTP: 0,0,0.173076923,24,0,0,0,0,0,-1231066491,351952211,66.26538164,1227753222,122775322.2,1,521,28,11,11,0,11,521,0,11,2.541935484,0.006451613,0.006451613,99682.72903,14.9483871,0.096774194,99994.78065,0.996884685,0.000151096,1.41033E-06,0,0.021113244,23,14
D:0| T0: 0.17| T1: 24.00| R0: 0.0| R1: 0.0| WTP: 0,0,0.173076923,24,0,0,0,0,0,-1493321373,486595046,60.13217012,1490314765,149031476.5,1,385,16,10,10,0,10,385,0,10,0.798969072,0,0,99792.07732,15.70103093,0.051546392,99995.45876,0.997968414,0.000158418,1.02569E-06,0,0.026041667,26,17
D:0| T0: 0.17| T1: 24.00| R0: 0.0| R1: 0.0| WTP: 0,0,0.173076923,24,0,0,0,0,0,-2037782249,296745624,4954.595422,1790052477,179005247.7,1,39226,1736,481,823,342,481,39226,342,823,107.213198,2.294416244,4.005076142,73475.38579,975.6294416,6.446700508,99485.8731,0.738318974,0.00974749,6.6131E-05,0.415552855,0.020980982,29,20
D:0| T0: 0.17| T1: 24.00| R0: 0.0| R1: 0.0| WTP: 0,0,0.173076923,24,0,0,0,0,0,-1689278952,1671484194,409.4919052,1668804357,166880435.7,1,3384,161,68,68,0,68,3384,0,68,10.31606218,0.243523316,0.243523316,97859.04145,89.84974093,0.606217617,99960.7772,0.978995441,0.000896637,7.0126E-06,0,0.020106446,28,19
D:0| T0: 0.17| T1: 24.00| R0: 0.0| R1: 0.0| WTP: 0,0,0.173076923,24,0,0,0,0,0,-2177830809,422157396,11879.18551,1583871533,158387153.3,1,98334,4369,476,1973,1497,476,98334,1497,1973,303.9050279,2.592178771,10.92178771,26113.46927,2049.960894,13.58100559,98631.15642,0.262861855,0.020571472,0.000137384,0.758743031,0.020064271,26,17
D:0| T0: 0.17| T1: 24.00| R0: 0.0| R1: 0.0| WTP: 0,0,0.173076923,24,0,0,0,0,0,-1963423376,1916599091,12816.58979,1322593886,132259388.6,1,98431,4258,447,2129,1682,447,98431,1682,2129,350.1329114,2.753164557,13.34810127,27640.51899,2168.949367,16.1835443,98569.12025,0.278220405,0.021755487,0.000163717,0.790042273,0.021629365,23,14
D:0| T0: 0.17| T1: 24.00| R0: 0.0| R1: 0.0| WTP: 0,0,0.173076923,24,0,0,0,0,0,-1846254200,1005953941,12216.23243,1235442578,123544257.8,1,98342,4312,495,2029,1534,495,98342,1534,2029,368.8013245,3.225165563,13.32450331,30384.56954,2637.046358,16.58940397,98711.46358,0.305556772,0.026435801,0.000167715,0.756037457,0.02063208,22,13
D:0| T0: 0.17| T1: 24.00| R0: 0.0| R1: 0.0| WTP: 0,0,0.173076923,24,0,0,0,0,0,-1922051942,1422765615,12241.99292,1309952296,130995229.6,1,88872,3789,548,2034,1486,548,88872,1486,2034,297.05,3.31875,12.5375,40028.55,1926.55,16.00625,98767.19375,0.402835345,0.019329845,0.000161992,0.730580138,0.022886849,23,14
D:0| T0: 0.17| T1: 24.00| R0: 0.0| R1: 0.0| WTP: 0,0,0.173076923,24,0,0,0,0,0,-1141173493,699740192,30.09482132,1139668752,113966875.2,1,339,16,5,5,0,5,339,0,5,0.805194805,0.012987013,0.012987013,99795.20779,13.00649351,0.045454545,99997.74026,0.997978703,0.000131615,6.45172E-07,0,0.014749263,22,13
D:0| T0: 0.17| T1: 24.00| R0: 0.0| R1: 0.0| WTP: 0,0,0.173076923,24,0,0,0,0,0,-877077009.2,240885764,6.0931291,876772352.8,87677235.28,1,99,9,1,1,0,1,99,0,1,1.3046875,0,0,99939.54688,3.9609375,0.0078125,99999.63281,0.999401857,4.1628E-05,1.55039E-07,0,0.01010101,19,10
D:0| T0: 0.17| T1: 24.00| R0: 0.0| R1: 0.0| WTP: 0,0,0.173076923,24,0,0,0,0,0,-1751226524,2023806564,7473.239389,1377564554,137756455.4,1,64820,2923,579,1241,662,579,64820,662,1241,217.0898204,3.335329341,7.251497006,57969.91018,1628.628743,10.71856287,99283.88024,0.582960091,0.016284955,0.000109006,0.533440774,0.019145326,24,15
D:0| T0: 0.17| T1: 24.00| R0: 0.0| R1: 0.0| WTP: 0,0,0.173076923,24,0,0,0,0,0,-1409573787,1907493879,132.2933622,1402959119,140295911.9,1,938,34,22,22,0,22,938,0,22,1.761363636,0.051136364,0.051136364,99451.4375,32.5625,0.176136364,99987.76705,0.994641665,0.000326367,2.48613E-06,0,0.023454158,25,16
D:0| T0: 0.17| T1: 24.00| R0: 0.0| R1: 0.0| WTP: 0,0,0.173076923,24,0,0,0,0,0,-2765830764,1565815291,11581.69993,2186745768,218674576.8,2,90633,3852,1199,1924,725,1199,90633,725,1924,111.3160377,2.643867925,4.316037736,62326.27123,1723.061321,7.141509434,99258.71698,0.624986967,0.017355783,7.416E-05,0.376819127,0.021228471,61,24
D:0| T0: 0.17| T1: 24.00| R0: 0.0| R1: 0.0| WTP: 0,0,0.173076923,24,0,0,0,0,0,-1772682733,784442364,343.1211169,1755526677,175552667.7,1,2611,121,57,57,0,57,2611,0,57,7.09223301,0.145631068,0.145631068,98276.67476,65.99029126,0.412621359,99967.82039,0.983102311,0.000659235,5.50875E-06,0,0.021830716,29,20
D:0| T0: 0.17| T1: 24.00| R0: 0.0| R1: 0.0| WTP: 0,0,0.173076923,24,0,0,0,0,0,-2026022510,206369745,9224.662745,1564789373,156478937.3,1,76953,3443,550,1532,982,550,76953,982,1532,238.8176796,2.928176796,8.303867403,48480.9116,1774.883978,11.3480663,99067.62431,0.487857087,0.017778876,0.00011528,0.640992167,0.019908256,26,17
D:0| T0: 0.17| T1: 24.00| R0: 0.0| R1: 0.0| WTP: 0,0,0.173076923,24,0,0,0,0,0,-2169931348,2087235992,11811.70151,1579346272,157934627.2,1,94449,4081,555,1962,1407,555,94449,1407,1962,284.9779006,2.983425414,10.68508287,32573.52486,2271.955801,13.75138122,98736.20994,0.327710743,0.022793562,0.00013965,0.717125382,0.020773116,26,17
D:0| T0: 0.17| T1: 24.00| R0: 0.0| R1: 0.0| WTP: 0,0,0.173076923,24,0,0,0,0,0,-2150595225,1019092536,795.0901621,2110840717,211084071.7,2,7491,319,132,132,0,132,7491,0,132,17.43096234,0.451882845,0.451882845,94822.01255,174.7866109,0.970711297,99914.64435,0.949074813,0.001744423,1.1007E-05,0,0.017621145,35,24
D:0| T0: 0.17| T1: 24.00| R0: 0.0| R1: 0.0| WTP: 0,0,0.173076923,24,0,0,0,0,0,-2661337178,1885906113,9734.145796,2174629888,217462988.8,2,77326,3289,1209,1617,408,1209,77326,408,1617,81.38945233,2.324543611,3.129817444,64617.72414,478.8539554,5.567951318,99291.61663,0.649375443,0.004818977,5.7657E-05,0.252319109,0.020911466,71,24
D:0| T0: 0.17| T1: 24.00| R0: 0.0| R1: 0.0| WTP: 0,0,0.173076923,24,0,0,0,0,0,-1475893206,2028637200,1264.513638,1412667524,141266752.4,1,11082,498,207,210,3,207,11082,3,210,33.42528736,1.051724138,1.063218391,92742.43678,248.8793103,2.229885057,99875.66667,0.928634903,0.002479365,2.38523E-05,0.014285714,0.018951358,25,16
D:0| T0: 0.17| T1: 24.00| R0: 0.0| R1: 0.0| WTP: 0,0,0.173076923,24,0,0,0,0,0,-2193661260,181476086,10709.8204,1658170240,165817024,1,86739,3824,537,1779,1242,537,86739,1242,1779,249.2956989,2.806451613,9.424731183,39414.52688,2185.919355,12.32258065,98865.46237,0.396737754,0.021924178,0.000124957,0.698145025,0.020509805,27,18
D:0| T0: 0.17| T1: 24.00| R0: 0.0| R1: 0.0| WTP: 0,0,0.173076923,24,0,0,0,0,0,-2203342319,2097578470,10842.9697,1661193834,166119383.4,1,85558,3814,584,1801,1217,584,85558,1217,1801,259.1290323,3.059139785,9.548387097,40090.06452,2490.709677,12.67204301,98856.64516,0.403672229,0.024981195,0.000128687,0.675735702,0.021050048,27,18
D:0| T0: 0.17| T1: 24.00| R0: 0.0| R1: 0.0| WTP: 0,0,0.173076923,24,0,0,0,0,0,-2763893014,119646392,11551.49577,2186318225,218631822.5,2,86996,3744,1056,1919,863,1056,86996,863,1919,103.8325991,2.162995595,4.026431718,66378.90749,1207.006608,6.350220264,99307.51322,0.665207821,0.012159883,6.59969E-05,0.449713392,0.022058485,65,24
D:0| T0: 0.17| T1: 24.00| R0: 0.0| R1: 0.0| WTP: 0,0,0.173076923,24,0,0,0,0,0,-1822268896,1298895859,11824.44223,1231046784,123104678.4,1,95331,4196,512,1964,1452,512,95331,1452,1964,353.56,3.333333333,12.93333333,35246.99333,2644.933333,16.35333333,98804.68,0.354356787,0.026513078,0.000165562,0.739307536,0.020601903,22,13
D:0| T0: 0.17| T1: 24.00| R0: 0.0| R1: 0.0| WTP: 0,0,0.173076923,24,0,0,0,0,0,-2537887848,1489316290,10625.0589,2006634903,200663490.3,1,82534,3668,529,1765,1236,529,82534,1236,1765,211.7887324,2.403755869,8.154929577,38400.00469,1348.258216,10.63849765,98764.79343,0.387276667,0.013528474,0.000108127,0.700283286,0.021385126,31,22
D:0| T0: 0.17| T1: 24.00| R0: 0.0| R1: 0.0| WTP: 0,0,0.173076923,24,0,0,0,0,0,-2717563507,855602142,14009.49354,2017088830,201708883,1,96194,3955,472,2328,1856,472,96194,1856,2328,236.6604651,2.153488372,10.74883721,26336.70233,1594.795349,12.94418605,98322.34419,0.265324005,0.016043383,0.000131127,0.797250859,0.024201094,31,22
D:0| T0: 0.17| T1: 24.00| R0: 0.0| R1: 0.0| WTP: 0,0,0.173076923,24,0,0,0,0,0,-2290824425,1438649896,3304.247164,2125612066,212561206.6,1,24979,1036,479,549,70,479,24979,70,549,52.61373391,1.922746781,2.210300429,83049.94421,545.1287554,4.244635193,99662.40773,0.833268084,0.005443653,4.40512E-05,0.127504554,0.021978462,33,24
D:0| T0: 0.17| T1: 24.00| R0: 0.0| R1: 0.0| WTP: 0,0,0.173076923,24,0,0,0,0,0,-1667490841,952489126,36.13731856,1665683975,166568397.5,1,393,13,6,6,0,6,393,0,6,1.036458333,0.005208333,0.005208333,99749.71354,16.3125,0.03125,99997.29688,0.997528192,0.000164252,6.21777E-07,0,0.015267176,28,19
D:0| T0: 0.17| T1: 24.00| R0: 0.0| R1: 0.0| WTP: 0,0,0.173076923,24,0,0,0,0,0,-1687488373,1550779155,12652.83926,1054846410,105484641,1,99140,4210,405,2102,1697,405,99140,1697,2102,388.0444444,2.925925926,15.45185185,25772.78519,2053.718519,18.45185185,98562.6,0.259796048,0.020577355,0.00018625,0.807326356,0.02120234,20,11
D:0| T0: 0.17| T1: 24.00| R0: 0.0| R1: 0.0| WTP: 0,0,0.173076923,24,0,0,0,0,0,-1584538183,607323321,120.3671534,1578519826,157851982.6,1,958,46,20,20,0,20,958,0,20,2.515957447,0.042553191,0.042553191,99350.77128,24.48404255,0.138297872,99988.26596,0.993634788,0.000245896,2.1166E-06,0,0.019832985,27,18
D:0| T0: 0.17| T1: 24.00| R0: 0.0| R1: 0.0| WTP: 0,0,0.173076923,24,0,0,0,0,0,-1763967924,2103646485,6320.595797,1447938134,144793813.4,1,48476,2088,518,1050,532,518,48476,532,1050,152.8176471,2.923529412,6.017647059,68788.1,861.6882353,9.047058824,99382.15294,0.691607142,0.008609496,9.21735E-05,0.506666667,0.021660203,25,16
D:0| T0: 0.17| T1: 24.00| R0: 0.0| R1: 0.0| WTP: 0,0,0.173076923,24,0,0,0,0,0,-1967351175,258120157,11146.97866,1410002242,141000224.2,1,97711,4438,441,1851,1410,441,97711,1410,1851,336.3151515,2.6,11.09090909,25085.55152,1505.909091,13.77575758,98682.07273,0.25287235,0.015096437,0.000139335,0.761750405,0.018943619,24,15
D:0| T0: 0.17| T1: 24.00| R0: 0.0| R1: 0.0| WTP: 0,0,0.173076923,24,0,0,0,0,0,-1881549754,1068951401,674.9467064,1847802418,184780241.8,1,6848,326,112,112,0,112,6848,0,112,19.8708134,0.435406699,0.435406699,95174.23445,127.6172249,0.976076555,99927.33971,0.952488261,0.001272629,1.06723E-05,0,0.01635514,30,21
D:0| T0: 0.17| T1: 24.00| R0: 0.0| R1: 0.0| WTP: 0,0,0.173076923,24,0,0,0,0,0,-2746773051,635956235,11209.17804,2186314149,218631414.9,2,86156,3769,992,1862,870,992,86156,870,1862,94.27944112,1.878243513,3.578842315,69813.94611,1297.185629,5.558882236,99406.26747,0.699099079,0.013061888,5.73808E-05,0.467239527,0.02161196,71,24
D:0| T0: 0.17| T1: 24.00| R0: 0.0| R1: 0.0| WTP: 0,0,0.173076923,24,0,0,0,0,0,-1056481164,1346693470,78.31500247,1052565414,105256541.4,1,830,35,13,13,0,13,830,0,13,3.167832168,0.034965035,0.034965035,99510.42657,29.68531469,0.104895105,99993.27972,0.995177696,0.00029731,1.80566E-06,0,0.015662651,21,12
D:0| T0: 0.17| T1: 24.00| R0: 0.0| R1: 0.0| WTP: 0,0,0.173076923,24,0,0,0,0,0,-2053644038,847102011,12959.21789,1405683144,140568314.4,1,98233,4205,472,2153,1681,472,98233,1681,2153,319.4573171,2.817073171,13,28185.04878,2044.310976,15.8597561,98563.80488,0.283633893,0.020520756,0.000160784,0.780771017,0.021917278,24,15
D:0| T0: 0.17| T1: 24.00| R0: 0.0| R1: 0.0| WTP: 0,0,0.173076923,24,0,0,0,0,0,-2791524702,812083272,12157.47531,2183650937,218365093.7,2,88006,3532,1758,2020,262,1758,88006,262,2020,96.48051948,3.616883117,4.16017316,51161.03247,1162.348485,7.989177489,98931.38095,0.514788209,0.011718027,8.24099E-05,0.12970297,0.02295298,66,24
D:0| T0: 0.17| T1: 24.00| R0: 0.0| R1: 0.0| WTP: 0,0,0.173076923,24,0,0,0,0,0,-2173799732,2146825809,11771.51154,1585224155,158522415.5,1,98874,4500,465,1955,1490,465,98874,1490,1955,310.3202247,2.556179775,10.8988764,22618.65169,1755.179775,13.51123596,98579.26404,0.228024452,0.017605376,0.000136496,0.762148338,0.01977264,26,17
D:0| T0: 0.17| T1: 24.00| R0: 0.0| R1: 0.0| WTP: 0,0,0.173076923,24,0,0,0,0,0,-2049126291,226186520,12851.40519,1406556032,140655603.2,1,97214,4231,468,2135,1667,468,97214,1667,2135,315.2619048,2.726190476,12.57738095,29346.85714,1687.755952,15.35714286,98566.32143,0.29534006,0.016944885,0.00015565,0.780796253,0.021961857,24,15
D:0| T0: 0.17| T1: 24.00| R0: 0.0| R1: 0.0| WTP: 0,0,0.173076923,24,0,0,0,0,0,-2789389563,1110225441,11926.23844,2193077641,219307764.1,2,91564,4008,1540,1981,441,1540,91564,441,1981,114.3024831,3.318284424,4.282167043,55086.71783,1597.889391,7.758465011,99092.96163,0.552934194,0.016104175,8.00621E-05,0.222614841,0.02163514,64,24
D:0| T0: 0.17| T1: 24.00| R0: 0.0| R1: 0.0| WTP: 0,0,0.173076923,24,0,0,0,0,0,-2698209756,1190767082,10106.38045,2192890734,219289073.4,2,92163,4127,1176,1678,502,1176,92163,502,1678,115.5765766,2.5,3.608108108,57405.90541,1109.603604,6.261261261,99272.99099,0.576217524,0.011164402,6.46488E-05,0.299165673,0.018206873,64,24
D:0| T0: 0.17| T1: 24.00| R0: 0.0| R1: 0.0| WTP: 0,0,0.173076923,24,0,0,0,0,0,-2049038391,2108234095,589.7016078,2019553310,201955331,1,3816,156,98,98,0,98,3816,0,98,9.366972477,0.28440367,0.28440367,97486.00917,107.4311927,0.747706422,99940.77523,0.975460291,0.001072089,8.95402E-06,0,0.025681342,32,23
D:0| T0: 0.17| T1: 24.00| R0: 0.0| R1: 0.0| WTP: 0,0,0.173076923,24,0,0,0,0,0,-2062506633,465621985,13044.7896,1410267153,141026715.3,1,98735,4381,480,2167,1687,480,98735,1687,2167,334.5272727,2.83030303,13.01212121,26112.41818,2058.369697,15.90909091,98516.55758,0.262930085,0.020662792,0.000161171,0.778495616,0.021947638,24,15
D:0| T0: 0.17| T1: 24.00| R0: 0.0| R1: 0.0| WTP: 0,0,0.173076923,24,0,0,0,0,0,-1470907198,1487072553,1168.372375,1412488579,141248857.9,1,11183,472,192,194,2,192,11183,2,194,33.1849711,1,1.011560694,93079.32948,235.1213873,2.115606936,99890.27746,0.931853345,0.00234256,2.22045E-05,0.010309278,0.017350863,25,16
D:0| T0: 0.17| T1: 24.00| R0: 0.0| R1: 0.0| WTP: 0,0,0.173076923,24,0,0,0,0,0,-2723864870,1213733847,10918.3731,2177946214,217794621.4,2,80497,3413,1473,1814,341,1473,80497,341,1814,71.41166381,2.387650086,2.939965695,54551.30703,582.8867925,5.471698113,99031.53002,0.549606165,0.005872662,5.68061E-05,0.188086045,0.022522578,84,24
D:0| T0: 0.17| T1: 24.00| R0: 0.0| R1: 0.0| WTP: 0,0,0.173076923,24,0,0,0,0,0,-2439584878,2003658337,5922.419548,2143463901,214346390.1,2,44748,1879,596,984,388,596,44748,388,984,90.98785425,2.311740891,3.862348178,67670.89474,734.1012146,6.271255061,99330.82591,0.680937101,0.007347291,6.40309E-05,0.394308943,0.02198981,36,24
D:0| T0: 0.17| T1: 24.00| R0: 0.0| R1: 0.0| WTP: 0,0,0.173076923,24,0,0,0,0,0,-1056628393,1170868072,84.26888432,1052414949,105241494.9,1,737,34,14,14,0,14,737,0,14,2.5,0.027777778,0.027777778,99553.38889,29.02777778,0.111111111,99993.40972,0.995606114,0.000290569,1.93116E-06,0,0.018995929,21,12
D:0| T0: 0.17| T1: 24.00| R0: 0.0| R1: 0.0| WTP: 0,0,0.173076923,24,0,0,0,0,0,-2356850640,569919592,11915.80294,1761060493,176106049.3,1,99253,4499,426,1979,1553,426,99253,1553,1979,291.0471204,2.178010471,10.28272251,19861.66492,1353.65445,12.51308901,98501.8377,0.200403918,0.013586368,0.000126488,0.784739768,0.019938944,28,19
D:0| T0: 0.17| T1: 24.00| R0: 0.0| R1: 0.0| WTP: 0,0,0.173076923,24,0,0,0,0,0,-2101805493,1833180623,4362.033463,1883703819,188370381.9,1,40935,1924,502,724,222,502,40935,222,724,121.7902439,2.292682927,3.336585366,71794.22927,925.3512195,5.795121951,99541.13171,0.721111564,0.009242055,5.97295E-05,0.306629834,0.017686576,30,21
D:0| T0: 0.17| T1: 24.00| R0: 0.0| R1: 0.0| WTP: 0,0,0.173076923,24,0,0,0,0,0,-2250428039,1123666637,13397.49232,1580553424,158055342.4,1,97045,4088,484,2226,1742,484,97045,1742,2226,292.4382022,2.646067416,12.37640449,26979.19101,1643.123596,15.08988764,98445.79213,0.271790086,0.016507599,0.000153066,0.782569632,0.022937812,26,17
D:0| T0: 0.17| T1: 24.00| R0: 0.0| R1: 0.0| WTP: 0,0,0.173076923,24,0,0,0,0,0,-2624963064,1682024981,9030.975062,2173414311,217341431.1,2,71675,3165,735,1500,765,735,71675,765,1500,166.8791667,2.966666667,6.091666667,50887.08333,2447.845833,9.158333333,99065.55417,0.512325728,0.024550112,9.34585E-05,0.51,0.020927799,34,24
D:0| T0: 0.17| T1: 24.00| R0: 0.0| R1: 0.0| WTP: 0,0,0.173076923,24,0,0,0,0,0,-2778190754,1687523543,11768.81378,2189750065,218975006.5,2,91062,3912,1060,1955,895,1060,91062,895,1955,117.3389021,2.374701671,4.486873508,65007.09069,829.0381862,7.019093079,99304.01909,0.651737209,0.008351581,7.24511E-05,0.457800512,0.021468889,60,24
D:0| T0: 0.17| T1: 24.00| R0: 0.0| R1: 0.0| WTP: 0,0,0.173076923,24,0,0,0,0,0,-2098517827,178034412,12141.87123,1491424265,149142426.5,1,94595,4091,473,2017,1544,473,94595,1544,2017,302.4882353,2.705882353,11.71176471,32179.84706,1957.470588,14.5,98671.00588,0.323884412,0.01964123,0.000147066,0.765493307,0.02132248,25,16
D:0| T0: 0.17| T1: 24.00| R0: 0.0| R1: 0.0| WTP: 0,0,0.173076923,24,0,0,0,0,0,-1965558549,739490003,11252.80218,1402918440,140291844,1,93004,4063,472,1869,1397,472,93004,1397,1869,315.3580247,2.858024691,11.41358025,35432.75926,1602.95679,14.30864198,98812.0679,0.356447524,0.016067527,0.000144941,0.747458534,0.02009591,24,15
D:0| T0: 0.17| T1: 24.00| R0: 0.0| R1: 0.0| WTP: 0,0,0.173076923,24,0,0,0,0,0,-1973734689,178482706,8510.628926,1548203243,154820324.3,1,63172,2774,540,1414,874,540,63172,874,1414,187.3446328,2.95480226,7.836158192,57986.71186,1529.644068,10.87570621,99144.86441,0.58376196,0.01531079,0.000110547,0.618104668,0.022383334,26,17
D:0| T0: 0.17| T1: 24.00| R0: 0.0| R1: 0.0| WTP: 0,0,0.173076923,24,0,0,0,0,0,-2022576101,1919366370,3196.185014,1862766851,186276685.1,1,24018,1000,446,531,85,446,24018,85,531,59.85990338,2.033816425,2.429951691,84146.29469,401.7487923,4.599033816,99674.77295,0.844168403,0.004010565,4.70942E-05,0.16007533,0.022109339,30,21
D:0| T0: 0.17| T1: 24.00| R0: 0.0| R1: 0.0| WTP: 0,0,0.173076923,24,0,0,0,0,0,-1981487002,1819796913,11429.23864,1410025070,141002507,1,97451,4460,447,1898,1451,447,97451,1451,1898,331.8562874,2.622754491,11.25149701,29956.10778,2402.502994,13.91616766,98757.13174,0.301268217,0.024087167,0.000140892,0.764488936,0.019476455,24,15
D:0| T0: 0.17| T1: 24.00| R0: 0.0| R1: 0.0| WTP: 0,0,0.173076923,24,0,0,0,0,0,-2843040096,1866591913,12983.18585,2193880804,219388080.4,2,95558,4138,948,2157,1209,948,95558,1209,2157,124.7893462,2.147699758,5.04842615,64474.35109,1901.48184,7.343825666,99281.45036,0.64533901,0.019167421,7.57847E-05,0.560500695,0.022572678,59,24
D:0| T0: 0.17| T1: 24.00| R0: 0.0| R1: 0.0| WTP: 0,0,0.173076923,24,0,0,0,0,0,-1854053111,1219425989,12401.84865,1233960679,123396067.9,1,99237,4466,445,2060,1615,445,99237,1615,2060,367.2281879,2.899328859,13.69798658,25378.61074,1725.073826,16.67785235,98582.61074,0.255690659,0.017298075,0.000168699,0.783980583,0.020758386,22,13
D:0| T0: 0.17| T1: 24.00| R0: 0.0| R1: 0.0| WTP: 0,0,0.173076923,24,0,0,0,0,0,-2081001749,502409586,11734.42741,1494280379,149428037.9,1,97438,4267,475,1949,1474,475,97438,1474,1949,306.0287356,2.655172414,11.08045977,28094.3908,2257.413793,13.83333333,98682,0.282737,0.022643698,0.00013985,0.756285274,0.020002463,25,16
D:0| T0: 0.17| T1: 24.00| R0: 0.0| R1: 0.0| WTP: 0,0,0.173076923,24,0,0,0,0,0,-1956592972,1405887957,9608.669848,1476159480,147615948,1,76415,3438,512,1596,1084,512,76415,1084,1596,251.7869822,2.940828402,9.313609467,49101.85207,1371.710059,12.32544379,99030.04142,0.494238164,0.013737337,0.000124981,0.679197995,0.020885952,25,16
D:0| T0: 0.17| T1: 24.00| R0: 0.0| R1: 0.0| WTP: 0,0,0.173076923,24,0,0,0,0,0,-2094420002,283033753,12288.32318,1480003843,148000384.3,1,87277,3583,531,2042,1511,531,87277,1511,2042,255.9884393,2.994219653,11.67052023,38554.0578,1341.491329,14.74566474,98675.24855,0.388482073,0.013467474,0.000149366,0.739960823,0.023396771,25,16
D:0| T0: 0.17| T1: 24.00| R0: 0.0| R1: 0.0| WTP: 0,0,0.173076923,24,0,0,0,0,0,-2442906241,1083157068,5947.128611,2145549811,214554981.1,1,44084,1891,611,988,377,611,44084,377,988,104.8193833,2.528634361,4.158590308,68445.04405,986.5770925,6.889867841,99350.94714,0.688615203,0.009869687,7.0484E-05,0.381578947,0.022411759,33,24
D:0| T0: 0.17| T1: 24.00| R0: 0.0| R1: 0.0| WTP: 0,0,0.173076923,24,0,0,0,0,0,-2195326163,1988704626,3189.468904,2035852718,203585271.8,1,21682,887,470,530,60,470,21682,60,530,49.40358744,1.97309417,2.228699552,85041.75785,249.4080717,4.340807175,99658.37668,0.853324847,0.002491796,4.47597E-05,0.113207547,0.02444875,32,23
D:0| T0: 0.17| T1: 24.00| R0: 0.0| R1: 0.0| WTP: 0,0,0.173076923,24,0,0,0,0,0,-1782919123,884761309,12743.97338,1145720455,114572045.5,1,99069,4387,436,2117,1681,436,99069,1681,2117,369.3673469,2.911564626,14.29251701,24302.81633,1752.081633,17.2585034,98511.2381,0.245066138,0.017571463,0.00017431,0.794048181,0.021368945,21,12
D:0| T0: 0.17| T1: 24.00| R0: 0.0| R1: 0.0| WTP: 0,0,0.173076923,24,0,0,0,0,0,-1357033682,533485933,716.7577695,1321195794,132119579.4,1,6560,306,119,119,0,119,6560,0,119,22.79012346,0.617283951,0.617283951,95949.82099,110.5246914,1.351851852,99933.99383,0.960166,0.001101319,1.46094E-05,0,0.018140244,24,15
D:0| T0: 0.17| T1: 24.00| R0: 0.0| R1: 0.0| WTP: 0,0,0.173076923,24,0,0,0,0,0,-1541710028,632196071,897.0507331,1496857491,149685749.1,1,7021,309,148,149,1,148,7021,1,149,21.58988764,0.724719101,0.730337079,95478.35393,102.4719101,1.584269663,99911.10674,0.955671149,0.001022034,1.66039E-05,0.006711409,0.021222048,26,17
D:0| T0: 0.17| T1: 24.00| R0: 0.0| R1: 0.0| WTP: 0,0,0.173076923,24,0,0,0,0,0,-2132995666,393400457,12797.00807,1493145262,149314526.2,1,96342,4175,447,2126,1679,447,96342,1679,2126,304.3430233,2.540697674,12.26162791,30650.72093,1753.767442,14.8372093,98579.56395,0.30840584,0.017605094,0.000150281,0.789746002,0.022067219,25,16
D:0| T0: 0.17| T1: 24.00| R0: 0.0| R1: 0.0| WTP: 0,0,0.173076923,24,0,0,0,0,0,-1929437168,398973227,10756.71502,1391601417,139160141.7,1,82399,3546,541,1787,1246,541,82399,1246,1787,262.9107143,3.136904762,10.48809524,44001.22024,1467.214286,13.69642857,98895.46429,0.443037157,0.014703408,0.000138964,0.697257974,0.021687156,24,15
D:0| T0: 0.17| T1: 24.00| R0: 0.0| R1: 0.0| WTP: 0,0,0.173076923,24,0,0,0,0,0,-2734150093,1402256491,10969.02801,2185698693,218569869.3,2,85451,3753,1692,1822,130,1692,85451,130,1822,91.16798419,3.171936759,3.420948617,49155.98617,1071.304348,6.754940711,98966.42885,0.494932213,0.010791,6.99391E-05,0.071350165,0.021322161,73,24
D:0| T0: 0.17| T1: 24.00| R0: 0.0| R1: 0.0| WTP: 0,0,0.173076923,24,0,0,0,0,0,-2499058230,2102527413,9944.961666,2001810146,200181014.6,1,75044,3333,654,1652,998,654,75044,998,1652,199.9952607,3,7.696682464,47394.36019,2057.260664,10.81042654,98944.08531,0.4775157,0.020634822,0.00010969,0.604116223,0.022013752,31,22
D:0| T0: 0.17| T1: 24.00| R0: 0.0| R1: 0.0| WTP: 0,0,0.173076923,24,0,0,0,0,0,-2223863970,1748031099,11322.31507,1657748216,165774821.6,1,84820,3584,627,1881,1254,627,84820,1254,1881,249.6793478,3.331521739,10.09782609,42318.53804,2486.804348,13.48369565,98840.16304,0.42603791,0.024958767,0.000136848,0.666666667,0.022176373,27,18
D:0| T0: 0.17| T1: 24.00| R0: 0.0| R1: 0.0| WTP: 0,0,0.173076923,24,0,0,0,0,0,-2722140854,1946754629,10746.23698,2184829005,218482900.5,2,87010,3761,911,1785,874,911,87010,874,1785,104.972912,1.934537246,3.878103837,70188.22573,755.9074492,5.939051919,99422.1535,0.703267445,0.007610702,6.12415E-05,0.489635854,0.020514883,64,24
D:0| T0: 0.17| T1: 24.00| R0: 0.0| R1: 0.0| WTP: 0,0,0.173076923,24,0,0,0,0,0,-2053296278,2097712204,2149.705652,1945810995,194581099.5,1,17589,805,348,357,9,348,17589,9,357,45.97222222,1.444444444,1.49537037,88200.31481,251.962963,3.111111111,99778.14815,0.883997055,0.002514567,3.25451E-05,0.025210084,0.020296776,31,22
D:0| T0: 0.17| T1: 24.00| R0: 0.0| R1: 0.0| WTP: 0,0,0.173076923,24,0,0,0,0,0,-2743972043,1198827119,11190.55008,2184444539,218444453.9,2,84675,3650,949,1859,910,949,84675,910,1859,94.35582822,1.844580777,3.676891616,72103.89571,1108.010225,5.615541922,99435.70143,0.721951775,0.011159686,5.78359E-05,0.48951049,0.021954532,70,24
D:0| T0: 0.17| T1: 24.00| R0: 0.0| R1: 0.0| WTP: 0,0,0.173076923,24,0,0,0,0,0,-1404184043,109253198,30.1143433,1402678326,140267832.6,1,294,12,5,5,0,5,294,0,5,0.91160221,0.005524862,0.005524862,99818.67956,11.40331492,0.027624309,99997,0.998220311,0.000115882,5.49461E-07,0,0.017064846,25,16
D:0| T0: 0.17| T1: 24.00| R0: 0.0| R1: 0.0| WTP: 0,0,0.173076923,24,0,0,0,0,0,-1438170899,314481292,614.2164209,1407460078,140746007.8,1,4927,215,102,102,0,102,4927,0,102,17.11242604,0.49704142,0.49704142,96855.05917,87.1183432,1.100591716,99941.61538,0.969148319,0.000868848,1.20058E-05,0,0.020702253,25,16
D:0| T0: 0.17| T1: 28.00| R0: 0.0| R1: 0.0| WTP: 0,0,0.173076923,28,0,0,0,0,0,-1491858231,1178568022,30.12067847,1490352197,149035219.7,1,312,15,5,5,0,5,312,0,5,0.978378378,0,0,99803.43784,8.740540541,0.027027027,99996.95676,0.998068409,8.91422E-05,5.37645E-07,0,0.01607717,26,17
D:0| T0: 0.17| T1: 28.00| R0: 0.0| R1: 0.0| WTP: 0,0,0.173076923,28,0,0,0,0,0,-1906711473,2029998696,11746.56513,1319383216,131938321.6,1,95757,4310,471,1951,1480,471,95757,1480,1951,338.5,2.917721519,12.23417722,34133.97468,2047.259494,15.20253165,98787.36076,0.343134047,0.020521127,0.000153792,0.758585341,0.02037449,23,14
D:0| T0: 0.17| T1: 28.00| R0: 0.0| R1: 0.0| WTP: 0,0,0.173076923,28,0,0,0,0,0,-2792176117,776062361,10592.82938,2262534648,226253464.8,1,78227,3339,743,1760,1017,743,78227,1017,1760,168.219917,2.987551867,7.157676349,45972.9751,2014.377593,10.2406639,98885.53527,0.463070186,0.020230734,0.00010437,0.577840909,0.022498626,34,25
D:0| T0: 0.17| T1: 28.00| R0: 0.0| R1: 0.0| WTP: 0,0,0.173076923,28,0,0,0,0,0,-1494647557,1813046880,78.28705192,1490733204,149073320.4,1,566,31,13,13,0,13,566,0,13,2.232044199,0.022099448,0.022099448,99628.38674,18.9558011,0.093922652,99992.45856,0.996365391,0.000191001,1.42865E-06,0,0.022968198,26,17
D:0| T0: 0.17| T1: 28.00| R0: 0.0| R1: 0.0| WTP: 0,0,0.173076923,28,0,0,0,0,0,-1432585441,2032407216,2029.219858,1331124449,133112444.9,1,17270,787,311,337,26,311,17270,26,337,56.13333333,1.757575758,1.903030303,89330.33939,364.8,3.793939394,99814.11515,0.894983692,0.003633692,3.90999E-05,0.077151335,0.019513607,24,15
D:0| T0: 0.17| T1: 28.00| R0: 0.0| R1: 0.0| WTP: 0,0,0.173076923,28,0,0,0,0,0,-789830023.7,1507873352,18.03885983,788928080.7,78892808.07,1,53,5,3,3,0,3,53,0,3,0.346153846,0,0,99969.92308,3.353846154,0.023076923,99999.23846,0.999708164,3.52674E-05,4.5802E-07,0,0.056603774,18,9
D:0| T0: 0.17| T1: 28.00| R0: 0.0| R1: 0.0| WTP: 0,0,0.173076923,28,0,0,0,0,0,-968754026.9,1855899401,78.28915632,964839569,96483956.9,1,825,38,13,13,0,13,825,0,13,2.927536232,0.036231884,0.036231884,99516.06522,21.85507246,0.115942029,99992.72464,0.995239322,0.000219585,1.87061E-06,0,0.015757576,20,11
D:0| T0: 0.17| T1: 28.00| R0: 0.0| R1: 0.0| WTP: 0,0,0.173076923,28,0,0,0,0,0,-2279444171,1819459251,7663.077644,1896290289,189629028.9,1,60030,2612,568,1273,705,568,60030,705,1273,154.3495146,2.669902913,6.04368932,58086.92233,1047.548544,8.82038835,99174.00971,0.584913616,0.010488404,8.9509E-05,0.553809898,0.021206064,30,21
D:0| T0: 0.17| T1: 28.00| R0: 0.0| R1: 0.0| WTP: 0,0,0.173076923,28,0,0,0,0,0,-879717430.9,909791748,48.30141192,877302360.3,87730236.03,1,712,35,8,8,0,8,712,0,8,3.715384615,0.023076923,0.023076923,99597.11538,18.2,0.092307692,99996.43846,0.996011817,0.000183516,1.22141E-06,0,0.011235955,19,10
D:0| T0: 0.17| T1: 28.00| R0: 0.0| R1: 0.0| WTP: 0,0,0.173076923,28,0,0,0,0,0,-2768908769,1339092841,5566.990827,2490559227,249055922.7,1,38479,1611,616,925,309,616,38479,309,925,79.49027237,2.284046693,3.455252918,72084.45136,538.9610895,5.859922179,99363.0856,0.725226854,0.005394489,6.00101E-05,0.334054054,0.024039711,37,28
D:0| T0: 0.17| T1: 28.00| R0: 0.0| R1: 0.0| WTP: 0,0,0.173076923,28,0,0,0,0,0,-2030729947,1365866345,12461.40314,1407659790,140765979,1,97538,4342,473,2070,1597,473,97538,1597,2070,323.5361446,2.777108434,12.3313253,30129.07229,1838.403614,15.18674699,98646.18072,0.303029949,0.018449069,0.000153835,0.771497585,0.021222498,24,15
D:0| T0: 0.17| T1: 28.00| R0: 0.0| R1: 0.0| WTP: 0,0,0.173076923,28,0,0,0,0,0,-3044954623,825453433,10152.4871,2537330267,253733026.7,2,86156,3882,1374,1686,312,1374,86156,312,1686,88.23320896,2.416044776,2.97761194,55047.4291,822.1212687,5.555970149,99170.29478,0.553587495,0.00827496,5.74571E-05,0.185053381,0.019569154,77,28
D:0| T0: 0.17| T1: 28.00| R0: 0.0| R1: 0.0| WTP: 0,0,0.173076923,28,0,0,0,0,0,-1951386180,939711378,12599.97694,1321387333,132138733.3,1,97565,4337,449,2093,1644,449,97565,1644,2093,352.1225806,2.806451613,13.36129032,32566.96774,2472.883871,16.23870968,98693.54839,0.327314107,0.024802877,0.000164638,0.785475394,0.021452365,23,14
D:0| T0: 0.17| T1: 28.00| R0: 0.0| R1: 0.0| WTP: 0,0,0.173076923,28,0,0,0,0,0,-3111803436,638950699,11385.18793,2542544040,254254404,2,90741,4111,1149,1891,742,1149,90741,742,1891,101.5734406,2.167002012,3.621730382,65336.8008,1159.71831,5.93360161,99318.84708,0.655133757,0.011684646,6.16017E-05,0.392384981,0.020839532,71,28
D:0| T0: 0.17| T1: 28.00| R0: 0.0| R1: 0.0| WTP: 0,0,0.173076923,28,0,0,0,0,0,-1898766432,938699148,1005.479527,1848492455,184849245.5,1,7893,374,167,167,0,167,7893,0,167,21.25358852,0.669856459,0.669856459,94570.48804,126.861244,1.473684211,99894.5311,0.946752186,0.001265693,1.59175E-05,0,0.021157988,30,21
D:0| T0: 0.17| T1: 28.00| R0: 0.0| R1: 0.0| WTP: 0,0,0.173076923,28,0,0,0,0,0,-1841682443,121790188,18.05415653,1840779735,184077973.5,1,194,10,3,3,0,3,194,0,3,0.349056604,0,0,99886.26415,7.735849057,0.014150943,99998.73585,0.998877489,7.92026E-05,2.81693E-07,0,0.015463918,30,21
D:0| T0: 0.17| T1: 28.00| R0: 0.0| R1: 0.0| WTP: 0,0,0.173076923,28,0,0,0,0,0,-2726625721,1331335240,9325.005643,2260375439,226037543.9,1,73333,3203,757,1549,792,757,73333,792,1549,168.8675214,3.115384615,6.444444444,48747.92735,2061.089744,9.670940171,99013.54274,0.491023269,0.020674628,9.89128E-05,0.511297611,0.021122823,34,25
D:0| T0: 0.17| T1: 28.00| R0: 0.0| R1: 0.0| WTP: 0,0,0.173076923,28,0,0,0,0,0,-2163737738,470935411,13362.35035,1495620221,149562022.1,1,98775,4173,475,2220,1745,475,98775,1745,2220,312.5,2.697674419,12.81395349,24473.4186,1485.94186,15.54651163,98426.86628,0.246574405,0.014924275,0.000157498,0.786036036,0.022475323,25,16
D:0| T0: 0.17| T1: 28.00| R0: 0.0| R1: 0.0| WTP: 0,0,0.173076923,28,0,0,0,0,0,-3169583401,823434397,12674.13469,2535876667,253587666.7,2,89917,3813,1008,2106,1098,1008,89917,1098,2106,96.87840671,1.991614256,4.270440252,67914.8239,961.7568134,6.375262055,99302.16562,0.680584012,0.009699078,6.58048E-05,0.521615202,0.023410479,69,28
D:0| T0: 0.17| T1: 28.00| R0: 0.0| R1: 0.0| WTP: 0,0,0.173076923,28,0,0,0,0,0,-1147243496,493045351,132.4932633,1140618833,114061883.3,1,1358,62,22,22,0,22,1358,0,22,4.570469799,0.073825503,0.073825503,99178.87919,23.2147651,0.228187919,99988.9396,0.991908714,0.000233087,2.93363E-06,0,0.016212233,22,13
D:0| T0: 0.17| T1: 28.00| R0: 0.0| R1: 0.0| WTP: 0,0,0.173076923,28,0,0,0,0,0,-3055267461,1700216563,10356.51461,2537441730,253744173,2,87117,3890,894,1720,826,894,87117,826,1720,104.5065502,1.807860262,3.580786026,71752.02402,1027.465066,5.528384279,99486.67249,0.718439566,0.010338218,5.74257E-05,0.480232558,0.019743563,66,28
D:0| T0: 0.17| T1: 28.00| R0: 0.0| R1: 0.0| WTP: 0,0,0.173076923,28,0,0,0,0,0,-1699750614,1744119059,3565.528496,1521474189,152147418.9,1,31573,1438,445,592,147,445,31573,147,592,99.06043956,2.307692308,3.093406593,79206.44505,480.7417582,5.543956044,99645.01648,0.794821436,0.004795986,5.68324E-05,0.248310811,0.018750198,26,17
D:0| T0: 0.17| T1: 28.00| R0: 0.0| R1: 0.0| WTP: 0,0,0.173076923,28,0,0,0,0,0,-2462102175,2036906360,138.4339748,2455180476,245518047.6,2,937,44,23,23,0,23,937,0,23,2.098540146,0.025547445,0.025547445,99364.09124,24.20072993,0.105839416,99985.16788,0.993795553,0.000243302,1.67291E-06,0,0.024546425,39,28
D:0| T0: 0.17| T1: 28.00| R0: 0.0| R1: 0.0| WTP: 0,0,0.173076923,28,0,0,0,0,0,-3085881870,809704121,10927.75877,2539493932,253949393.2,2,88118,3927,1048,1815,767,1048,88118,767,1815,100.7175258,2.010309278,3.560824742,69269.54021,937.9092784,5.731958763,99412.72577,0.694282087,0.009444076,5.94235E-05,0.422589532,0.020597381,69,28
D:0| T0: 0.17| T1: 28.00| R0: 0.0| R1: 0.0| WTP: 0,0,0.173076923,28,0,0,0,0,0,-2784244625,1219866412,8689.013898,2349793930,234979393,1,72235,3207,716,1443,727,716,72235,727,1443,168.6735537,2.851239669,5.82231405,47027.10744,2452.42562,8.79338843,99033.02066,0.473864652,0.024589884,8.9506E-05,0.503811504,0.019976466,35,26
D:0| T0: 0.17| T1: 28.00| R0: 0.0| R1: 0.0| WTP: 0,0,0.173076923,28,0,0,0,0,0,-880548875.2,843498920,72.19973601,876938888.4,87693888.84,1,647,29,12,12,0,12,647,0,12,1.92481203,0.015037594,0.015037594,99623.25564,22.4887218,0.127819549,99993.54887,0.996302547,0.000225537,1.79114E-06,0,0.018547141,19,10
D:0| T0: 0.17| T1: 28.00| R0: 0.0| R1: 0.0| WTP: 0,0,0.173076923,28,0,0,0,0,0,-2524679514,107351963,1245.829185,2462388055,246238805.5,1,8161,347,207,207,0,207,8161,0,207,17.71705426,0.689922481,0.689922481,94185.12791,220.0503876,1.457364341,99867.32171,0.94314445,0.002196296,1.60006E-05,0,0.025364539,37,28
D:0| T0: 0.17| T1: 28.00| R0: 0.0| R1: 0.0| WTP: 0,0,0.173076923,28,0,0,0,0,0,-3132674238,773789021,11805.47298,2542400589,254240058.9,2,91579,4017,990,1961,971,990,91579,971,1961,97.32369942,1.772639692,3.61849711,64099.43353,1195.570328,5.547206166,99285.68015,0.642234448,0.012047379,5.7292E-05,0.495155533,0.021413206,75,28
D:0| T0: 0.17| T1: 28.00| R0: 0.0| R1: 0.0| WTP: 0,0,0.173076923,28,0,0,0,0,0,-3156785465,850936611,12398.29292,2536870819,253687081.9,2,88331,3692,1153,2060,907,1153,88331,907,2060,94.74696356,2.190283401,4.004048583,64344.88664,951.7044534,6.358299595,99212.3583,0.645688757,0.009595251,6.55463E-05,0.440291262,0.023321371,71,28
D:0| T0: 0.17| T1: 28.00| R0: 0.0| R1: 0.0| WTP: 0,0,0.173076923,28,0,0,0,0,0,-2208661717,1701318364,6440.879931,1886617720,188661772,1,48546,2066,593,1070,477,593,48546,477,1070,128.1617647,2.799019608,5.098039216,66123.78431,1013.656863,8.014705882,99316.60294,0.665356634,0.010138231,8.15597E-05,0.445794393,0.022040951,30,21
D:0| T0: 0.17| T1: 28.00| R0: 0.0| R1: 0.0| WTP: 0,0,0.173076923,28,0,0,0,0,0,-1140198407,778708269,12.05544501,1139595635,113959563.5,1,160,9,2,2,0,2,160,0,2,0.577181208,0,0,99907.56376,7.577181208,0.013422819,99999.52349,0.999082926,7.74669E-05,2.66668E-07,0,0.012578616,22,13
D:0| T0: 0.17| T1: 28.00| R0: 0.0| R1: 0.0| WTP: 0,0,0.173076923,28,0,0,0,0,0,-1581914065,1391938506,1619.063448,1500960893,150096089.3,1,12213,490,265,269,4,265,12213,4,269,34.41242938,1.322033898,1.333333333,91991.17514,246.559322,2.870056497,99838.23164,0.921450195,0.002457106,3.00386E-05,0.014869888,0.02202571,26,17
D:0| T0: 0.17| T1: 28.00| R0: 0.0| R1: 0.0| WTP: 0,0,0.173076923,28,0,0,0,0,0,-966359998.7,43418681,36.15789548,964552103.9,96455210.39,1,448,22,6,6,0,6,448,0,6,1.766423358,0,0,99738.22628,18.38686131,0.04379562,99996.93431,0.997417343,0.000185078,8.69587E-07,0,0.013392857,20,11
D:0| T0: 0.17| T1: 28.00| R0: 0.0| R1: 0.0| WTP: 0,0,0.173076923,28,0,0,0,0,0,-2757534997,817384966,13042.80165,2105394915,210539491.5,1,97822,4117,441,2167,1726,441,97822,1726,2167,235.1506849,1.96803653,9.808219178,20561.99087,1216.515982,11.82648402,98330.76712,0.207488953,0.012227703,0.000119801,0.796492847,0.022152481,32,23
D:0| T0: 0.17| T1: 28.00| R0: 0.0| R1: 0.0| WTP: 0,0,0.173076923,28,0,0,0,0,0,-1933910598,762053968,12269.39796,1320440700,132044070,1,95458,4290,497,2038,1541,497,95458,1541,2038,339.6918239,3.062893082,12.68553459,32651.35849,1878.163522,15.80503145,98698.81761,0.328496954,0.018836603,0.000160036,0.756133464,0.021349704,23,14
D:0| T0: 0.17| T1: 28.00| R0: 0.0| R1: 0.0| WTP: 0,0,0.173076923,28,0,0,0,0,0,-2492843011,1692506311,638.7625143,2460904885,246090488.5,2,6143,287,106,106,0,106,6143,0,106,14.67041199,0.288389513,0.288389513,95765.45318,154.3146067,0.685393258,99933.11236,0.958329567,0.001540373,7.9145E-06,0,0.017255413,38,28
D:0| T0: 0.17| T1: 28.00| R0: 0.0| R1: 0.0| WTP: 0,0,0.173076923,28,0,0,0,0,0,-615459852.2,1037620300,36.0634779,613656678.3,61365667.83,1,189,3,6,6,0,6,189,0,6,0.5625,0,0,99899.99107,6.258928571,0.0625,99997.875,0.999023061,6.41604E-05,1.06197E-06,0,0.031746032,16,7
D:0| T0: 0.17| T1: 28.00| R0: 0.0| R1: 0.0| WTP: 0,0,0.173076923,28,0,0,0,0,0,-1528169582,301400999,656.3266049,1495353251,149535325.1,1,5263,243,109,109,0,109,5263,0,109,16.64835165,0.467032967,0.467032967,96524.47802,120.7802198,1.054945055,99935.81319,0.965902233,0.001204021,1.19188E-05,0,0.020710621,26,17
D:0| T0: 0.17| T1: 28.00| R0: 0.0| R1: 0.0| WTP: 0,0,0.173076923,28,0,0,0,0,0,-2510059671,1868336855,8579.025629,2081108389,208110838.9,1,67252,2898,610,1425,815,610,67252,815,1425,171.0182648,2.689497717,6.365296804,52262.28311,1195.570776,9.155251142,99064.35616,0.526522568,0.011982025,9.31687E-05,0.571929825,0.021188961,32,23
D:0| T0: 0.17| T1: 28.00| R0: 0.0| R1: 0.0| WTP: 0,0,0.173076923,28,0,0,0,0,0,-2224097217,1868498144,8223.015062,1812946464,181294646.4,1,62583,2729,635,1366,731,635,62583,731,1366,168.8325123,3.019704433,6.581280788,57170.52709,1278.660099,9.684729064,99143.84236,0.575684899,0.012807541,9.877E-05,0.535139092,0.021827014,29,20
D:0| T0: 0.17| T1: 28.00| R0: 0.0| R1: 0.0| WTP: 0,0,0.173076923,28,0,0,0,0,0,-1851510385,2101566889,192.5684389,1841881963,184188196.3,1,1307,54,32,32,0,32,1307,0,32,3.470588235,0.078431373,0.078431373,99127.97059,35.24019608,0.230392157,99980.40686,0.991485172,0.000352835,3.12242E-06,0,0.02448355,30,21
D:0| T0: 0.17| T1: 28.00| R0: 0.0| R1: 0.0| WTP: 0,0,0.173076923,28,0,0,0,0,0,-1968416855,1665097450,13001.34028,1318349841,131834984.1,1,98303,4245,438,2160,1722,438,98303,1722,2160,335.0573248,2.732484076,13.63694268,28653.10191,2147.821656,16.41401274,98558.82803,0.28833457,0.021555904,0.000166186,0.797222222,0.02197288,23,14
D:0| T0: 0.17| T1: 28.00| R0: 0.0| R1: 0.0| WTP: 0,0,0.173076923,28,0,0,0,0,0,-1883626195,1716179948,11242.80387,1321486001,132148600.1,1,98040,4376,478,1867,1389,478,98040,1389,1867,349.6815287,2.98089172,11.75159236,31126.16561,2151.77707,14.78343949,98819.96815,0.312876334,0.021562003,0.000149784,0.74397429,0.019043248,23,14
D:0| T0: 0.17| T1: 28.00| R0: 0.0| R1: 0.0| WTP: 0,0,0.173076923,28,0,0,0,0,0,-1161076997,1560278715,391.0284409,1141525574,114152557.4,1,2287,99,65,65,0,65,2287,0,65,7.272151899,0.284810127,0.284810127,98698.41139,47.56962025,0.696202532,99967.28481,0.987315533,0.000475487,8.17863E-06,0,0.028421513,22,13
D:0| T0: 0.17| T1: 28.00| R0: 0.0| R1: 0.0| WTP: 0,0,0.173076923,28,0,0,0,0,0,-2330459506,991019385,10124.37815,1824240598,182424059.8,1,75581,3192,610,1682,1072,610,75581,1072,1682,207.2182741,3.015228426,8.401015228,47832.03046,2275.329949,11.49238579,98948.60914,0.48181966,0.02281456,0.000116747,0.637336504,0.02225427,29,20
D:0| T0: 0.17| T1: 28.00| R0: 0.0| R1: 0.0| WTP: 0,0,0.173076923,28,0,0,0,0,0,-3095753334,118052103,11138.0016,2538853254,253885325.4,2,86224,3772,1649,1850,201,1649,86224,201,1850,88.95158287,2.901303538,3.25698324,47345.51955,809.8212291,6.333333333,98929.31844,0.477027492,0.008158241,6.56433E-05,0.108648649,0.021455992,77,28
D:0| T0: 0.17| T1: 28.00| R0: 0.0| R1: 0.0| WTP: 0,0,0.173076923,28,0,0,0,0,0,-2018243144,1209758844,12487.00953,1393892667,139389266.7,1,88204,3609,528,2075,1547,528,88204,1547,2075,273.9515152,3.139393939,12.44848485,40211.76364,1568.357576,15.62424242,98708.38788,0.404832705,0.015744512,0.000158423,0.745542169,0.02352501,24,15
D:0| T0: 0.17| T1: 28.00| R0: 0.0| R1: 0.0| WTP: 0,0,0.173076923,28,0,0,0,0,0,-971295411.4,70671723,132.287538,964681034.5,96468103.45,1,879,37,22,22,0,22,879,0,22,2.096296296,0.096296296,0.096296296,99502.6,40.9037037,0.251851852,99989.91111,0.995132145,0.000408641,3.23562E-06,0,0.025028441,20,11
D:0| T0: 0.17| T1: 28.00| R0: 0.0| R1: 0.0| WTP: 0,0,0.173076923,28,0,0,0,0,0,-615724590.1,1722612191,42.05585974,613621797.1,61362179.71,1,154,7,7,7,0,7,154,0,7,0.339130435,0,0,99925.90435,6.269565217,0.069565217,99997.8,0.999282038,6.45706E-05,1.20693E-06,0,0.045454545,16,7
D:0| T0: 0.17| T1: 28.00| R0: 0.0| R1: 0.0| WTP: 0,0,0.173076923,28,0,0,0,0,0,-2019662922,1968291596,60.27458221,2016649193,201664919.3,1,480,31,10,10,0,10,480,0,10,1.887892377,0.004484305,0.004484305,99687.01794,8.713004484,0.049327354,99995.69507,0.99691812,8.91993E-05,8.92897E-07,0,0.020833333,32,23
D:0| T0: 0.17| T1: 28.00| R0: 0.0| R1: 0.0| WTP: 0,0,0.173076923,28,0,0,0,0,0,-2081251979,1877569084,13494.00386,1406551787,140655178.7,1,98396,4145,476,2242,1766,476,98396,1766,2242,326.0802469,2.895061728,13.75308642,28298.09259,1940.851852,16.66666667,98508.96296,0.284748422,0.019488655,0.000168597,0.787689563,0.022785479,24,15
D:0| T0: 0.17| T1: 28.00| R0: 0.0| R1: 0.0| WTP: 0,0,0.173076923,28,0,0,0,0,0,-2068572054,1726322189,13306.75095,1403234506,140323450.6,1,96304,4112,524,2211,1687,524,96304,1687,2211,307.5030303,3.109090909,13.26060606,31480.65455,1982.472727,16.44848485,98571.98788,0.316751669,0.019905308,0.000166567,0.763003166,0.022958548,24,15
D:0| T0: 0.17| T1: 28.00| R0: 0.0| R1: 0.0| WTP: 0,0,0.173076923,28,0,0,0,0,0,-1886903744,307848836,11497.9627,1312005608,131200560.8,1,90240,3972,507,1910,1403,507,90240,1403,1910,304.1552795,3.062111801,11.72049689,39548.54658,1977.285714,14.86956522,98843.35404,0.397740099,0.019823457,0.000150608,0.734554974,0.02116578,23,14
D:0| T0: 0.17| T1: 28.00| R0: 0.0| R1: 0.0| WTP: 0,0,0.173076923,28,0,0,0,0,0,-1835977801,1154000220,12035.59302,1234198150,123419815,1,98939,4480,439,1999,1560,439,98939,1560,1999,356.8766234,2.753246753,12.83766234,25431.02597,1673.532468,15.72077922,98620.52597,0.256197708,0.016774105,0.000158844,0.780390195,0.020204368,22,13
D:0| T0: 0.17| T1: 28.00| R0: 0.0| R1: 0.0| WTP: 0,0,0.173076923,28,0,0,0,0,0,-1848893629,2028661055,150.3633374,1841375462,184137546.2,1,905,37,25,25,0,25,905,0,25,2,0.048780488,0.048780488,99380.10732,23.08292683,0.165853659,99985.20976,0.993956921,0.000232011,2.42747E-06,0,0.027624309,30,21
D:0| T0: 0.17| T1: 28.00| R0: 0.0| R1: 0.0| WTP: 0,0,0.173076923,28,0,0,0,0,0,-3115953359,1629114640,11469.3145,2542487634,254248763.4,2,91794,4067,1307,1905,598,1307,91794,598,1905,104.7229167,2.554166667,3.775,59065.2,1186.135417,6.50625,99218.32292,0.593026141,0.011949113,6.7388E-05,0.313910761,0.02075299,69,28
D:0| T0: 0.17| T1: 28.00| R0: 0.0| R1: 0.0| WTP: 0,0,0.173076923,28,0,0,0,0,0,-1964457217,1439048174,12952.84406,1316815014,131681501.4,1,97218,4091,501,2152,1651,501,97218,1651,2152,320.6583851,3.049689441,13.26708075,31550.6646,2571.826087,16.38509317,98626.93789,0.317283489,0.025819004,0.000165513,0.767193309,0.022135818,23,14
D:0| T0: 0.17| T1: 28.00| R0: 0.0| R1: 0.0| WTP: 0,0,0.173076923,28,0,0,0,0,0,-2606194342,865227006,13487.76317,1931806183,193180618.3,1,99171,4141,440,2241,1801,440,99171,1801,2241,253.4975845,2.062801932,10.73429952,18111.4058,1287.507246,12.87439614,98252.28502,0.182903911,0.012941058,0.000130328,0.803659081,0.022597332,30,21
D:0| T0: 0.17| T1: 28.00| R0: 0.0| R1: 0.0| WTP: 0,0,0.173076923,28,0,0,0,0,0,-3051853236,890479738,10337.81843,2534962314,253496231.4,2,81784,3615,1211,1717,506,1211,81784,506,1717,55.63570567,1.326899879,1.922798552,33920.00603,705.535585,3.364294331,98648.924,0.343160831,0.0071082,3.55982E-05,0.294700058,0.020994327,119,28
D:0| T0: 0.17| T1: 28.00| R0: 0.0| R1: 0.0| WTP: 0,0,0.173076923,28,0,0,0,0,0,-1260009283,1017049163,571.924303,1231413068,123141306.8,1,4882,218,95,95,0,95,4882,0,95,15.35220126,0.471698113,0.471698113,97010.84906,111.0251572,1.088050314,99947.66667,0.970643074,0.001106399,1.18804E-05,0,0.019459238,23,14
D:0| T0: 0.17| T1: 28.00| R0: 0.0| R1: 0.0| WTP: 0,0,0.173076923,28,0,0,0,0,0,-1316046176,1707305064,18.14171148,1315139090,131513909,1,304,12,3,3,0,3,304,0,3,1.43902439,0.006097561,0.006097561,99809.40854,9.384146341,0.018292683,99998.14634,0.998116373,9.53351E-05,3.63639E-07,0,0.009868421,24,15
D:0| T0: 0.17| T1: 28.00| R0: 0.0| R1: 0.0| WTP: 0,0,0.173076923,28,0,0,0,0,0,-2256163780,400145663,13458.37785,1583244887,158324488.7,1,99063,4296,416,2236,1820,416,99063,1820,2236,305.3125,2.301136364,12.61363636,21244.23864,1511.471591,14.97727273,98336.77273,0.214354435,0.015179205,0.000151496,0.813953488,0.022571495,26,17
D:0| T0: 0.17| T1: 28.00| R0: 0.0| R1: 0.0| WTP: 0,0,0.173076923,28,0,0,0,0,0,-1146840749,1662654181,120.5449117,1140813503,114081350.3,1,1480,66,20,20,0,20,1480,0,20,5.25974026,0.051948052,0.051948052,99114.72078,38.96753247,0.168831169,99989.98701,0.991256664,0.000389447,2.58088E-06,0,0.013513514,22,13
D:0| T0: 0.17| T1: 28.00| R0: 0.0| R1: 0.0| WTP: 0,0,0.173076923,28,0,0,0,0,0,-2028784179,182136456,12413.50839,1408108760,140810876,1,98235,4374,473,2062,1589,473,98235,1589,2062,333.2037037,2.87037037,12.62345679,28120.00617,2101.364198,15.5308642,98623.17284,0.282984097,0.021080113,0.000157104,0.770611057,0.020990482,24,15
D:0| T0: 0.17| T1: 28.00| R0: 0.0| R1: 0.0| WTP: 0,0,0.173076923,28,0,0,0,0,0,-1403902093,979575387,24.11458233,1402696364,140269636.4,1,290,12,4,4,0,4,290,0,4,1.046783626,0,0,99823.53216,11.45614035,0.023391813,99998.20468,0.99825693,0.000116223,4.65123E-07,0,0.013793103,25,16
D:0| T0: 0.17| T1: 28.00| R0: 0.0| R1: 0.0| WTP: 0,0,0.173076923,28,0,0,0,0,0,-2114530231,2142525414,10984.42846,1565308808,156530880.8,1,81403,3435,588,1825,1237,588,81403,1237,1825,240.7653631,3.201117318,10.05027933,45963.01676,1782.201117,13.33519553,98902.11732,0.462652857,0.017876666,0.000135287,0.677808219,0.022419321,26,17
D:0| T0: 0.17| T1: 28.00| R0: 0.0| R1: 0.0| WTP: 0,0,0.173076923,28,0,0,0,0,0,-3045323799,1464057597,10176.35439,2536506080,253650608,2,82804,3604,1564,1690,126,1564,82804,126,1690,77.28807947,2.427152318,2.625827815,46786.14238,513.3725166,5.226821192,98945.68377,0.471544855,0.00517035,5.42462E-05,0.074556213,0.020409642,87,28
D:0| T0: 0.17| T1: 28.00| R0: 0.0| R1: 0.0| WTP: 0,0,0.173076923,28,0,0,0,0,0,-2062133212,364562610,11580.68812,1483098806,148309880.6,1,87956,3757,530,1924,1394,530,87956,1394,1924,266.3275862,2.965517241,10.93678161,39138.09195,1709.189655,14,98782.65517,0.394011626,0.017143152,0.000141569,0.724532225,0.021874574,25,16
D:0| T0: 0.17| T1: 28.00| R0: 0.0| R1: 0.0| WTP: 0,0,0.173076923,28,0,0,0,0,0,-2257783547,40350784,10400.98761,1737734166,173773416.6,1,77125,3268,605,1728,1123,605,77125,1123,1728,212.625641,3.01025641,8.717948718,47288.47692,1529.682051,11.81538462,98915.11282,0.476332949,0.015341981,0.000120075,0.649884259,0.022405186,28,19
D:0| T0: 0.17| T1: 28.00| R0: 0.0| R1: 0.0| WTP: 0,0,0.173076923,28,0,0,0,0,0,-2074109977,804064356,9890.023559,1579608799,157960879.9,1,89264,4116,438,1642,1204,438,89264,1204,1642,292.2011173,2.379888268,9.072625698,36867.4581,1444.03352,11.50837989,98925.40223,0.370984933,0.014467612,0.000116487,0.733252132,0.018394874,26,17
D:0| T0: 0.17| T1: 28.00| R0: 0.0| R1: 0.0| WTP: 0,0,0.173076923,28,0,0,0,0,0,-1628227273,2125493986,5507.451387,1352854703,135285470.3,1,39738,1695,465,915,450,465,39738,450,915,129.0059524,2.654761905,5.303571429,74078.57738,742.8690476,8.041666667,99455.19643,0.744512211,0.007417016,8.20256E-05,0.491803279,0.023025819,24,15
D:0| T0: 0.17| T1: 28.00| R0: 0.0| R1: 0.0| WTP: 0,0,0.173076923,28,0,0,0,0,0,-2022145136,23154253,7499.412326,1647174520,164717452,1,69083,3146,519,1245,726,519,69083,726,1245,219.8315217,2.695652174,6.60326087,53171.11413,1000.472826,9.461956522,99223.38043,0.53493693,0.010008325,9.59413E-05,0.58313253,0.0180218,27,18
D:0| T0: 0.17| T1: 28.00| R0: 0.0| R1: 0.0| WTP: 0,0,0.173076923,28,0,0,0,0,0,-2038013103,1391367689,385.2502514,2018750591,201875059.1,1,3102,138,64,64,0,64,3102,0,64,7.206278027,0.170403587,0.170403587,97810.30493,47.04932735,0.452914798,99958.0583,0.97853964,0.000470982,5.71604E-06,0,0.020638504,32,23
D:0| T0: 0.17| T1: 28.00| R0: 0.0| R1: 0.0| WTP: 0,0,0.173076923,28,0,0,0,0,0,-2403329841,574142276,2173.165102,2294671586,229467158.6,1,16719,710,356,361,5,356,16719,5,361,36.45679012,1.304526749,1.325102881,88596.55556,316.4115226,2.794238683,99771.09053,0.888025751,0.003158796,2.94371E-05,0.013850416,0.021593492,35,26
D:0| T0: 0.17| T1: 28.00| R0: 0.0| R1: 0.0| WTP: 0,0,0.173076923,28,0,0,0,0,0,-701611202.7,898736779,6.039854375,701309210,70130921,1,92,4,1,1,0,1,92,0,1,0.578947368,0,0,99953.01754,5.789473684,0.00877193,99999.17544,0.999539648,5.9218E-05,1.73913E-07,0,0.010869565,17,8
D:0| T0: 0.17| T1: 28.00| R0: 0.0| R1: 0.0| WTP: 0,0,0.173076923,28,0,0,0,0,0,-3046853096,346473503,9975.803627,2548062915,254806291.5,2,91146,4350,1313,1656,343,1313,91146,343,1656,101.6553672,2.359698682,2.979284369,47621.72505,981.26742,5.438794727,99096.44068,0.47916614,0.009875853,5.62719E-05,0.207125604,0.018168852,76,28
D:0| T0: 0.17| T1: 28.00| R0: 0.0| R1: 0.0| WTP: 0,0,0.173076923,28,0,0,0,0,0,-2707890779,445552282,4436.49241,2486066159,248606615.9,2,33491,1483,592,737,145,592,33491,145,737,66.94776119,2.063432836,2.593283582,76622.03358,719.0186567,4.809701493,99519.27239,0.769761207,0.007190865,4.95886E-05,0.196743555,0.022005912,38,28
D:0| T0: 0.17| T1: 28.00| R0: 0.0| R1: 0.0| WTP: 0,0,0.173076923,28,0,0,0,0,0,-1746013496,911758476,11946.23269,1148701861,114870186.1,1,99146,4479,437,1984,1547,437,99146,1547,1984,396.7676056,2.985915493,13.83098592,27636.58451,1954.535211,16.9084507,98686.9507,0.278200211,0.019581078,0.000170959,0.779737903,0.020010893,21,12
D:0| T0: 0.17| T1: 28.00| R0: 0.0| R1: 0.0| WTP: 0,0,0.173076923,28,0,0,0,0,0,-2141479453,1464197940,11111.20923,1585918992,158591899.2,1,93996,4382,552,1845,1293,552,93996,1293,1845,311.6256983,3.005586592,10.18994413,33594.05028,3063.877095,13.24581006,98820.50279,0.337879763,0.03073005,0.000134389,0.700813008,0.019628495,26,17
D:0| T0: 0.17| T1: 28.00| R0: 0.0| R1: 0.0| WTP: 0,0,0.173076923,28,0,0,0,0,0,-1687163374,500405854,1908.361708,1591745289,159174528.9,1,13849,600,307,317,10,307,13849,10,317,42.3315508,1.465240642,1.524064171,91001.3262,304.6149733,3.160427807,99814.31551,0.911740735,0.003036852,3.32424E-05,0.031545741,0.022894699,27,18
D:0| T0: 0.17| T1: 28.00| R0: 0.0| R1: 0.0| WTP: 0,0,0.173076923,28,0,0,0,0,0,-2004424760,772037341,12110.26047,1398911737,139891173.7,1,92766,3897,464,2012,1548,464,92766,1548,2012,293.5333333,2.739393939,12.06666667,35320.81818,1842.612121,14.87272727,98710.27879,0.355418127,0.018482671,0.000150624,0.769383698,0.021688981,24,15
D:0| T0: 0.17| T1: 28.00| R0: 0.0| R1: 0.0| WTP: 0,0,0.173076923,28,0,0,0,0,0,-967790505.6,1543158763,66.16145856,964482432.7,96448243.27,1,464,23,11,11,0,11,464,0,11,1.379562044,0.02189781,0.02189781,99731.39416,15.99270073,0.102189781,99993.85401,0.997379249,0.000161025,1.59428E-06,0,0.023706897,20,11
D:0| T0: 0.17| T1: 28.00| R0: 0.0| R1: 0.0| WTP: 0,0,0.173076923,28,0,0,0,0,0,-1832721565,1604932531,13782.2358,1143609775,114360977.5,1,98721,4189,442,2290,1848,442,98721,1848,2290,361.6438356,2.938356164,15.55479452,28998.41781,1995.582192,18.5890411,98497.54795,0.291808024,0.020024328,0.000187945,0.8069869,0.023196686,21,12
D:0| T0: 0.17| T1: 28.00| R0: 0.0| R1: 0.0| WTP: 0,0,0.173076923,28,0,0,0,0,0,-2606397423,539051477,10270.38144,2092878350,209287835,1,77413,3439,689,1706,1017,689,77413,1017,1706,202.8027523,3.059633028,7.669724771,45165.97248,2037.399083,10.82568807,98900.74771,0.45512808,0.0204447,0.000110323,0.596131301,0.022037642,32,23
D:0| T0: 0.17| T1: 28.00| R0: 0.0| R1: 0.0| WTP: 0,0,0.173076923,28,0,0,0,0,0,-1235046152,1743124675,144.3604116,1227828131,122782813.1,1,733,30,24,24,0,24,733,0,24,2.662420382,0.057324841,0.057324841,99529.2293,15.29299363,0.21656051,99986.01911,0.99543861,0.000153751,3.03832E-06,0,0.032742156,23,14
D:0| T0: 0.17| T1: 28.00| R0: 0.0| R1: 0.0| WTP: 0,0,0.173076923,28,0,0,0,0,0,-3107776840,1965983789,11395.6997,2537991855,253799185.5,2,87403,3820,1093,1893,800,1093,87403,800,1893,103.7245119,2.1670282,3.882863341,69888.01085,1100.071584,6.277657267,99394.63991,0.700286336,0.011079441,6.52258E-05,0.422609614,0.021658295,66,28
D:0| T0: 0.17| T1: 28.00| R0: 0.0| R1: 0.0| WTP: 0,0,0.173076923,28,0,0,0,0,0,-2320546455,516774280,728.3701541,2284127947,228412794.7,1,5542,243,121,121,0,121,5542,0,121,11.99186992,0.394308943,0.394308943,96125.00407,145.6747967,0.886178862,99922.0935,0.962033873,0.001453907,9.80332E-06,0,0.021833273,35,26
D:0| T0: 0.17| T1: 28.00| R0: 0.0| R1: 0.0| WTP: 0,0,0.173076923,28,0,0,0,0,0,-2296715272,86603142,12497.83911,1671823317,167182331.7,1,98877,4264,422,2076,1654,422,98877,1654,2076,296.4565217,2.239130435,11.19565217,20627.42391,1394.456522,13.48913043,98429.9837,0.20817992,0.013998365,0.000136404,0.79672447,0.020995783,27,18
D:0| T0: 0.17| T1: 28.00| R0: 0.0| R1: 0.0| WTP: 0,0,0.173076923,28,0,0,0,0,0,-965989593.7,1431870609,30.13122792,964483032.3,96448303.23,1,447,16,5,5,0,5,447,0,5,1.467153285,0,0,99737.33577,22.10948905,0.03649635,99997.13139,0.997406558,0.000221746,7.24652E-07,0,0.011185682,20,11
D:0| T0: 0.17| T1: 28.00| R0: 0.0| R1: 0.0| WTP: 0,0,0.173076923,28,0,0,0,0,0,-2561069609,1592383984,4882.931227,2316923047,231692304.7,1,38645,1653,625,811,186,625,38645,186,811,89.30165289,2.462809917,3.20661157,73345.36777,466.8347107,5.785123967,99478.17769,0.73708206,0.00466913,5.9338E-05,0.229346486,0.020985897,35,26
D:0| T0: 0.17| T1: 28.00| R0: 0.0| R1: 0.0| WTP: 0,0,0.173076923,28,0,0,0,0,0,-3062252351,1440183867,10465.19974,2538992364,253899236.4,2,86659,3959,1070,1738,668,1070,86659,668,1738,97.112,2.03,3.342,67955.094,838.2,5.454,99410.702,0.681399804,0.008437486,5.65162E-05,0.384349827,0.02005562,72,28
D:0| T0: 0.17| T1: 28.00| R0: 0.0| R1: 0.0| WTP: 0,0,0.173076923,28,0,0,0,0,0,-2216600266,1696510588,439.4901935,2194625756,219462575.6,1,4098,171,73,73,0,73,4098,0,73,8.274678112,0.214592275,0.214592275,97230.24893,83.35622318,0.527896996,99953.59657,0.972780595,0.000832626,6.24149E-06,0,0.017813568,34,25
D:0| T0: 0.17| T1: 28.00| R0: 0.0| R1: 0.0| WTP: 0,0,0.173076923,28,0,0,0,0,0,-2298715397,895039877,11046.3651,1746397142,174639714.2,1,84956,3665,584,1835,1251,584,84956,1251,1835,240.5206186,2.93814433,9.319587629,39528.04124,2295.494845,12.31443299,98817.30412,0.398154226,0.02302829,0.000125193,0.681743869,0.021599416,28,19
D:0| T0: 0.17| T1: 28.00| R0: 0.0| R1: 0.0| WTP: 0,0,0.173076923,28,0,0,0,0,0,-3145928488,129565953,12170.28746,2537414115,253741411.5,2,88666,3752,1262,2022,760,1262,88666,760,2022,87.3580705,2.176252319,3.567717996,64354.29314,1157.90167,5.918367347,99231.07421,0.645703693,0.011674635,6.14085E-05,0.37586548,0.022804683,76,28
D:0| T0: 0.17| T1: 28.00| R0: 0.0| R1: 0.0| WTP: 0,0,0.173076923,28,0,0,0,0,0,-1865188265,1902565669,415.5966057,1844408435,184440843.5,1,4219,196,69,69,0,69,4219,0,69,10.41545894,0.256038647,0.256038647,97168.86473,75.99033816,0.574879227,99955.94203,0.972147651,0.000759016,6.63677E-06,0,0.016362343,30,21
D:0| T0: 0.17| T1: 28.00| R0: 0.0| R1: 0.0| WTP: 0,0,0.173076923,28,0,0,0,0,0,-1413891858,1984179288,198.6784526,1403957935,140395793.5,1,1788,69,33,33,0,33,1788,0,33,5.296511628,0.087209302,0.087209302,98850.1686,78.55813953,0.284883721,99982.40116,0.988690847,0.000783459,3.81563E-06,0,0.018456376,25,16
D:0| T0: 0.17| T1: 28.00| R0: 0.0| R1: 0.0| WTP: 0,0,0.173076923,28,0,0,0,0,0,-3094266281,677377223,11155.27545,2536502509,253650250.9,2,85505,3682,1735,1853,118,1735,85505,118,1853,77.18864775,2.719532554,2.906510851,45643.78798,1162.260434,5.809682805,98869.12688,0.460132543,0.011713366,6.03656E-05,0.063680518,0.021671247,85,28
D:0| T0: 0.17| T1: 28.00| R0: 0.0| R1: 0.0| WTP: 0,0,0.173076923,28,0,0,0,0,0,-3109647502,973583301,11325.56496,2543369254,254336925.4,2,91021,4012,1484,1881,397,1484,91021,397,1881,110.3877996,3.054466231,3.895424837,58190.41612,1613.973856,7.132897603,99191.11765,0.584139444,0.016258383,7.38161E-05,0.211057948,0.020665561,66,28
D:0| T0: 0.17| T1: 28.00| R0: 0.0| R1: 0.0| WTP: 0,0,0.173076923,28,0,0,0,0,0,-2037402907,781062938,1819.595345,1946423140,194642314,1,16669,807,300,302,2,300,16669,2,302,49.28301887,1.254716981,1.264150943,88793.16038,365.2264151,2.693396226,99814.68396,0.889631333,0.003642702,2.83044E-05,0.006622517,0.018117464,31,22
D:0| T0: 0.17| T1: 28.00| R0: 0.0| R1: 0.0| WTP: 0,0,0.173076923,28,0,0,0,0,0,-3131155121,338783425,11680.90311,2547109966,254710996.6,2,94174,4206,1024,1940,916,1024,94174,916,1940,110.8236515,1.968879668,3.842323651,64029.79876,1590.13278,5.954356846,99325.67842,0.641166516,0.016017853,6.19497E-05,0.472164948,0.020600166,69,28
D:0| T0: 0.17| T1: 28.00| R0: 0.0| R1: 0.0| WTP: 0,0,0.173076923,28,0,0,0,0,0,-1496594806,1027579040,114.3679034,1490876411,149087641.1,1,917,39,19,19,0,19,917,0,19,2.531914894,0.053191489,0.053191489,99416.66489,37.12234043,0.154255319,99988.96809,0.994283973,0.000371146,2.01075E-06,0,0.020765027,26,17
D:0| T0: 0.17| T1: 28.00| R0: 0.0| R1: 0.0| WTP: 0,0,0.173076923,28,0,0,0,0,0,-3152572968,764973813,12249.18444,2540113746,254011374.6,2,91998,3987,1149,2035,886,1149,91998,886,2035,96.19329389,2.140039448,3.859960552,61893.30572,1243.09073,6.132149901,99213.47732,0.620925957,0.012531859,6.32867E-05,0.435380835,0.022120046,72,28
D:0| T0: 0.17| T1: 28.00| R0: 0.0| R1: 0.0| WTP: 0,0,0.173076923,28,0,0,0,0,0,-3133399050,1245753446,11758.60048,2545469026,254546902.6,2,92883,4111,1352,1953,601,1352,92883,601,1953,102.2854331,2.549212598,3.712598425,50512.74213,1244.515748,6.344488189,98995.74803,0.50832742,0.012545233,6.5559E-05,0.307889344,0.021015686,73,28
D:0| T0: 0.17| T1: 28.00| R0: 0.0| R1: 0.0| WTP: 0,0,0.173076923,28,0,0,0,0,0,-2115271545,1013177794,3310.063447,1949768372,194976837.2,1,24433,1013,457,550,93,457,24433,93,550,56.13615023,1.981220657,2.408450704,83444.0892,480.6244131,4.577464789,99656.82629,0.837286831,0.004798261,4.71851E-05,0.169090909,0.022510539,31,22
D:0| T0: 0.17| T1: 28.00| R0: 0.0| R1: 0.0| WTP: 0,0,0.173076923,28,0,0,0,0,0,-1668898538,1395089249,54.31437069,1666182819,166618281.9,1,867,37,9,9,0,9,867,0,9,2.642105263,0.010526316,0.010526316,99400.07895,24.06315789,0.052631579,99994.11053,0.994069425,0.000241844,9.42445E-07,0,0.010380623,28,19
D:0| T0: 0.17| T1: 28.00| R0: 0.0| R1: 0.0| WTP: 0,0,0.173076923,28,0,0,0,0,0,-438852878.3,1339545835,12.01008238,438252374.2,43825237.42,1,66,0,2,2,0,2,66,0,2,0,0,0,99962.31579,4.557894737,0.021052632,99998.72632,0.99963791,4.76049E-05,4.16669E-07,0,0.03030303,14,5
D:0| T0: 0.17| T1: 28.00| R0: 0.0| R1: 0.0| WTP: 0,0,0.173076923,28,0,0,0,0,0,-1803808453,219139554,11410.78146,1233269380,123326938,1,95408,4273,467,1895,1428,467,95408,1428,1895,366.147651,3.060402685,12.57718121,32898,1681.52349,15.7114094,98779.59732,0.331041421,0.016848896,0.000158928,0.753562005,0.019862066,22,13
D:0| T0: 0.17| T1: 28.00| R0: 0.0| R1: 0.0| WTP: 0,0,0.173076923,28,0,0,0,0,0,-1428864147,1336508942,451.6680232,1406280746,140628074.6,1,3698,167,75,75,0,75,3698,0,75,13.33727811,0.284023669,0.284023669,97760.78107,87.67455621,0.75739645,99962.23077,0.977996639,0.00087437,8.82671E-06,0,0.020281233,25,16
D:0| T0: 0.17| T1: 28.00| R0: 0.0| R1: 0.0| WTP: 0,0,0.173076923,28,0,0,0,0,0,-703999557.1,448559423,54.07595311,701295759.4,70129575.94,1,162,4,9,9,0,9,162,0,9,0.434782609,0.017391304,0.017391304,99910.31304,10.29565217,0.095652174,99997.29565,0.999132373,0.000104226,1.55178E-06,0,0.055555556,17,8
D:0| T0: 0.17| T1: 28.00| R0: 0.0| R1: 0.0| WTP: 0,0,0.173076923,28,0,0,0,0,0,-2341667252,2110028840,1089.701955,2287182154,228718215.4,1,8531,384,181,181,0,181,8531,0,181,19.525,0.629166667,0.629166667,94033.29583,172.9458333,1.3875,99883.17917,0.941479057,0.001726289,1.50339E-05,0,0.021216739,35,26
D:0| T0: 0.17| T1: 28.00| R0: 0.0| R1: 0.0| WTP: 0,0,0.173076923,28,0,0,0,0,0,-3189559347,1982030155,13076.48112,2535735291,253573529.1,2,90914,3723,1060,2173,1113,1060,90914,1113,2173,97.69426752,2.116772824,4.452229299,68515.33546,1278.760085,6.702760085,99303.0913,0.686551885,0.012899659,6.92146E-05,0.512195122,0.023901709,68,28
D:0| T0: 0.17| T1: 28.00| R0: 0.0| R1: 0.0| WTP: 0,0,0.173076923,28,0,0,0,0,0,-3095453580,696219407,11244.11527,2533247817,253324781.7,2,84782,3581,1256,1868,612,1256,84782,612,1868,98.26153846,2.593406593,3.914285714,64250.30989,618.6593407,6.703296703,99234.4967,0.645451072,0.006232896,6.91159E-05,0.327623126,0.022032979,65,28
D:0| T0: 0.17| T1: 28.00| R0: 0.0| R1: 0.0| WTP: 0,0,0.173076923,28,0,0,0,0,0,-1990826146,1402539442,10104.21028,1485615632,148561563.2,1,84628,3787,549,1678,1129,549,84628,1129,1678,283.7705882,3.147058824,9.741176471,44141.80588,2280.270588,12.94117647,99002.20588,0.443936197,0.022846769,0.000131338,0.672824791,0.019827953,25,16
D:0| T0: 0.17| T1: 28.00| R0: 0.0| R1: 0.0| WTP: 0,0,0.173076923,28,0,0,0,0,0,-2170138711,1319833493,10276.86929,1656295247,165629524.7,1,82058,3679,610,1707,1097,610,82058,1097,1707,240.6914894,3.159574468,8.95212766,43550.01596,2947.164894,12.18085106,98943.32447,0.438413347,0.029552063,0.000123649,0.64264792,0.020802359,27,18
D:0| T0: 0.17| T1: 28.00| R0: 0.0| R1: 0.0| WTP: 0,0,0.173076923,28,0,0,0,0,0,-1885052194,663608076,788.3451044,1845634939,184563493.9,1,5676,235,131,131,0,131,5676,0,131,13.57560976,0.502439024,0.502439024,96326.76585,165.702439,1.107317073,99923.73171,0.964032521,0.00165234,1.27265E-05,0,0.023079634,30,21
D:0| T0: 0.17| T1: 28.00| R0: 0.0| R1: 0.0| WTP: 0,0,0.173076923,28,0,0,0,0,0,-2020178004,414696500,72.25827997,2016565090,201656509,1,570,30,12,12,0,12,570,0,12,1.613333333,0.013333333,0.013333333,99633.01333,15.64444444,0.062222222,99993.08889,0.996404208,0.000158106,1.062E-06,0,0.021052632,32,23
D:0| T0: 0.17| T1: 28.00| R0: 0.0| R1: 0.0| WTP: 0,0,0.173076923,28,0,0,0,0,0,-1235681494,1249738535,150.4741011,1228157789,122815778.9,1,990,45,25,25,0,25,990,0,25,3.826086957,0.068322981,0.068322981,99391.55901,24.61490683,0.211180124,99987.7205,0.994045566,0.000246872,3.08678E-06,0,0.025252525,23,14
D:0| T0: 0.17| T1: 28.00| R0: 0.0| R1: 0.0| WTP: 0,0,0.173076923,28,0,0,0,0,0,-2025637172,614415382,168.55095,2017209625,201720962.5,1,1515,57,28,28,0,28,1515,0,28,3.399082569,0.041284404,0.041284404,99080.43119,44.09174312,0.174311927,99984.91284,0.990961812,0.000441702,2.55742E-06,0,0.018481848,32,23
D:0| T0: 0.17| T1: 28.00| R0: 0.0| R1: 0.0| WTP: 0,0,0.173076923,28,0,0,0,0,0,-1667325705,524899953,30.17289825,1665817060,166581706,1,480,28,5,5,0,5,480,0,5,1.458333333,0,0,99673.375,14.23958333,0.026041667,99996.66146,0.996772967,0.00014389,5.18145E-07,0,0.010438413,28,19
D:0| T0: 0.17| T1: 28.00| R0: 0.0| R1: 0.0| WTP: 0,0,0.173076923,28,0,0,0,0,0,-1868528488,1338977757,12660.58602,1235499187,123549918.7,1,98967,4419,403,2103,1700,403,98967,1700,2103,361.6623377,2.545454545,13.53896104,26152.23377,1689.824675,16.16233766,98549.27273,0.263361216,0.016945494,0.000163349,0.808368997,0.021249507,22,13
D:0| T0: 0.17| T1: 28.00| R0: 0.0| R1: 0.0| WTP: 0,0,0.173076923,28,0,0,0,0,0,-2171611986,341384587,10377.79317,1652722327,165272232.7,1,78975,3373,518,1724,1206,518,78975,1206,1724,230.9679144,2.695187166,9.096256684,43613.90909,1431.032086,11.86631016,98861.60428,0.439601863,0.01434678,0.000120265,0.699535963,0.021829693,27,18
D:0| T0: 0.17| T1: 28.00| R0: 0.0| R1: 0.0| WTP: 0,0,0.173076923,28,0,0,0,0,0,-3132885416,2032000160,11870.63476,2539353678,253935367.8,2,89308,3903,1234,1972,738,1234,89308,738,1972,99.04098361,2.375,3.856557377,62740.03279,1234.223361,6.381147541,99221.5082,0.629513848,0.012441231,6.61821E-05,0.374239351,0.022080889,70,28
D:0| T0: 0.17| T1: 28.00| R0: 0.0| R1: 0.0| WTP: 0,0,0.173076923,28,0,0,0,0,0,-2311998142,779488939,9722.511255,1825872580,182587258,1,76020,3316,566,1615,1049,566,76020,1049,1615,207.7821782,2.683168317,7.811881188,47341.05446,1430.034653,10.63861386,98974.18812,0.47678371,0.014336003,0.000108321,0.649535604,0.021244409,29,20
D:0| T0: 0.17| T1: 28.00| R0: 0.0| R1: 0.0| WTP: 0,0,0.173076923,28,0,0,0,0,0,-2403071716,1449019578,643.9927093,2370872080,237087208,1,4312,177,107,107,0,107,4312,0,107,9.519379845,0.290697674,0.290697674,97104.62791,105.1395349,0.724806202,99933.52326,0.971714509,0.001050298,8.26683E-06,0,0.024825986,36,27
D:0| T0: 0.17| T1: 28.00| R0: 0.0| R1: 0.0| WTP: 0,0,0.173076923,28,0,0,0,0,0,-1231066491,351952211,66.26538164,1227753222,122775322.2,1,521,28,11,11,0,11,521,0,11,2.541935484,0.006451613,0.006451613,99682.72903,14.9483871,0.096774194,99994.78065,0.996884685,0.000151096,1.41033E-06,0,0.021113244,23,14
D:0| T0: 0.17| T1: 28.00| R0: 0.0| R1: 0.0| WTP: 0,0,0.173076923,28,0,0,0,0,0,-1493321373,486595046,60.13217012,1490314765,149031476.5,1,385,16,10,10,0,10,385,0,10,0.798969072,0,0,99792.07732,15.70103093,0.051546392,99995.45876,0.997968414,0.000158418,1.02569E-06,0,0.026041667,26,17
D:0| T0: 0.17| T1: 28.00| R0: 0.0| R1: 0.0| WTP: 0,0,0.173076923,28,0,0,0,0,0,-2037782249,296745624,4954.595422,1790052477,179005247.7,1,39226,1736,481,823,342,481,39226,342,823,107.213198,2.294416244,4.005076142,73475.38579,975.6294416,6.446700508,99485.8731,0.738318974,0.00974749,6.6131E-05,0.415552855,0.020980982,29,20
D:0| T0: 0.17| T1: 28.00| R0: 0.0| R1: 0.0| WTP: 0,0,0.173076923,28,0,0,0,0,0,-1689278952,1671484194,409.4919052,1668804357,166880435.7,1,3384,161,68,68,0,68,3384,0,68,10.31606218,0.243523316,0.243523316,97859.04145,89.84974093,0.606217617,99960.7772,0.978995441,0.000896637,7.0126E-06,0,0.020106446,28,19
D:0| T0: 0.17| T1: 28.00| R0: 0.0| R1: 0.0| WTP: 0,0,0.173076923,28,0,0,0,0,0,-2177830809,422157396,11879.18551,1583871533,158387153.3,1,98334,4369,476,1973,1497,476,98334,1497,1973,303.9050279,2.592178771,10.92178771,26113.46927,2049.960894,13.58100559,98631.15642,0.262861855,0.020571472,0.000137384,0.758743031,0.020064271,26,17
D:0| T0: 0.17| T1: 28.00| R0: 0.0| R1: 0.0| WTP: 0,0,0.173076923,28,0,0,0,0,0,-1963423376,1916599091,12816.58979,1322593886,132259388.6,1,98431,4258,447,2129,1682,447,98431,1682,2129,350.1329114,2.753164557,13.34810127,27640.51899,2168.949367,16.1835443,98569.12025,0.278220405,0.021755487,0.000163717,0.790042273,0.021629365,23,14
D:0| T0: 0.17| T1: 28.00| R0: 0.0| R1: 0.0| WTP: 0,0,0.173076923,28,0,0,0,0,0,-1846254200,1005953941,12216.23243,1235442578,123544257.8,1,98342,4312,495,2029,1534,495,98342,1534,2029,368.8013245,3.225165563,13.32450331,30384.56954,2637.046358,16.58940397,98711.46358,0.305556772,0.026435801,0.000167715,0.756037457,0.02063208,22,13
D:0| T0: 0.17| T1: 28.00| R0: 0.0| R1: 0.0| WTP: 0,0,0.173076923,28,0,0,0,0,0,-1922051942,1422765615,12241.99292,1309952296,130995229.6,1,88872,3789,548,2034,1486,548,88872,1486,2034,297.05,3.31875,12.5375,40028.55,1926.55,16.00625,98767.19375,0.402835345,0.019329845,0.000161992,0.730580138,0.022886849,23,14
D:0| T0: 0.17| T1: 28.00| R0: 0.0| R1: 0.0| WTP: 0,0,0.173076923,28,0,0,0,0,0,-1141173493,699740192,30.09482132,1139668752,113966875.2,1,339,16,5,5,0,5,339,0,5,0.805194805,0.012987013,0.012987013,99795.20779,13.00649351,0.045454545,99997.74026,0.997978703,0.000131615,6.45172E-07,0,0.014749263,22,13
D:0| T0: 0.17| T1: 28.00| R0: 0.0| R1: 0.0| WTP: 0,0,0.173076923,28,0,0,0,0,0,-877077009.2,240885764,6.0931291,876772352.8,87677235.28,1,99,9,1,1,0,1,99,0,1,1.3046875,0,0,99939.54688,3.9609375,0.0078125,99999.63281,0.999401857,4.1628E-05,1.55039E-07,0,0.01010101,19,10
D:0| T0: 0.17| T1: 28.00| R0: 0.0| R1: 0.0| WTP: 0,0,0.173076923,28,0,0,0,0,0,-1751226524,2023806564,7473.239389,1377564554,137756455.4,1,64820,2923,579,1241,662,579,64820,662,1241,217.0898204,3.335329341,7.251497006,57969.91018,1628.628743,10.71856287,99283.88024,0.582960091,0.016284955,0.000109006,0.533440774,0.019145326,24,15
D:0| T0: 0.17| T1: 28.00| R0: 0.0| R1: 0.0| WTP: 0,0,0.173076923,28,0,0,0,0,0,-1409573787,1907493879,132.2933622,1402959119,140295911.9,1,938,34,22,22,0,22,938,0,22,1.761363636,0.051136364,0.051136364,99451.4375,32.5625,0.176136364,99987.76705,0.994641665,0.000326367,2.48613E-06,0,0.023454158,25,16
D:0| T0: 0.17| T1: 28.00| R0: 0.0| R1: 0.0| WTP: 0,0,0.173076923,28,0,0,0,0,0,-3132838401,1565815291,11847.00221,2540488291,254048829.1,2,90232,3917,1272,1968,696,1272,90232,696,1968,96.85968379,2.359683794,3.705533597,58284.50198,1426.205534,6.199604743,99143.99802,0.584828215,0.014374047,6.45105E-05,0.353658537,0.021810444,73,28
D:0| T0: 0.17| T1: 28.00| R0: 0.0| R1: 0.0| WTP: 0,0,0.173076923,28,0,0,0,0,0,-1772682733,784442364,343.1211169,1755526677,175552667.7,1,2611,121,57,57,0,57,2611,0,57,7.09223301,0.145631068,0.145631068,98276.67476,65.99029126,0.412621359,99967.82039,0.983102311,0.000659235,5.50875E-06,0,0.021830716,29,20
D:0| T0: 0.17| T1: 28.00| R0: 0.0| R1: 0.0| WTP: 0,0,0.173076923,28,0,0,0,0,0,-2026022510,206369745,9224.662745,1564789373,156478937.3,1,76953,3443,550,1532,982,550,76953,982,1532,238.8176796,2.928176796,8.303867403,48480.9116,1774.883978,11.3480663,99067.62431,0.487857087,0.017778876,0.00011528,0.640992167,0.019908256,26,17
D:0| T0: 0.17| T1: 28.00| R0: 0.0| R1: 0.0| WTP: 0,0,0.173076923,28,0,0,0,0,0,-2169931348,2087235992,11811.70151,1579346272,157934627.2,1,94449,4081,555,1962,1407,555,94449,1407,1962,284.9779006,2.983425414,10.68508287,32573.52486,2271.955801,13.75138122,98736.20994,0.327710743,0.022793562,0.00013965,0.717125382,0.020773116,26,17
D:0| T0: 0.17| T1: 28.00| R0: 0.0| R1: 0.0| WTP: 0,0,0.173076923,28,0,0,0,0,0,-2413545917,1019092536,795.0901621,2373791409,237379140.9,1,7491,319,132,132,0,132,7491,0,132,16.7983871,0.435483871,0.435483871,94738.0121,168.4798387,0.935483871,99912.95161,0.948251484,0.001681734,1.06092E-05,0,0.017621145,36,27
D:0| T0: 0.17| T1: 28.00| R0: 0.0| R1: 0.0| WTP: 0,0,0.173076923,28,0,0,0,0,0,-3045985952,1885906113,10389.20222,2526525841,252652584.1,2,77253,3242,1278,1726,448,1278,77253,448,1726,83.45286885,2.495901639,3.385245902,63999.22131,484.067623,6.004098361,99249.2541,0.643281907,0.004873294,6.19503E-05,0.259559676,0.022342174,70,28
D:0| T0: 0.17| T1: 28.00| R0: 0.0| R1: 0.0| WTP: 0,0,0.173076923,28,0,0,0,0,0,-1475893206,2028637200,1264.513638,1412667524,141266752.4,1,11082,498,207,210,3,207,11082,3,210,33.42528736,1.051724138,1.063218391,92742.43678,248.8793103,2.229885057,99875.66667,0.928634903,0.002479365,2.38523E-05,0.014285714,0.018951358,25,16
D:0| T0: 0.17| T1: 28.00| R0: 0.0| R1: 0.0| WTP: 0,0,0.173076923,28,0,0,0,0,0,-2193661260,181476086,10709.8204,1658170240,165817024,1,86739,3824,537,1779,1242,537,86739,1242,1779,249.2956989,2.806451613,9.424731183,39414.52688,2185.919355,12.32258065,98865.46237,0.396737754,0.021924178,0.000124957,0.698145025,0.020509805,27,18
D:0| T0: 0.17| T1: 28.00| R0: 0.0| R1: 0.0| WTP: 0,0,0.173076923,28,0,0,0,0,0,-2203342319,2097578470,10842.9697,1661193834,166119383.4,1,85558,3814,584,1801,1217,584,85558,1217,1801,259.1290323,3.059139785,9.548387097,40090.06452,2490.709677,12.67204301,98856.64516,0.403672229,0.024981195,0.000128687,0.675735702,0.021050048,27,18
D:0| T0: 0.17| T1: 28.00| R0: 0.0| R1: 0.0| WTP: 0,0,0.173076923,28,0,0,0,0,0,-3146942981,119646392,12194.18194,2537233884,253723388.4,2,86950,3787,1106,2026,920,1106,86950,920,2026,94.06187625,2.051896208,3.850299401,66883.52495,1098.802395,6.063872255,99280.72655,0.670349844,0.011076,6.3007E-05,0.454096742,0.023300748,72,28
D:0| T0: 0.17| T1: 28.00| R0: 0.0| R1: 0.0| WTP: 0,0,0.173076923,28,0,0,0,0,0,-1822268896,1298895859,11824.44223,1231046784,123104678.4,1,95331,4196,512,1964,1452,512,95331,1452,1964,353.56,3.333333333,12.93333333,35246.99333,2644.933333,16.35333333,98804.68,0.354356787,0.026513078,0.000165562,0.739307536,0.020601903,22,13
D:0| T0: 0.17| T1: 28.00| R0: 0.0| R1: 0.0| WTP: 0,0,0.173076923,28,0,0,0,0,0,-2537887848,1489316290,10625.0589,2006634903,200663490.3,1,82534,3668,529,1765,1236,529,82534,1236,1765,211.7887324,2.403755869,8.154929577,38400.00469,1348.258216,10.63849765,98764.79343,0.387276667,0.013528474,0.000108127,0.700283286,0.021385126,31,22
D:0| T0: 0.17| T1: 28.00| R0: 0.0| R1: 0.0| WTP: 0,0,0.173076923,28,0,0,0,0,0,-2717563507,855602142,14009.49354,2017088830,201708883,1,96194,3955,472,2328,1856,472,96194,1856,2328,236.6604651,2.153488372,10.74883721,26336.70233,1594.795349,12.94418605,98322.34419,0.265324005,0.016043383,0.000131127,0.797250859,0.024201094,31,22
D:0| T0: 0.17| T1: 28.00| R0: 0.0| R1: 0.0| WTP: 0,0,0.173076923,28,0,0,0,0,0,-2290824425,1438649896,3304.247164,2125612066,212561206.6,1,24979,1036,479,549,70,479,24979,70,549,52.61373391,1.922746781,2.210300429,83049.94421,545.1287554,4.244635193,99662.40773,0.833268084,0.005443653,4.40512E-05,0.127504554,0.021978462,33,24
D:0| T0: 0.17| T1: 28.00| R0: 0.0| R1: 0.0| WTP: 0,0,0.173076923,28,0,0,0,0,0,-1667490841,952489126,36.13731856,1665683975,166568397.5,1,393,13,6,6,0,6,393,0,6,1.036458333,0.005208333,0.005208333,99749.71354,16.3125,0.03125,99997.29688,0.997528192,0.000164252,6.21777E-07,0,0.015267176,28,19
D:0| T0: 0.17| T1: 28.00| R0: 0.0| R1: 0.0| WTP: 0,0,0.173076923,28,0,0,0,0,0,-1687488373,1550779155,12652.83926,1054846410,105484641,1,99140,4210,405,2102,1697,405,99140,1697,2102,388.0444444,2.925925926,15.45185185,25772.78519,2053.718519,18.45185185,98562.6,0.259796048,0.020577355,0.00018625,0.807326356,0.02120234,20,11
D:0| T0: 0.17| T1: 28.00| R0: 0.0| R1: 0.0| WTP: 0,0,0.173076923,28,0,0,0,0,0,-1584538183,607323321,120.3671534,1578519826,157851982.6,1,958,46,20,20,0,20,958,0,20,2.515957447,0.042553191,0.042553191,99350.77128,24.48404255,0.138297872,99988.26596,0.993634788,0.000245896,2.1166E-06,0,0.019832985,27,18
D:0| T0: 0.17| T1: 28.00| R0: 0.0| R1: 0.0| WTP: 0,0,0.173076923,28,0,0,0,0,0,-1763967924,2103646485,6320.595797,1447938134,144793813.4,1,48476,2088,518,1050,532,518,48476,532,1050,152.8176471,2.923529412,6.017647059,68788.1,861.6882353,9.047058824,99382.15294,0.691607142,0.008609496,9.21735E-05,0.506666667,0.021660203,25,16
D:0| T0: 0.17| T1: 28.00| R0: 0.0| R1: 0.0| WTP: 0,0,0.173076923,28,0,0,0,0,0,-1967351175,258120157,11146.97866,1410002242,141000224.2,1,97711,4438,441,1851,1410,441,97711,1410,1851,336.3151515,2.6,11.09090909,25085.55152,1505.909091,13.77575758,98682.07273,0.25287235,0.015096437,0.000139335,0.761750405,0.018943619,24,15
D:0| T0: 0.17| T1: 28.00| R0: 0.0| R1: 0.0| WTP: 0,0,0.173076923,28,0,0,0,0,0,-1881549754,1068951401,674.9467064,1847802418,184780241.8,1,6848,326,112,112,0,112,6848,0,112,19.8708134,0.435406699,0.435406699,95174.23445,127.6172249,0.976076555,99927.33971,0.952488261,0.001272629,1.06723E-05,0,0.01635514,30,21
D:0| T0: 0.17| T1: 28.00| R0: 0.0| R1: 0.0| WTP: 0,0,0.173076923,28,0,0,0,0,0,-3092575157,635956235,11166.26985,2534261665,253426166.5,2,85889,3663,964,1855,891,964,85889,891,1855,89.82086614,1.801181102,3.531496063,72890.71457,1283.145669,5.437007874,99468.63583,0.729747635,0.012923368,5.58985E-05,0.48032345,0.021597895,72,28
D:0| T0: 0.17| T1: 28.00| R0: 0.0| R1: 0.0| WTP: 0,0,0.173076923,28,0,0,0,0,0,-1056481164,1346693470,78.31500247,1052565414,105256541.4,1,830,35,13,13,0,13,830,0,13,3.167832168,0.034965035,0.034965035,99510.42657,29.68531469,0.104895105,99993.27972,0.995177696,0.00029731,1.80566E-06,0,0.015662651,21,12
D:0| T0: 0.17| T1: 28.00| R0: 0.0| R1: 0.0| WTP: 0,0,0.173076923,28,0,0,0,0,0,-2053644038,847102011,12959.21789,1405683144,140568314.4,1,98233,4205,472,2153,1681,472,98233,1681,2153,319.4573171,2.817073171,13,28185.04878,2044.310976,15.8597561,98563.80488,0.283633893,0.020520756,0.000160784,0.780771017,0.021917278,24,15
D:0| T0: 0.17| T1: 28.00| R0: 0.0| R1: 0.0| WTP: 0,0,0.173076923,28,0,0,0,0,0,-3140031775,812083272,12144.99044,2532782252,253278225.2,2,87294,3495,1797,2018,221,1797,87294,221,2018,85.38551859,3.33072407,3.741682975,50876.86106,1040.651663,7.285714286,98911.23092,0.512197247,0.010493748,7.52548E-05,0.109514371,0.023117282,73,28
D:0| T0: 0.17| T1: 28.00| R0: 0.0| R1: 0.0| WTP: 0,0,0.173076923,28,0,0,0,0,0,-2173799732,2146825809,11771.51154,1585224155,158522415.5,1,98874,4500,465,1955,1490,465,98874,1490,1955,310.3202247,2.556179775,10.8988764,22618.65169,1755.179775,13.51123596,98579.26404,0.228024452,0.017605376,0.000136496,0.762148338,0.01977264,26,17
D:0| T0: 0.17| T1: 28.00| R0: 0.0| R1: 0.0| WTP: 0,0,0.173076923,28,0,0,0,0,0,-2049126291,226186520,12851.40519,1406556032,140655603.2,1,97214,4231,468,2135,1667,468,97214,1667,2135,315.2619048,2.726190476,12.57738095,29346.85714,1687.755952,15.35714286,98566.32143,0.29534006,0.016944885,0.00015565,0.780796253,0.021961857,24,15
D:0| T0: 0.17| T1: 28.00| R0: 0.0| R1: 0.0| WTP: 0,0,0.173076923,28,0,0,0,0,0,-3129690042,1110225441,11757.49693,2541815196,254181519.6,2,90662,3980,1624,1953,329,1624,90662,329,1953,105.1702128,3.282978723,3.953191489,56657.74468,1486.546809,7.419148936,99126.98723,0.568887287,0.014980467,7.66654E-05,0.168458781,0.02154155,68,28
D:0| T0: 0.17| T1: 28.00| R0: 0.0| R1: 0.0| WTP: 0,0,0.173076923,28,0,0,0,0,0,-3043488919,1190767082,9986.473888,2544165225,254416522.5,2,92253,4176,1137,1658,521,1137,92253,521,1658,104.630303,2.171717172,3.197979798,58203.62626,997.610101,5.498989899,99292.2303,0.584268959,0.010038064,5.67965E-05,0.314234017,0.017972315,71,28
D:0| T0: 0.17| T1: 28.00| R0: 0.0| R1: 0.0| WTP: 0,0,0.173076923,28,0,0,0,0,0,-2049038391,2108234095,589.7016078,2019553310,201955331,1,3816,156,98,98,0,98,3816,0,98,9.366972477,0.28440367,0.28440367,97486.00917,107.4311927,0.747706422,99940.77523,0.975460291,0.001072089,8.95402E-06,0,0.025681342,32,23
D:0| T0: 0.17| T1: 28.00| R0: 0.0| R1: 0.0| WTP: 0,0,0.173076923,28,0,0,0,0,0,-2062506633,465621985,13044.7896,1410267153,141026715.3,1,98735,4381,480,2167,1687,480,98735,1687,2167,334.5272727,2.83030303,13.01212121,26112.41818,2058.369697,15.90909091,98516.55758,0.262930085,0.020662792,0.000161171,0.778495616,0.021947638,24,15
D:0| T0: 0.17| T1: 28.00| R0: 0.0| R1: 0.0| WTP: 0,0,0.173076923,28,0,0,0,0,0,-1470907198,1487072553,1168.372375,1412488579,141248857.9,1,11183,472,192,194,2,192,11183,2,194,33.1849711,1,1.011560694,93079.32948,235.1213873,2.115606936,99890.27746,0.931853345,0.00234256,2.22045E-05,0.010309278,0.017350863,25,16
D:0| T0: 0.17| T1: 28.00| R0: 0.0| R1: 0.0| WTP: 0,0,0.173076923,28,0,0,0,0,0,-2731172781,1213733847,4875.330653,2487406248,248740624.8,1,37564,1534,620,810,190,620,37564,190,810,73.66798419,2.304347826,3.015810277,73460.26087,625.9367589,5.466403162,99463.34783,0.738383356,0.006261691,5.65317E-05,0.234567901,0.021563199,37,28
D:0| T0: 0.17| T1: 28.00| R0: 0.0| R1: 0.0| WTP: 0,0,0.173076923,28,0,0,0,0,0,-2702535570,2003658337,5922.419548,2406414593,240641459.3,1,44748,1879,596,984,388,596,44748,388,984,90.98785425,2.311740891,3.862348178,67670.89474,734.1012146,6.271255061,99330.82591,0.680937101,0.007347291,6.40309E-05,0.394308943,0.02198981,36,27
D:0| T0: 0.17| T1: 28.00| R0: 0.0| R1: 0.0| WTP: 0,0,0.173076923,28,0,0,0,0,0,-1056628393,1170868072,84.26888432,1052414949,105241494.9,1,737,34,14,14,0,14,737,0,14,2.5,0.027777778,0.027777778,99553.38889,29.02777778,0.111111111,99993.40972,0.995606114,0.000290569,1.93116E-06,0,0.018995929,21,12
D:0| T0: 0.17| T1: 28.00| R0: 0.0| R1: 0.0| WTP: 0,0,0.173076923,28,0,0,0,0,0,-2356850640,569919592,11915.80294,1761060493,176106049.3,1,99253,4499,426,1979,1553,426,99253,1553,1979,291.0471204,2.178010471,10.28272251,19861.66492,1353.65445,12.51308901,98501.8377,0.200403918,0.013586368,0.000126488,0.784739768,0.019938944,28,19
D:0| T0: 0.17| T1: 28.00| R0: 0.0| R1: 0.0| WTP: 0,0,0.173076923,28,0,0,0,0,0,-2101805493,1833180623,4362.033463,1883703819,188370381.9,1,40935,1924,502,724,222,502,40935,222,724,121.7902439,2.292682927,3.336585366,71794.22927,925.3512195,5.795121951,99541.13171,0.721111564,0.009242055,5.97295E-05,0.306629834,0.017686576,30,21
D:0| T0: 0.17| T1: 28.00| R0: 0.0| R1: 0.0| WTP: 0,0,0.173076923,28,0,0,0,0,0,-2250428039,1123666637,13397.49232,1580553424,158055342.4,1,97045,4088,484,2226,1742,484,97045,1742,2226,292.4382022,2.646067416,12.37640449,26979.19101,1643.123596,15.08988764,98445.79213,0.271790086,0.016507599,0.000153066,0.782569632,0.022937812,26,17
D:0| T0: 0.17| T1: 28.00| R0: 0.0| R1: 0.0| WTP: 0,0,0.173076923,28,0,0,0,0,0,-2712613295,1682024981,9030.975062,2261064541,226106454.1,1,71675,3165,735,1500,765,735,71675,765,1500,166.8791667,2.966666667,6.091666667,50887.09167,2447.845833,9.158333333,99065.55417,0.512325812,0.024550112,9.34585E-05,0.51,0.020927799,34,25
D:0| T0: 0.17| T1: 28.00| R0: 0.0| R1: 0.0| WTP: 0,0,0.173076923,28,0,0,0,0,0,-3145222538,1687523543,12081.34846,2541155115,254115511.5,2,90989,3991,1073,2007,934,1073,90989,934,2007,107.9738562,2.191721133,4.204793028,65529.71895,754.6797386,6.533769063,99296.60784,0.657060136,0.007606107,6.75976E-05,0.465371201,0.022057611,66,28
D:0| T0: 0.17| T1: 28.00| R0: 0.0| R1: 0.0| WTP: 0,0,0.173076923,28,0,0,0,0,0,-2098517827,178034412,12141.87123,1491424265,149142426.5,1,94595,4091,473,2017,1544,473,94595,1544,2017,302.4882353,2.705882353,11.71176471,32179.84706,1957.470588,14.5,98671.00588,0.323884412,0.01964123,0.000147066,0.765493307,0.02132248,25,16
D:0| T0: 0.17| T1: 28.00| R0: 0.0| R1: 0.0| WTP: 0,0,0.173076923,28,0,0,0,0,0,-1965558549,739490003,11252.80218,1402918440,140291844,1,93004,4063,472,1869,1397,472,93004,1397,1869,315.3580247,2.858024691,11.41358025,35432.75926,1602.95679,14.30864198,98812.0679,0.356447524,0.016067527,0.000144941,0.747458534,0.02009591,24,15
D:0| T0: 0.17| T1: 28.00| R0: 0.0| R1: 0.0| WTP: 0,0,0.173076923,28,0,0,0,0,0,-1973734689,178482706,8510.628926,1548203243,154820324.3,1,63172,2774,540,1414,874,540,63172,874,1414,187.3446328,2.95480226,7.836158192,57986.71186,1529.644068,10.87570621,99144.86441,0.58376196,0.01531079,0.000110547,0.618104668,0.022383334,26,17
D:0| T0: 0.17| T1: 28.00| R0: 0.0| R1: 0.0| WTP: 0,0,0.173076923,28,0,0,0,0,0,-2022576101,1919366370,3196.185014,1862766851,186276685.1,1,24018,1000,446,531,85,446,24018,85,531,59.85990338,2.033816425,2.429951691,84146.29469,401.7487923,4.599033816,99674.77295,0.844168403,0.004010565,4.70942E-05,0.16007533,0.022109339,30,21
D:0| T0: 0.17| T1: 28.00| R0: 0.0| R1: 0.0| WTP: 0,0,0.173076923,28,0,0,0,0,0,-1981487002,1819796913,11429.23864,1410025070,141002507,1,97451,4460,447,1898,1451,447,97451,1451,1898,331.8562874,2.622754491,11.25149701,29956.10778,2402.502994,13.91616766,98757.13174,0.301268217,0.024087167,0.000140892,0.764488936,0.019476455,24,15
D:0| T0: 0.17| T1: 28.00| R0: 0.0| R1: 0.0| WTP: 0,0,0.173076923,28,0,0,0,0,0,-3164080068,1866591913,12406.45208,2543757464,254375746.4,2,95412,4067,992,2061,1069,992,95412,1069,2061,114.5637584,2.064876957,4.420581655,65151.81208,1766.223714,6.637583893,99319.65548,0.652187574,0.017800069,6.88294E-05,0.518680252,0.021601056,64,28
D:0| T0: 0.17| T1: 28.00| R0: 0.0| R1: 0.0| WTP: 0,0,0.173076923,28,0,0,0,0,0,-1854053111,1219425989,12401.84865,1233960679,123396067.9,1,99237,4466,445,2060,1615,445,99237,1615,2060,367.2281879,2.899328859,13.69798658,25378.61074,1725.073826,16.67785235,98582.61074,0.255690659,0.017298075,0.000168699,0.783980583,0.020758386,22,13
D:0| T0: 0.17| T1: 28.00| R0: 0.0| R1: 0.0| WTP: 0,0,0.173076923,28,0,0,0,0,0,-2081001749,502409586,11734.42741,1494280379,149428037.9,1,97438,4267,475,1949,1474,475,97438,1474,1949,306.0287356,2.655172414,11.08045977,28094.3908,2257.413793,13.83333333,98682,0.282737,0.022643698,0.00013985,0.756285274,0.020002463,25,16
D:0| T0: 0.17| T1: 28.00| R0: 0.0| R1: 0.0| WTP: 0,0,0.173076923,28,0,0,0,0,0,-1956592972,1405887957,9608.669848,1476159480,147615948,1,76415,3438,512,1596,1084,512,76415,1084,1596,251.7869822,2.940828402,9.313609467,49101.85207,1371.710059,12.32544379,99030.04142,0.494238164,0.013737337,0.000124981,0.679197995,0.020885952,25,16
D:0| T0: 0.17| T1: 28.00| R0: 0.0| R1: 0.0| WTP: 0,0,0.173076923,28,0,0,0,0,0,-2094420002,283033753,12288.32318,1480003843,148000384.3,1,87277,3583,531,2042,1511,531,87277,1511,2042,255.9884393,2.994219653,11.67052023,38554.0578,1341.491329,14.74566474,98675.24855,0.388482073,0.013467474,0.000149366,0.739960823,0.023396771,25,16
D:0| T0: 0.17| T1: 28.00| R0: 0.0| R1: 0.0| WTP: 0,0,0.173076923,28,0,0,0,0,0,-2442906241,1083157068,5947.128611,2145549811,214554981.1,1,44084,1891,611,988,377,611,44084,377,988,104.8193833,2.528634361,4.158590308,68445.04405,986.5770925,6.889867841,99350.94714,0.688615203,0.009869687,7.0484E-05,0.381578947,0.022411759,33,24
D:0| T0: 0.17| T1: 28.00| R0: 0.0| R1: 0.0| WTP: 0,0,0.173076923,28,0,0,0,0,0,-2195326163,1988704626,3189.468904,2035852718,203585271.8,1,21682,887,470,530,60,470,21682,60,530,49.40358744,1.97309417,2.228699552,85041.75785,249.4080717,4.340807175,99658.37668,0.853324847,0.002491796,4.47597E-05,0.113207547,0.02444875,32,23
D:0| T0: 0.17| T1: 28.00| R0: 0.0| R1: 0.0| WTP: 0,0,0.173076923,28,0,0,0,0,0,-1782919123,884761309,12743.97338,1145720455,114572045.5,1,99069,4387,436,2117,1681,436,99069,1681,2117,369.3673469,2.911564626,14.29251701,24302.81633,1752.081633,17.2585034,98511.2381,0.245066138,0.017571463,0.00017431,0.794048181,0.021368945,21,12
D:0| T0: 0.17| T1: 28.00| R0: 0.0| R1: 0.0| WTP: 0,0,0.173076923,28,0,0,0,0,0,-1357033682,533485933,716.7577695,1321195794,132119579.4,1,6560,306,119,119,0,119,6560,0,119,22.79012346,0.617283951,0.617283951,95949.82099,110.5246914,1.351851852,99933.99383,0.960166,0.001101319,1.46094E-05,0,0.018140244,24,15
D:0| T0: 0.17| T1: 28.00| R0: 0.0| R1: 0.0| WTP: 0,0,0.173076923,28,0,0,0,0,0,-1541710028,632196071,897.0507331,1496857491,149685749.1,1,7021,309,148,149,1,148,7021,1,149,21.58988764,0.724719101,0.730337079,95478.35393,102.4719101,1.584269663,99911.10674,0.955671149,0.001022034,1.66039E-05,0.006711409,0.021222048,26,17
D:0| T0: 0.17| T1: 28.00| R0: 0.0| R1: 0.0| WTP: 0,0,0.173076923,28,0,0,0,0,0,-2132995666,393400457,12797.00807,1493145262,149314526.2,1,96342,4175,447,2126,1679,447,96342,1679,2126,304.3430233,2.540697674,12.26162791,30650.72093,1753.767442,14.8372093,98579.56395,0.30840584,0.017605094,0.000150281,0.789746002,0.022067219,25,16
D:0| T0: 0.17| T1: 28.00| R0: 0.0| R1: 0.0| WTP: 0,0,0.173076923,28,0,0,0,0,0,-1929437168,398973227,10756.71502,1391601417,139160141.7,1,82399,3546,541,1787,1246,541,82399,1246,1787,262.9107143,3.136904762,10.48809524,44001.22024,1467.214286,13.69642857,98895.46429,0.443037157,0.014703408,0.000138964,0.697257974,0.021687156,24,15
D:0| T0: 0.17| T1: 28.00| R0: 0.0| R1: 0.0| WTP: 0,0,0.173076923,28,0,0,0,0,0,-3076505550,1402256491,10818.65314,2535572893,253557289.3,2,84567,3692,1693,1797,104,1693,84567,104,1797,83.18727273,2.903636364,3.076363636,49836.92364,971.6218182,6.149090909,98976.68,0.50193538,0.009788,6.39084E-05,0.057874235,0.021249424,79,28
D:0| T0: 0.17| T1: 28.00| R0: 0.0| R1: 0.0| WTP: 0,0,0.173076923,28,0,0,0,0,0,-2499058230,2102527413,9944.961666,2001810146,200181014.6,1,75044,3333,654,1652,998,654,75044,998,1652,199.9952607,3,7.696682464,47394.36019,2057.260664,10.81042654,98944.08531,0.4775157,0.020634822,0.00010969,0.604116223,0.022013752,31,22
D:0| T0: 0.17| T1: 28.00| R0: 0.0| R1: 0.0| WTP: 0,0,0.173076923,28,0,0,0,0,0,-2223863970,1748031099,11322.31507,1657748216,165774821.6,1,84820,3584,627,1881,1254,627,84820,1254,1881,249.6793478,3.331521739,10.09782609,42318.53804,2486.804348,13.48369565,98840.16304,0.42603791,0.024958767,0.000136848,0.666666667,0.022176373,27,18
D:0| T0: 0.17| T1: 28.00| R0: 0.0| R1: 0.0| WTP: 0,0,0.173076923,28,0,0,0,0,0,-2430745683,1946754629,1125.618252,2374464770,237446477,1,8598,349,187,187,0,187,8598,0,187,18.12195122,0.62601626,0.62601626,93951.59756,134.6626016,1.398373984,99876.96341,0.940719103,0.001344662,1.51554E-05,0,0.021749244,36,27
D:0| T0: 0.17| T1: 28.00| R0: 0.0| R1: 0.0| WTP: 0,0,0.173076923,28,0,0,0,0,0,-2053296278,2097712204,2149.705652,1945810995,194581099.5,1,17589,805,348,357,9,348,17589,9,357,45.97222222,1.444444444,1.49537037,88200.31481,251.962963,3.111111111,99778.14815,0.883997055,0.002514567,3.25451E-05,0.025210084,0.020296776,31,22
D:0| T0: 0.17| T1: 28.00| R0: 0.0| R1: 0.0| WTP: 0,0,0.173076923,28,0,0,0,0,0,-3079035551,1198827119,10907.80494,2533645304,253364530.4,2,84394,3659,917,1812,895,917,84394,895,1812,87.43352601,1.658959538,3.348747592,73718.89981,1039.83815,5.125240848,99482.19268,0.738006916,0.010470847,5.29556E-05,0.49392936,0.021470721,75,28
D:0| T0: 0.17| T1: 28.00| R0: 0.0| R1: 0.0| WTP: 0,0,0.173076923,28,0,0,0,0,0,-1404184043,109253198,30.1143433,1402678326,140267832.6,1,294,12,5,5,0,5,294,0,5,0.91160221,0.005524862,0.005524862,99818.67956,11.40331492,0.027624309,99997,0.998220311,0.000115882,5.49461E-07,0,0.017064846,25,16
D:0| T0: 0.17| T1: 28.00| R0: 0.0| R1: 0.0| WTP: 0,0,0.173076923,28,0,0,0,0,0,-1438170899,314481292,614.2164209,1407460078,140746007.8,1,4927,215,102,102,0,102,4927,0,102,17.11242604,0.49704142,0.49704142,96855.05917,87.1183432,1.100591716,99941.61538,0.969148319,0.000868848,1.20058E-05,0,0.020702253,25,16
D:0| T0: 0.17| T1: 32.00| R0: 0.0| R1: 0.0| WTP: 0,0,0.173076923,32,0,0,0,0,0,-1491858231,1178568022,30.12067847,1490352197,149035219.7,1,312,15,5,5,0,5,312,0,5,0.978378378,0,0,99803.43784,8.740540541,0.027027027,99996.95676,0.998068409,8.91422E-05,5.37645E-07,0,0.01607717,26,17
D:0| T0: 0.17| T1: 32.00| R0: 0.0| R1: 0.0| WTP: 0,0,0.173076923,32,0,0,0,0,0,-1906711473,2029998696,11746.56513,1319383216,131938321.6,1,95757,4310,471,1951,1480,471,95757,1480,1951,338.5,2.917721519,12.23417722,34133.97468,2047.259494,15.20253165,98787.36076,0.343134047,0.020521127,0.000153792,0.758585341,0.02037449,23,14
D:0| T0: 0.17| T1: 32.00| R0: 0.0| R1: 0.0| WTP: 0,0,0.173076923,32,0,0,0,0,0,-2792176117,776062361,10592.82938,2262534648,226253464.8,1,78227,3339,743,1760,1017,743,78227,1017,1760,168.219917,2.987551867,7.157676349,45972.9751,2014.377593,10.2406639,98885.53527,0.463070186,0.020230734,0.00010437,0.577840909,0.022498626,34,25
D:0| T0: 0.17| T1: 32.00| R0: 0.0| R1: 0.0| WTP: 0,0,0.173076923,32,0,0,0,0,0,-1494647557,1813046880,78.28705192,1490733204,149073320.4,1,566,31,13,13,0,13,566,0,13,2.232044199,0.022099448,0.022099448,99628.38674,18.9558011,0.093922652,99992.45856,0.996365391,0.000191001,1.42865E-06,0,0.022968198,26,17
D:0| T0: 0.17| T1: 32.00| R0: 0.0| R1: 0.0| WTP: 0,0,0.173076923,32,0,0,0,0,0,-1432585441,2032407216,2029.219858,1331124449,133112444.9,1,17270,787,311,337,26,311,17270,26,337,56.13333333,1.757575758,1.903030303,89330.33939,364.8,3.793939394,99814.11515,0.894983692,0.003633692,3.90999E-05,0.077151335,0.019513607,24,15
D:0| T0: 0.17| T1: 32.00| R0: 0.0| R1: 0.0| WTP: 0,0,0.173076923,32,0,0,0,0,0,-789830023.7,1507873352,18.03885983,788928080.7,78892808.07,1,53,5,3,3,0,3,53,0,3,0.346153846,0,0,99969.92308,3.353846154,0.023076923,99999.23846,0.999708164,3.52674E-05,4.5802E-07,0,0.056603774,18,9
D:0| T0: 0.17| T1: 32.00| R0: 0.0| R1: 0.0| WTP: 0,0,0.173076923,32,0,0,0,0,0,-968754026.9,1855899401,78.28915632,964839569,96483956.9,1,825,38,13,13,0,13,825,0,13,2.927536232,0.036231884,0.036231884,99516.06522,21.85507246,0.115942029,99992.72464,0.995239322,0.000219585,1.87061E-06,0,0.015757576,20,11
D:0| T0: 0.17| T1: 32.00| R0: 0.0| R1: 0.0| WTP: 0,0,0.173076923,32,0,0,0,0,0,-2279444171,1819459251,7663.077644,1896290289,189629028.9,1,60030,2612,568,1273,705,568,60030,705,1273,154.3495146,2.669902913,6.04368932,58086.92233,1047.548544,8.82038835,99174.00971,0.584913616,0.010488404,8.9509E-05,0.553809898,0.021206064,30,21
D:0| T0: 0.17| T1: 32.00| R0: 0.0| R1: 0.0| WTP: 0,0,0.173076923,32,0,0,0,0,0,-879717430.9,909791748,48.30141192,877302360.3,87730236.03,1,712,35,8,8,0,8,712,0,8,3.715384615,0.023076923,0.023076923,99597.11538,18.2,0.092307692,99996.43846,0.996011817,0.000183516,1.22141E-06,0,0.011235955,19,10
D:0| T0: 0.17| T1: 32.00| R0: 0.0| R1: 0.0| WTP: 0,0,0.173076923,32,0,0,0,0,0,-2768908769,1339092841,5566.990827,2490559227,249055922.7,1,38479,1611,616,925,309,616,38479,309,925,79.49027237,2.284046693,3.455252918,72084.45136,538.9610895,5.859922179,99363.0856,0.725226854,0.005394489,6.00101E-05,0.334054054,0.024039711,37,28
D:0| T0: 0.17| T1: 32.00| R0: 0.0| R1: 0.0| WTP: 0,0,0.173076923,32,0,0,0,0,0,-2030729947,1365866345,12461.40314,1407659790,140765979,1,97538,4342,473,2070,1597,473,97538,1597,2070,323.5361446,2.777108434,12.3313253,30129.07229,1838.403614,15.18674699,98646.18072,0.303029949,0.018449069,0.000153835,0.771497585,0.021222498,24,15
D:0| T0: 0.17| T1: 32.00| R0: 0.0| R1: 0.0| WTP: 0,0,0.173076923,32,0,0,0,0,0,-3410623454,825453433,10446.88161,2888279373,288827937.3,2,85896,3856,1412,1735,323,1412,85896,323,1735,89.64650284,2.508506616,3.098298677,57713.7656,826.2873346,5.7731569,99209.40076,0.580332573,0.008318135,5.98857E-05,0.186167147,0.020198845,76,32
D:0| T0: 0.17| T1: 32.00| R0: 0.0| R1: 0.0| WTP: 0,0,0.173076923,32,0,0,0,0,0,-1951386180,939711378,12599.97694,1321387333,132138733.3,1,97565,4337,449,2093,1644,449,97565,1644,2093,352.1225806,2.806451613,13.36129032,32566.96774,2472.883871,16.23870968,98693.54839,0.327314107,0.024802877,0.000164638,0.785475394,0.021452365,23,14
D:0| T0: 0.17| T1: 32.00| R0: 0.0| R1: 0.0| WTP: 0,0,0.173076923,32,0,0,0,0,0,-3460615397,638950699,11313.71564,2894929615,289492961.5,2,90393,4096,1145,1879,734,1145,90393,734,1879,94.42595978,1.946983547,3.263254113,67184.35832,1044.49543,5.361974406,99351.45704,0.673676587,0.010525451,5.56807E-05,0.390633316,0.020787008,79,32
D:0| T0: 0.17| T1: 32.00| R0: 0.0| R1: 0.0| WTP: 0,0,0.173076923,32,0,0,0,0,0,-1898766432,938699148,1005.479527,1848492455,184849245.5,1,7893,374,167,167,0,167,7893,0,167,21.25358852,0.669856459,0.669856459,94570.48804,126.861244,1.473684211,99894.5311,0.946752186,0.001265693,1.59175E-05,0,0.021157988,30,21
D:0| T0: 0.17| T1: 32.00| R0: 0.0| R1: 0.0| WTP: 0,0,0.173076923,32,0,0,0,0,0,-1841682443,121790188,18.05415653,1840779735,184077973.5,1,194,10,3,3,0,3,194,0,3,0.349056604,0,0,99886.26415,7.735849057,0.014150943,99998.73585,0.998877489,7.92026E-05,2.81693E-07,0,0.015463918,30,21
D:0| T0: 0.17| T1: 32.00| R0: 0.0| R1: 0.0| WTP: 0,0,0.173076923,32,0,0,0,0,0,-2726625721,1331335240,9325.005643,2260375439,226037543.9,1,73333,3203,757,1549,792,757,73333,792,1549,168.8675214,3.115384615,6.444444444,48747.92735,2061.089744,9.670940171,99013.54274,0.491023269,0.020674628,9.89128E-05,0.511297611,0.021122823,34,25
D:0| T0: 0.17| T1: 32.00| R0: 0.0| R1: 0.0| WTP: 0,0,0.173076923,32,0,0,0,0,0,-2163737738,470935411,13362.35035,1495620221,149562022.1,1,98775,4173,475,2220,1745,475,98775,1745,2220,312.5,2.697674419,12.81395349,24473.4186,1485.94186,15.54651163,98426.86628,0.246574405,0.014924275,0.000157498,0.786036036,0.022475323,25,16
D:0| T0: 0.17| T1: 32.00| R0: 0.0| R1: 0.0| WTP: 0,0,0.173076923,32,0,0,0,0,0,-3500975983,823434397,12189.33021,2891509473,289150947.3,2,89959,3969,966,2025,1059,966,89959,1059,2025,99.5915493,1.828973843,3.93360161,69938.45272,926.1368209,5.875251509,99373.95372,0.700727915,0.009334308,6.06482E-05,0.522962963,0.022510255,71,32
D:0| T0: 0.17| T1: 32.00| R0: 0.0| R1: 0.0| WTP: 0,0,0.173076923,32,0,0,0,0,0,-1147243496,493045351,132.4932633,1140618833,114061883.3,1,1358,62,22,22,0,22,1358,0,22,4.570469799,0.073825503,0.073825503,99178.87919,23.2147651,0.228187919,99988.9396,0.991908714,0.000233087,2.93363E-06,0,0.016212233,22,13
D:0| T0: 0.17| T1: 32.00| R0: 0.0| R1: 0.0| WTP: 0,0,0.173076923,32,0,0,0,0,0,-3423567846,1700216563,10645.83139,2891276277,289127627.7,2,87072,4033,915,1768,853,915,87072,853,1768,101.3482688,1.729124236,3.439918534,72479.85743,957.2647658,5.301425662,99483.76986,0.725761289,0.009636138,5.50023E-05,0.482466063,0.020305035,71,32
D:0| T0: 0.17| T1: 32.00| R0: 0.0| R1: 0.0| WTP: 0,0,0.173076923,32,0,0,0,0,0,-1699750614,1744119059,3565.528496,1521474189,152147418.9,1,31573,1438,445,592,147,445,31573,147,592,99.06043956,2.307692308,3.093406593,79206.44505,480.7417582,5.543956044,99645.01648,0.794821436,0.004795986,5.68324E-05,0.248310811,0.018750198,26,17
D:0| T0: 0.17| T1: 32.00| R0: 0.0| R1: 0.0| WTP: 0,0,0.173076923,32,0,0,0,0,0,-2637402637,2036906360,138.4339748,2630480938,263048093.8,1,937,44,23,23,0,23,937,0,23,2.098540146,0.025547445,0.025547445,99364.10219,24.20437956,0.105839416,99985.16788,0.993795662,0.000243338,1.67291E-06,0,0.024546425,39,30
D:0| T0: 0.17| T1: 32.00| R0: 0.0| R1: 0.0| WTP: 0,0,0.173076923,32,0,0,0,0,0,-2896759025,809704121,1583.620931,2817577978,281757797.8,2,12835,557,263,263,0,263,12835,0,263,24.24252492,0.704318937,0.704318937,91370.30897,221.2724252,1.604651163,99831.9402,0.915263864,0.002210643,1.74397E-05,0,0.020490845,42,32
D:0| T0: 0.17| T1: 32.00| R0: 0.0| R1: 0.0| WTP: 0,0,0.173076923,32,0,0,0,0,0,-2784244625,1219866412,8689.013898,2349793930,234979393,1,72235,3207,716,1443,727,716,72235,727,1443,168.6735537,2.851239669,5.82231405,47027.10744,2452.42562,8.79338843,99033.02066,0.473864652,0.024589884,8.9506E-05,0.503811504,0.019976466,35,26
D:0| T0: 0.17| T1: 32.00| R0: 0.0| R1: 0.0| WTP: 0,0,0.173076923,32,0,0,0,0,0,-880548875.2,843498920,72.19973601,876938888.4,87693888.84,1,647,29,12,12,0,12,647,0,12,1.92481203,0.015037594,0.015037594,99623.25564,22.4887218,0.127819549,99993.54887,0.996302547,0.000225537,1.79114E-06,0,0.018547141,19,10
D:0| T0: 0.17| T1: 32.00| R0: 0.0| R1: 0.0| WTP: 0,0,0.173076923,32,0,0,0,0,0,-2524679514,107351963,1245.829185,2462388055,246238805.5,1,8161,347,207,207,0,207,8161,0,207,17.71705426,0.689922481,0.689922481,94185.12791,220.0503876,1.457364341,99867.32171,0.94314445,0.002196296,1.60006E-05,0,0.025364539,37,28
D:0| T0: 0.17| T1: 32.00| R0: 0.0| R1: 0.0| WTP: 0,0,0.173076923,32,0,0,0,0,0,-2866332041,773789021,1077.470422,2812458520,281245852,2,8545,375,179,179,0,179,8545,0,179,14.53020134,0.453020134,0.453020134,94003.05369,197.0033557,1.080536913,99885.07047,0.941148831,0.001967412,1.19837E-05,0,0.020950375,43,32
D:0| T0: 0.17| T1: 32.00| R0: 0.0| R1: 0.0| WTP: 0,0,0.173076923,32,0,0,0,0,0,-2926284971,850936611,2166.299289,2817970006,281797000.6,2,15098,619,353,360,7,353,15098,7,360,23.84590164,1,1.019672131,88922.51475,261.6196721,2.213114754,99749.76393,0.891492083,0.002614122,2.33417E-05,0.019444444,0.023844218,44,32
D:0| T0: 0.17| T1: 32.00| R0: 0.0| R1: 0.0| WTP: 0,0,0.173076923,32,0,0,0,0,0,-2208661717,1701318364,6440.879931,1886617720,188661772,1,48546,2066,593,1070,477,593,48546,477,1070,128.1617647,2.799019608,5.098039216,66123.78431,1013.656863,8.014705882,99316.60294,0.665356634,0.010138231,8.15597E-05,0.445794393,0.022040951,30,21
D:0| T0: 0.17| T1: 32.00| R0: 0.0| R1: 0.0| WTP: 0,0,0.173076923,32,0,0,0,0,0,-1140198407,778708269,12.05544501,1139595635,113959563.5,1,160,9,2,2,0,2,160,0,2,0.577181208,0,0,99907.56376,7.577181208,0.013422819,99999.52349,0.999082926,7.74669E-05,2.66668E-07,0,0.012578616,22,13
D:0| T0: 0.17| T1: 32.00| R0: 0.0| R1: 0.0| WTP: 0,0,0.173076923,32,0,0,0,0,0,-1581914065,1391938506,1619.063448,1500960893,150096089.3,1,12213,490,265,269,4,265,12213,4,269,34.41242938,1.322033898,1.333333333,91991.17514,246.559322,2.870056497,99838.23164,0.921450195,0.002457106,3.00386E-05,0.014869888,0.02202571,26,17
D:0| T0: 0.17| T1: 32.00| R0: 0.0| R1: 0.0| WTP: 0,0,0.173076923,32,0,0,0,0,0,-966359998.7,43418681,36.15789548,964552103.9,96455210.39,1,448,22,6,6,0,6,448,0,6,1.766423358,0,0,99738.22628,18.38686131,0.04379562,99996.93431,0.997417343,0.000185078,8.69587E-07,0,0.013392857,20,11
D:0| T0: 0.17| T1: 32.00| R0: 0.0| R1: 0.0| WTP: 0,0,0.173076923,32,0,0,0,0,0,-2757534997,817384966,13042.80165,2105394915,210539491.5,1,97822,4117,441,2167,1726,441,97822,1726,2167,235.1506849,1.96803653,9.808219178,20561.99087,1216.515982,11.82648402,98330.76712,0.207488953,0.012227703,0.000119801,0.796492847,0.022152481,32,23
D:0| T0: 0.17| T1: 32.00| R0: 0.0| R1: 0.0| WTP: 0,0,0.173076923,32,0,0,0,0,0,-1933910598,762053968,12269.39796,1320440700,132044070,1,95458,4290,497,2038,1541,497,95458,1541,2038,339.6918239,3.062893082,12.68553459,32651.35849,1878.163522,15.80503145,98698.81761,0.328496954,0.018836603,0.000160036,0.756133464,0.021349704,23,14
D:0| T0: 0.17| T1: 32.00| R0: 0.0| R1: 0.0| WTP: 0,0,0.173076923,32,0,0,0,0,0,-2580493242,1692506311,638.7625143,2548555116,254855511.6,1,6143,287,106,106,0,106,6143,0,106,14.67041199,0.288389513,0.288389513,95765.45318,154.3146067,0.685393258,99933.11236,0.958329567,0.001540373,7.9145E-06,0,0.017255413,38,29
D:0| T0: 0.17| T1: 32.00| R0: 0.0| R1: 0.0| WTP: 0,0,0.173076923,32,0,0,0,0,0,-615459852.2,1037620300,36.0634779,613656678.3,61365667.83,1,189,3,6,6,0,6,189,0,6,0.5625,0,0,99899.99107,6.258928571,0.0625,99997.875,0.999023061,6.41604E-05,1.06197E-06,0,0.031746032,16,7
D:0| T0: 0.17| T1: 32.00| R0: 0.0| R1: 0.0| WTP: 0,0,0.173076923,32,0,0,0,0,0,-1528169582,301400999,656.3266049,1495353251,149535325.1,1,5263,243,109,109,0,109,5263,0,109,16.64835165,0.467032967,0.467032967,96524.47802,120.7802198,1.054945055,99935.81319,0.965902233,0.001204021,1.19188E-05,0,0.020710621,26,17
D:0| T0: 0.17| T1: 32.00| R0: 0.0| R1: 0.0| WTP: 0,0,0.173076923,32,0,0,0,0,0,-2510059671,1868336855,8579.025629,2081108389,208110838.9,1,67252,2898,610,1425,815,610,67252,815,1425,171.0182648,2.689497717,6.365296804,52262.28311,1195.570776,9.155251142,99064.35616,0.526522568,0.011982025,9.31687E-05,0.571929825,0.021188961,32,23
D:0| T0: 0.17| T1: 32.00| R0: 0.0| R1: 0.0| WTP: 0,0,0.173076923,32,0,0,0,0,0,-2224097217,1868498144,8223.015062,1812946464,181294646.4,1,62583,2729,635,1366,731,635,62583,731,1366,168.8325123,3.019704433,6.581280788,57170.52709,1278.660099,9.684729064,99143.84236,0.575684899,0.012807541,9.877E-05,0.535139092,0.021827014,29,20
D:0| T0: 0.17| T1: 32.00| R0: 0.0| R1: 0.0| WTP: 0,0,0.173076923,32,0,0,0,0,0,-1851510385,2101566889,192.5684389,1841881963,184188196.3,1,1307,54,32,32,0,32,1307,0,32,3.470588235,0.078431373,0.078431373,99127.97059,35.24019608,0.230392157,99980.40686,0.991485172,0.000352835,3.12242E-06,0,0.02448355,30,21
D:0| T0: 0.17| T1: 32.00| R0: 0.0| R1: 0.0| WTP: 0,0,0.173076923,32,0,0,0,0,0,-1968416855,1665097450,13001.34028,1318349841,131834984.1,1,98303,4245,438,2160,1722,438,98303,1722,2160,335.0573248,2.732484076,13.63694268,28653.10191,2147.821656,16.41401274,98558.82803,0.28833457,0.021555904,0.000166186,0.797222222,0.02197288,23,14
D:0| T0: 0.17| T1: 32.00| R0: 0.0| R1: 0.0| WTP: 0,0,0.173076923,32,0,0,0,0,0,-1883626195,1716179948,11242.80387,1321486001,132148600.1,1,98040,4376,478,1867,1389,478,98040,1389,1867,349.6815287,2.98089172,11.75159236,31126.16561,2151.77707,14.78343949,98819.96815,0.312876334,0.021562003,0.000149784,0.74397429,0.019043248,23,14
D:0| T0: 0.17| T1: 32.00| R0: 0.0| R1: 0.0| WTP: 0,0,0.173076923,32,0,0,0,0,0,-1161076997,1560278715,391.0284409,1141525574,114152557.4,1,2287,99,65,65,0,65,2287,0,65,7.272151899,0.284810127,0.284810127,98698.41139,47.56962025,0.696202532,99967.28481,0.987315533,0.000475487,8.17863E-06,0,0.028421513,22,13
D:0| T0: 0.17| T1: 32.00| R0: 0.0| R1: 0.0| WTP: 0,0,0.173076923,32,0,0,0,0,0,-2330459506,991019385,10124.37815,1824240598,182424059.8,1,75581,3192,610,1682,1072,610,75581,1072,1682,207.2182741,3.015228426,8.401015228,47832.03046,2275.329949,11.49238579,98948.60914,0.48181966,0.02281456,0.000116747,0.637336504,0.02225427,29,20
D:0| T0: 0.17| T1: 32.00| R0: 0.0| R1: 0.0| WTP: 0,0,0.173076923,32,0,0,0,0,0,-3448532152,118052103,11168.25726,2890119289,289011928.9,2,86194,3766,1669,1855,186,1669,86194,186,1855,84.05933682,2.746945899,3.057591623,48000.39965,760.4380454,5.963350785,98936.04887,0.483721923,0.007662805,6.19685E-05,0.100269542,0.021521469,82,32
D:0| T0: 0.17| T1: 32.00| R0: 0.0| R1: 0.0| WTP: 0,0,0.173076923,32,0,0,0,0,0,-2018243144,1209758844,12487.00953,1393892667,139389266.7,1,88204,3609,528,2075,1547,528,88204,1547,2075,273.9515152,3.139393939,12.44848485,40211.76364,1568.357576,15.62424242,98708.38788,0.404832705,0.015744512,0.000158423,0.745542169,0.02352501,24,15
D:0| T0: 0.17| T1: 32.00| R0: 0.0| R1: 0.0| WTP: 0,0,0.173076923,32,0,0,0,0,0,-971295411.4,70671723,132.287538,964681034.5,96468103.45,1,879,37,22,22,0,22,879,0,22,2.096296296,0.096296296,0.096296296,99502.6,40.9037037,0.251851852,99989.91111,0.995132145,0.000408641,3.23562E-06,0,0.025028441,20,11
D:0| T0: 0.17| T1: 32.00| R0: 0.0| R1: 0.0| WTP: 0,0,0.173076923,32,0,0,0,0,0,-615724590.1,1722612191,42.05585974,613621797.1,61362179.71,1,154,7,7,7,0,7,154,0,7,0.339130435,0,0,99925.90435,6.269565217,0.069565217,99997.8,0.999282038,6.45706E-05,1.20693E-06,0,0.045454545,16,7
D:0| T0: 0.17| T1: 32.00| R0: 0.0| R1: 0.0| WTP: 0,0,0.173076923,32,0,0,0,0,0,-2019662922,1968291596,60.27458221,2016649193,201664919.3,1,480,31,10,10,0,10,480,0,10,1.887892377,0.004484305,0.004484305,99687.01794,8.713004484,0.049327354,99995.69507,0.99691812,8.91993E-05,8.92897E-07,0,0.020833333,32,23
D:0| T0: 0.17| T1: 32.00| R0: 0.0| R1: 0.0| WTP: 0,0,0.173076923,32,0,0,0,0,0,-2081251979,1877569084,13494.00386,1406551787,140655178.7,1,98396,4145,476,2242,1766,476,98396,1766,2242,326.0802469,2.895061728,13.75308642,28298.09259,1940.851852,16.66666667,98508.96296,0.284748422,0.019488655,0.000168597,0.787689563,0.022785479,24,15
D:0| T0: 0.17| T1: 32.00| R0: 0.0| R1: 0.0| WTP: 0,0,0.173076923,32,0,0,0,0,0,-2068572054,1726322189,13306.75095,1403234506,140323450.6,1,96304,4112,524,2211,1687,524,96304,1687,2211,307.5030303,3.109090909,13.26060606,31480.65455,1982.472727,16.44848485,98571.98788,0.316751669,0.019905308,0.000166567,0.763003166,0.022958548,24,15
D:0| T0: 0.17| T1: 32.00| R0: 0.0| R1: 0.0| WTP: 0,0,0.173076923,32,0,0,0,0,0,-1886903744,307848836,11497.9627,1312005608,131200560.8,1,90240,3972,507,1910,1403,507,90240,1403,1910,304.1552795,3.062111801,11.72049689,39548.54658,1977.285714,14.86956522,98843.35404,0.397740099,0.019823457,0.000150608,0.734554974,0.02116578,23,14
D:0| T0: 0.17| T1: 32.00| R0: 0.0| R1: 0.0| WTP: 0,0,0.173076923,32,0,0,0,0,0,-1835977801,1154000220,12035.59302,1234198150,123419815,1,98939,4480,439,1999,1560,439,98939,1560,1999,356.8766234,2.753246753,12.83766234,25431.02597,1673.532468,15.72077922,98620.52597,0.256197708,0.016774105,0.000158844,0.780390195,0.020204368,22,13
D:0| T0: 0.17| T1: 32.00| R0: 0.0| R1: 0.0| WTP: 0,0,0.173076923,32,0,0,0,0,0,-1848893629,2028661055,150.3633374,1841375462,184137546.2,1,905,37,25,25,0,25,905,0,25,2,0.048780488,0.048780488,99380.10732,23.08292683,0.165853659,99985.20976,0.993956921,0.000232011,2.42747E-06,0,0.027624309,30,21
D:0| T0: 0.17| T1: 32.00| R0: 0.0| R1: 0.0| WTP: 0,0,0.173076923,32,0,0,0,0,0,-3451490994,1629114640,11121.76764,2895402612,289540261.2,2,91618,4072,1290,1847,557,1290,91618,557,1847,102.2287968,2.384615385,3.459566075,60575.2071,1116.238659,6.003944773,99261.36292,0.608180231,0.011242975,6.22986E-05,0.301570114,0.020159794,73,32
D:0| T0: 0.17| T1: 32.00| R0: 0.0| R1: 0.0| WTP: 0,0,0.173076923,32,0,0,0,0,0,-1964457217,1439048174,12952.84406,1316815014,131681501.4,1,97218,4091,501,2152,1651,501,97218,1651,2152,320.6583851,3.049689441,13.26708075,31550.6646,2571.826087,16.38509317,98626.93789,0.317283489,0.025819004,0.000165513,0.767193309,0.022135818,23,14
D:0| T0: 0.17| T1: 32.00| R0: 0.0| R1: 0.0| WTP: 0,0,0.173076923,32,0,0,0,0,0,-2606194342,865227006,13487.76317,1931806183,193180618.3,1,99171,4141,440,2241,1801,440,99171,1801,2241,253.4975845,2.062801932,10.73429952,18111.4058,1287.507246,12.87439614,98252.28502,0.182903911,0.012941058,0.000130328,0.803659081,0.022597332,30,21
D:0| T0: 0.17| T1: 32.00| R0: 0.0| R1: 0.0| WTP: 0,0,0.173076923,32,0,0,0,0,0,-3278355178,890479738,8188.426433,2868933857,286893385.7,2,65524,2869,854,1360,506,854,65524,506,1360,106.8483965,2.381924198,3.822157434,49687.28571,1364.294461,6.306122449,99012.37026,0.501051225,0.013694691,6.48113E-05,0.372058824,0.020755754,49,32
D:0| T0: 0.17| T1: 32.00| R0: 0.0| R1: 0.0| WTP: 0,0,0.173076923,32,0,0,0,0,0,-1260009283,1017049163,571.924303,1231413068,123141306.8,1,4882,218,95,95,0,95,4882,0,95,15.35220126,0.471698113,0.471698113,97010.84906,111.0251572,1.088050314,99947.66667,0.970643074,0.001106399,1.18804E-05,0,0.019459238,23,14
D:0| T0: 0.17| T1: 32.00| R0: 0.0| R1: 0.0| WTP: 0,0,0.173076923,32,0,0,0,0,0,-1316046176,1707305064,18.14171148,1315139090,131513909,1,304,12,3,3,0,3,304,0,3,1.43902439,0.006097561,0.006097561,99809.40854,9.384146341,0.018292683,99998.14634,0.998116373,9.53351E-05,3.63639E-07,0,0.009868421,24,15
D:0| T0: 0.17| T1: 32.00| R0: 0.0| R1: 0.0| WTP: 0,0,0.173076923,32,0,0,0,0,0,-2256163780,400145663,13458.37785,1583244887,158324488.7,1,99063,4296,416,2236,1820,416,99063,1820,2236,305.3125,2.301136364,12.61363636,21244.23864,1511.471591,14.97727273,98336.77273,0.214354435,0.015179205,0.000151496,0.813953488,0.022571495,26,17
D:0| T0: 0.17| T1: 32.00| R0: 0.0| R1: 0.0| WTP: 0,0,0.173076923,32,0,0,0,0,0,-1146840749,1662654181,120.5449117,1140813503,114081350.3,1,1480,66,20,20,0,20,1480,0,20,5.25974026,0.051948052,0.051948052,99114.72078,38.96753247,0.168831169,99989.98701,0.991256664,0.000389447,2.58088E-06,0,0.013513514,22,13
D:0| T0: 0.17| T1: 32.00| R0: 0.0| R1: 0.0| WTP: 0,0,0.173076923,32,0,0,0,0,0,-2028784179,182136456,12413.50839,1408108760,140810876,1,98235,4374,473,2062,1589,473,98235,1589,2062,333.2037037,2.87037037,12.62345679,28120.00617,2101.364198,15.5308642,98623.17284,0.282984097,0.021080113,0.000157104,0.770611057,0.020990482,24,15
D:0| T0: 0.17| T1: 32.00| R0: 0.0| R1: 0.0| WTP: 0,0,0.173076923,32,0,0,0,0,0,-1403902093,979575387,24.11458233,1402696364,140269636.4,1,290,12,4,4,0,4,290,0,4,1.046783626,0,0,99823.53216,11.45614035,0.023391813,99998.20468,0.99825693,0.000116223,4.65123E-07,0,0.013793103,25,16
D:0| T0: 0.17| T1: 32.00| R0: 0.0| R1: 0.0| WTP: 0,0,0.173076923,32,0,0,0,0,0,-2114530231,2142525414,10984.42846,1565308808,156530880.8,1,81403,3435,588,1825,1237,588,81403,1237,1825,240.7653631,3.201117318,10.05027933,45963.01676,1782.201117,13.33519553,98902.11732,0.462652857,0.017876666,0.000135287,0.677808219,0.022419321,26,17
D:0| T0: 0.17| T1: 32.00| R0: 0.0| R1: 0.0| WTP: 0,0,0.173076923,32,0,0,0,0,0,-3391609021,1464057597,10115.86415,2885815814,288581581.4,2,82994,3581,1552,1680,128,1552,82994,128,1680,74.53571429,2.353896104,2.547077922,49108.5,504.6185065,5.076298701,98997.64935,0.494871204,0.005082423,5.28286E-05,0.076190476,0.020242427,88,32
D:0| T0: 0.17| T1: 32.00| R0: 0.0| R1: 0.0| WTP: 0,0,0.173076923,32,0,0,0,0,0,-2062133212,364562610,11580.68812,1483098806,148309880.6,1,87956,3757,530,1924,1394,530,87956,1394,1924,266.3275862,2.965517241,10.93678161,39138.09195,1709.189655,14,98782.65517,0.394011626,0.017143152,0.000141569,0.724532225,0.021874574,25,16
D:0| T0: 0.17| T1: 32.00| R0: 0.0| R1: 0.0| WTP: 0,0,0.173076923,32,0,0,0,0,0,-2257783547,40350784,10400.98761,1737734166,173773416.6,1,77125,3268,605,1728,1123,605,77125,1123,1728,212.625641,3.01025641,8.717948718,47288.47692,1529.682051,11.81538462,98915.11282,0.476332949,0.015341981,0.000120075,0.649884259,0.022405186,28,19
D:0| T0: 0.17| T1: 32.00| R0: 0.0| R1: 0.0| WTP: 0,0,0.173076923,32,0,0,0,0,0,-2074109977,804064356,9890.023559,1579608799,157960879.9,1,89264,4116,438,1642,1204,438,89264,1204,1642,292.2011173,2.379888268,9.072625698,36867.4581,1444.03352,11.50837989,98925.40223,0.370984933,0.014467612,0.000116487,0.733252132,0.018394874,26,17
D:0| T0: 0.17| T1: 32.00| R0: 0.0| R1: 0.0| WTP: 0,0,0.173076923,32,0,0,0,0,0,-1628227273,2125493986,5507.451387,1352854703,135285470.3,1,39738,1695,465,915,450,465,39738,450,915,129.0059524,2.654761905,5.303571429,74078.57738,742.8690476,8.041666667,99455.19643,0.744512211,0.007417016,8.20256E-05,0.491803279,0.023025819,24,15
D:0| T0: 0.17| T1: 32.00| R0: 0.0| R1: 0.0| WTP: 0,0,0.173076923,32,0,0,0,0,0,-2022145136,23154253,7499.412326,1647174520,164717452,1,69083,3146,519,1245,726,519,69083,726,1245,219.8315217,2.695652174,6.60326087,53171.11413,1000.472826,9.461956522,99223.38043,0.53493693,0.010008325,9.59413E-05,0.58313253,0.0180218,27,18
D:0| T0: 0.17| T1: 32.00| R0: 0.0| R1: 0.0| WTP: 0,0,0.173076923,32,0,0,0,0,0,-2038013103,1391367689,385.2502514,2018750591,201875059.1,1,3102,138,64,64,0,64,3102,0,64,7.206278027,0.170403587,0.170403587,97810.30493,47.04932735,0.452914798,99958.0583,0.97853964,0.000470982,5.71604E-06,0,0.020638504,32,23
D:0| T0: 0.17| T1: 32.00| R0: 0.0| R1: 0.0| WTP: 0,0,0.173076923,32,0,0,0,0,0,-2403329841,574142276,2173.165102,2294671586,229467158.6,1,16719,710,356,361,5,356,16719,5,361,36.45679012,1.304526749,1.325102881,88596.55556,316.4115226,2.794238683,99771.09053,0.888025751,0.003158796,2.94371E-05,0.013850416,0.021593492,35,26
D:0| T0: 0.17| T1: 32.00| R0: 0.0| R1: 0.0| WTP: 0,0,0.173076923,32,0,0,0,0,0,-701611202.7,898736779,6.039854375,701309210,70130921,1,92,4,1,1,0,1,92,0,1,0.578947368,0,0,99953.01754,5.789473684,0.00877193,99999.17544,0.999539648,5.9218E-05,1.73913E-07,0,0.010869565,17,8
D:0| T0: 0.17| T1: 32.00| R0: 0.0| R1: 0.0| WTP: 0,0,0.173076923,32,0,0,0,0,0,-2997621159,346473503,4705.084077,2762366955,276236695.5,1,43699,2075,632,781,149,632,43699,149,781,93.00357143,2.139285714,2.65,68346.65714,891.5892857,4.892857143,99475.89643,0.686883565,0.008918335,5.04839E-05,0.19078105,0.017872263,40,31
D:0| T0: 0.17| T1: 32.00| R0: 0.0| R1: 0.0| WTP: 0,0,0.173076923,32,0,0,0,0,0,-2795541010,445552282,4436.49241,2573716390,257371639,1,33491,1483,592,737,145,592,33491,145,737,66.94776119,2.063432836,2.593283582,76622.03358,719.0186567,4.809701493,99519.27239,0.769761245,0.007190865,4.95886E-05,0.196743555,0.022005912,38,29
D:0| T0: 0.17| T1: 32.00| R0: 0.0| R1: 0.0| WTP: 0,0,0.173076923,32,0,0,0,0,0,-1746013496,911758476,11946.23269,1148701861,114870186.1,1,99146,4479,437,1984,1547,437,99146,1547,1984,396.7676056,2.985915493,13.83098592,27636.58451,1954.535211,16.9084507,98686.9507,0.278200211,0.019581078,0.000170959,0.779737903,0.020010893,21,12
D:0| T0: 0.17| T1: 32.00| R0: 0.0| R1: 0.0| WTP: 0,0,0.173076923,32,0,0,0,0,0,-2141479453,1464197940,11111.20923,1585918992,158591899.2,1,93996,4382,552,1845,1293,552,93996,1293,1845,311.6256983,3.005586592,10.18994413,33594.05028,3063.877095,13.24581006,98820.50279,0.337879763,0.03073005,0.000134389,0.700813008,0.019628495,26,17
D:0| T0: 0.17| T1: 32.00| R0: 0.0| R1: 0.0| WTP: 0,0,0.173076923,32,0,0,0,0,0,-1687163374,500405854,1908.361708,1591745289,159174528.9,1,13849,600,307,317,10,307,13849,10,317,42.3315508,1.465240642,1.524064171,91001.3262,304.6149733,3.160427807,99814.31551,0.911740735,0.003036852,3.32424E-05,0.031545741,0.022894699,27,18
D:0| T0: 0.17| T1: 32.00| R0: 0.0| R1: 0.0| WTP: 0,0,0.173076923,32,0,0,0,0,0,-2004424760,772037341,12110.26047,1398911737,139891173.7,1,92766,3897,464,2012,1548,464,92766,1548,2012,293.5333333,2.739393939,12.06666667,35320.81818,1842.612121,14.87272727,98710.27879,0.355418127,0.018482671,0.000150624,0.769383698,0.021688981,24,15
D:0| T0: 0.17| T1: 32.00| R0: 0.0| R1: 0.0| WTP: 0,0,0.173076923,32,0,0,0,0,0,-967790505.6,1543158763,66.16145856,964482432.7,96448243.27,1,464,23,11,11,0,11,464,0,11,1.379562044,0.02189781,0.02189781,99731.39416,15.99270073,0.102189781,99993.85401,0.997379249,0.000161025,1.59428E-06,0,0.023706897,20,11
D:0| T0: 0.17| T1: 32.00| R0: 0.0| R1: 0.0| WTP: 0,0,0.173076923,32,0,0,0,0,0,-1832721565,1604932531,13782.2358,1143609775,114360977.5,1,98721,4189,442,2290,1848,442,98721,1848,2290,361.6438356,2.938356164,15.55479452,28998.41781,1995.582192,18.5890411,98497.54795,0.291808024,0.020024328,0.000187945,0.8069869,0.023196686,21,12
D:0| T0: 0.17| T1: 32.00| R0: 0.0| R1: 0.0| WTP: 0,0,0.173076923,32,0,0,0,0,0,-2606397423,539051477,10270.38144,2092878350,209287835,1,77413,3439,689,1706,1017,689,77413,1017,1706,202.8027523,3.059633028,7.669724771,45165.97248,2037.399083,10.82568807,98900.74771,0.45512808,0.0204447,0.000110323,0.596131301,0.022037642,32,23
D:0| T0: 0.17| T1: 32.00| R0: 0.0| R1: 0.0| WTP: 0,0,0.173076923,32,0,0,0,0,0,-1235046152,1743124675,144.3604116,1227828131,122782813.1,1,733,30,24,24,0,24,733,0,24,2.662420382,0.057324841,0.057324841,99529.2293,15.29299363,0.21656051,99986.01911,0.99543861,0.000153751,3.03832E-06,0,0.032742156,23,14
D:0| T0: 0.17| T1: 32.00| R0: 0.0| R1: 0.0| WTP: 0,0,0.173076923,32,0,0,0,0,0,-3471645900,1965983789,11713.15333,2885988233,288598823.3,2,87691,3662,1110,1946,836,1110,87691,836,1946,91,2.00591716,3.631163708,69405.98422,1005.879684,5.822485207,99363.39053,0.695575626,0.010136168,6.07238E-05,0.429599178,0.022191559,73,32
D:0| T0: 0.17| T1: 32.00| R0: 0.0| R1: 0.0| WTP: 0,0,0.173076923,32,0,0,0,0,0,-2320546455,516774280,728.3701541,2284127947,228412794.7,1,5542,243,121,121,0,121,5542,0,121,11.99186992,0.394308943,0.394308943,96125.00407,145.6747967,0.886178862,99922.0935,0.962033873,0.001453907,9.80332E-06,0,0.021833273,35,26
D:0| T0: 0.17| T1: 32.00| R0: 0.0| R1: 0.0| WTP: 0,0,0.173076923,32,0,0,0,0,0,-2296715272,86603142,12497.83911,1671823317,167182331.7,1,98877,4264,422,2076,1654,422,98877,1654,2076,296.4565217,2.239130435,11.19565217,20627.42391,1394.456522,13.48913043,98429.9837,0.20817992,0.013998365,0.000136404,0.79672447,0.020995783,27,18
D:0| T0: 0.17| T1: 32.00| R0: 0.0| R1: 0.0| WTP: 0,0,0.173076923,32,0,0,0,0,0,-965989593.7,1431870609,30.13122792,964483032.3,96448303.23,1,447,16,5,5,0,5,447,0,5,1.467153285,0,0,99737.33577,22.10948905,0.03649635,99997.13139,0.997406558,0.000221746,7.24652E-07,0,0.011185682,20,11
D:0| T0: 0.17| T1: 32.00| R0: 0.0| R1: 0.0| WTP: 0,0,0.173076923,32,0,0,0,0,0,-2561069609,1592383984,4882.931227,2316923047,231692304.7,1,38645,1653,625,811,186,625,38645,186,811,89.30165289,2.462809917,3.20661157,73345.36777,466.8347107,5.785123967,99478.17769,0.73708206,0.00466913,5.9338E-05,0.229346486,0.020985897,35,26
D:0| T0: 0.17| T1: 32.00| R0: 0.0| R1: 0.0| WTP: 0,0,0.173076923,32,0,0,0,0,0,-2907666510,1440183867,1728.954876,2821218766,282121876.6,2,15407,738,287,287,0,287,15407,0,287,29.37383178,0.791277259,0.791277259,88320.2866,231.3956386,1.647975078,99792.72274,0.885098164,0.002312016,1.7851E-05,0,0.018627896,46,32
D:0| T0: 0.17| T1: 32.00| R0: 0.0| R1: 0.0| WTP: 0,0,0.173076923,32,0,0,0,0,0,-2216600266,1696510588,439.4901935,2194625756,219462575.6,1,4098,171,73,73,0,73,4098,0,73,8.274678112,0.214592275,0.214592275,97230.24893,83.35622318,0.527896996,99953.59657,0.972780595,0.000832626,6.24149E-06,0,0.017813568,34,25
D:0| T0: 0.17| T1: 32.00| R0: 0.0| R1: 0.0| WTP: 0,0,0.173076923,32,0,0,0,0,0,-2298715397,895039877,11046.3651,1746397142,174639714.2,1,84956,3665,584,1835,1251,584,84956,1251,1835,240.5206186,2.93814433,9.319587629,39528.04124,2295.494845,12.31443299,98817.30412,0.398154226,0.02302829,0.000125193,0.681743869,0.021599416,28,19
D:0| T0: 0.17| T1: 32.00| R0: 0.0| R1: 0.0| WTP: 0,0,0.173076923,32,0,0,0,0,0,-3502313225,129565953,12284.43528,2888091461,288809146.1,2,88928,3752,1278,2041,763,1278,88928,763,2041,75.05103668,1.918660287,3.121212121,63547.3748,997.0717703,5.16108453,99199.42584,0.637720571,0.010057234,5.3372E-05,0.373836355,0.022951151,89,32
D:0| T0: 0.17| T1: 32.00| R0: 0.0| R1: 0.0| WTP: 0,0,0.173076923,32,0,0,0,0,0,-1865188265,1902565669,415.5966057,1844408435,184440843.5,1,4219,196,69,69,0,69,4219,0,69,10.41545894,0.256038647,0.256038647,97168.86473,75.99033816,0.574879227,99955.94203,0.972147651,0.000759016,6.63677E-06,0,0.016362343,30,21
D:0| T0: 0.17| T1: 32.00| R0: 0.0| R1: 0.0| WTP: 0,0,0.173076923,32,0,0,0,0,0,-1413891858,1984179288,198.6784526,1403957935,140395793.5,1,1788,69,33,33,0,33,1788,0,33,5.296511628,0.087209302,0.087209302,98850.1686,78.55813953,0.284883721,99982.40116,0.988690847,0.000783459,3.81563E-06,0,0.018456376,25,16
D:0| T0: 0.17| T1: 32.00| R0: 0.0| R1: 0.0| WTP: 0,0,0.173076923,32,0,0,0,0,0,-3443365456,677377223,11131.14307,2886808303,288680830.3,2,85269,3637,1736,1849,113,1736,85269,113,1849,66.84492754,2.326086957,2.485507246,44377.88116,1006.794203,5.010144928,98835.53913,0.447597283,0.010148913,5.23712E-05,0.061147186,0.021672589,98,32
D:0| T0: 0.17| T1: 32.00| R0: 0.0| R1: 0.0| WTP: 0,0,0.173076923,32,0,0,0,0,0,-3458659172,973583301,11289.58542,2894179901,289417990.1,2,90608,4054,1491,1875,384,1491,90608,384,1875,94.0962963,2.585185185,3.277777778,54706.36296,1360.551852,6.042592593,99105.76667,0.549525791,0.013711218,6.27807E-05,0.2048,0.020693537,78,32
D:0| T0: 0.17| T1: 32.00| R0: 0.0| R1: 0.0| WTP: 0,0,0.173076923,32,0,0,0,0,0,-2037402907,781062938,1819.595345,1946423140,194642314,1,16669,807,300,302,2,300,16669,2,302,49.28301887,1.254716981,1.264150943,88793.16038,365.2264151,2.693396226,99814.68396,0.889631333,0.003642702,2.83044E-05,0.006622517,0.018117464,31,22
D:0| T0: 0.17| T1: 32.00| R0: 0.0| R1: 0.0| WTP: 0,0,0.173076923,32,0,0,0,0,0,-3486198904,338783425,11818.22889,2895287459,289528745.9,2,94067,4106,1023,1963,940,1023,94067,940,1963,99.82884615,1.809615385,3.584615385,64911.08077,1471.944231,5.546153846,99328.01154,0.650044419,0.014834593,5.78618E-05,0.478858889,0.020868105,75,32
D:0| T0: 0.17| T1: 32.00| R0: 0.0| R1: 0.0| WTP: 0,0,0.173076923,32,0,0,0,0,0,-1496594806,1027579040,114.3679034,1490876411,149087641.1,1,917,39,19,19,0,19,917,0,19,2.531914894,0.053191489,0.053191489,99416.66489,37.12234043,0.154255319,99988.96809,0.994283973,0.000371146,2.01075E-06,0,0.020765027,26,17
D:0| T0: 0.17| T1: 32.00| R0: 0.0| R1: 0.0| WTP: 0,0,0.173076923,32,0,0,0,0,0,-2935803379,764973813,2281.639231,2821721417,282172141.7,1,17440,762,378,379,1,378,17440,1,379,32.72852234,1.151202749,1.151202749,87800.37113,406.7869416,2.457044674,99752.73196,0.880195361,0.004063582,2.59727E-05,0.002638522,0.021731651,41,32
D:0| T0: 0.17| T1: 32.00| R0: 0.0| R1: 0.0| WTP: 0,0,0.173076923,32,0,0,0,0,0,-3497769296,1245753446,12058.46891,2894845851,289484585.1,2,92769,4083,1359,2003,644,1359,92769,644,2003,96.63137996,2.466918715,3.655954631,53080.27599,1189.064272,6.200378072,99034.54064,0.534182923,0.011988367,6.40628E-05,0.321517723,0.021591264,76,32
D:0| T0: 0.17| T1: 32.00| R0: 0.0| R1: 0.0| WTP: 0,0,0.173076923,32,0,0,0,0,0,-2115271545,1013177794,3310.063447,1949768372,194976837.2,1,24433,1013,457,550,93,457,24433,93,550,56.13615023,1.981220657,2.408450704,83444.0892,480.6244131,4.577464789,99656.82629,0.837286831,0.004798261,4.71851E-05,0.169090909,0.022510539,31,22
D:0| T0: 0.17| T1: 32.00| R0: 0.0| R1: 0.0| WTP: 0,0,0.173076923,32,0,0,0,0,0,-1668898538,1395089249,54.31437069,1666182819,166618281.9,1,867,37,9,9,0,9,867,0,9,2.642105263,0.010526316,0.010526316,99400.07895,24.06315789,0.052631579,99994.11053,0.994069425,0.000241844,9.42445E-07,0,0.010380623,28,19
D:0| T0: 0.17| T1: 32.00| R0: 0.0| R1: 0.0| WTP: 0,0,0.173076923,32,0,0,0,0,0,-438852878.3,1339545835,12.01008238,438252374.2,43825237.42,1,66,0,2,2,0,2,66,0,2,0,0,0,99962.31579,4.557894737,0.021052632,99998.72632,0.99963791,4.76049E-05,4.16669E-07,0,0.03030303,14,5
D:0| T0: 0.17| T1: 32.00| R0: 0.0| R1: 0.0| WTP: 0,0,0.173076923,32,0,0,0,0,0,-1803808453,219139554,11410.78146,1233269380,123326938,1,95408,4273,467,1895,1428,467,95408,1428,1895,366.147651,3.060402685,12.57718121,32898,1681.52349,15.7114094,98779.59732,0.331041421,0.016848896,0.000158928,0.753562005,0.019862066,22,13
D:0| T0: 0.17| T1: 32.00| R0: 0.0| R1: 0.0| WTP: 0,0,0.173076923,32,0,0,0,0,0,-1428864147,1336508942,451.6680232,1406280746,140628074.6,1,3698,167,75,75,0,75,3698,0,75,13.33727811,0.284023669,0.284023669,97760.78107,87.67455621,0.75739645,99962.23077,0.977996639,0.00087437,8.82671E-06,0,0.020281233,25,16
D:0| T0: 0.17| T1: 32.00| R0: 0.0| R1: 0.0| WTP: 0,0,0.173076923,32,0,0,0,0,0,-703999557.1,448559423,54.07595311,701295759.4,70129575.94,1,162,4,9,9,0,9,162,0,9,0.434782609,0.017391304,0.017391304,99910.31304,10.29565217,0.095652174,99997.29565,0.999132373,0.000104226,1.55178E-06,0,0.055555556,17,8
D:0| T0: 0.17| T1: 32.00| R0: 0.0| R1: 0.0| WTP: 0,0,0.173076923,32,0,0,0,0,0,-2341667252,2110028840,1089.701955,2287182154,228718215.4,1,8531,384,181,181,0,181,8531,0,181,19.525,0.629166667,0.629166667,94033.29583,172.9458333,1.3875,99883.17917,0.941479057,0.001726289,1.50339E-05,0,0.021216739,35,26
D:0| T0: 0.17| T1: 32.00| R0: 0.0| R1: 0.0| WTP: 0,0,0.173076923,32,0,0,0,0,0,-3533951020,1982030155,12938.57359,2887022341,288702234.1,2,91136,3781,1088,2150,1062,1088,91136,1062,2150,83.7027027,1.81981982,3.713513514,65410.63063,1092.192793,5.67027027,99232.33694,0.65563258,0.011017676,5.88425E-05,0.493953488,0.023591117,80,32
D:0| T0: 0.17| T1: 32.00| R0: 0.0| R1: 0.0| WTP: 0,0,0.173076923,32,0,0,0,0,0,-3451359570,696219407,11316.72903,2885523118,288552311.8,2,84663,3641,1261,1880,619,1261,84663,619,1880,94.0781893,2.434156379,3.695473251,65032.17901,577.0679012,6.294238683,99249.54527,0.653342143,0.005813808,6.50722E-05,0.329255319,0.022205686,70,32
D:0| T0: 0.17| T1: 32.00| R0: 0.0| R1: 0.0| WTP: 0,0,0.173076923,32,0,0,0,0,0,-1990826146,1402539442,10104.21028,1485615632,148561563.2,1,84628,3787,549,1678,1129,549,84628,1129,1678,283.7705882,3.147058824,9.741176471,44141.80588,2280.270588,12.94117647,99002.20588,0.443936197,0.022846769,0.000131338,0.672824791,0.019827953,25,16
D:0| T0: 0.17| T1: 32.00| R0: 0.0| R1: 0.0| WTP: 0,0,0.173076923,32,0,0,0,0,0,-2170138711,1319833493,10276.86929,1656295247,165629524.7,1,82058,3679,610,1707,1097,610,82058,1097,1707,240.6914894,3.159574468,8.95212766,43550.01596,2947.164894,12.18085106,98943.32447,0.438413347,0.029552063,0.000123649,0.64264792,0.020802359,27,18
D:0| T0: 0.17| T1: 32.00| R0: 0.0| R1: 0.0| WTP: 0,0,0.173076923,32,0,0,0,0,0,-1885052194,663608076,788.3451044,1845634939,184563493.9,1,5676,235,131,131,0,131,5676,0,131,13.57560976,0.502439024,0.502439024,96326.76585,165.702439,1.107317073,99923.73171,0.964032521,0.00165234,1.27265E-05,0,0.023079634,30,21
D:0| T0: 0.17| T1: 32.00| R0: 0.0| R1: 0.0| WTP: 0,0,0.173076923,32,0,0,0,0,0,-2020178004,414696500,72.25827997,2016565090,201656509,1,570,30,12,12,0,12,570,0,12,1.613333333,0.013333333,0.013333333,99633.01333,15.64444444,0.062222222,99993.08889,0.996404208,0.000158106,1.062E-06,0,0.021052632,32,23
D:0| T0: 0.17| T1: 32.00| R0: 0.0| R1: 0.0| WTP: 0,0,0.173076923,32,0,0,0,0,0,-1235681494,1249738535,150.4741011,1228157789,122815778.9,1,990,45,25,25,0,25,990,0,25,3.826086957,0.068322981,0.068322981,99391.55901,24.61490683,0.211180124,99987.7205,0.994045566,0.000246872,3.08678E-06,0,0.025252525,23,14
D:0| T0: 0.17| T1: 32.00| R0: 0.0| R1: 0.0| WTP: 0,0,0.173076923,32,0,0,0,0,0,-2025637172,614415382,168.55095,2017209625,201720962.5,1,1515,57,28,28,0,28,1515,0,28,3.399082569,0.041284404,0.041284404,99080.43119,44.09174312,0.174311927,99984.91284,0.990961812,0.000441702,2.55742E-06,0,0.018481848,32,23
D:0| T0: 0.17| T1: 32.00| R0: 0.0| R1: 0.0| WTP: 0,0,0.173076923,32,0,0,0,0,0,-1667325705,524899953,30.17289825,1665817060,166581706,1,480,28,5,5,0,5,480,0,5,1.458333333,0,0,99673.375,14.23958333,0.026041667,99996.66146,0.996772967,0.00014389,5.18145E-07,0,0.010438413,28,19
D:0| T0: 0.17| T1: 32.00| R0: 0.0| R1: 0.0| WTP: 0,0,0.173076923,32,0,0,0,0,0,-1868528488,1338977757,12660.58602,1235499187,123549918.7,1,98967,4419,403,2103,1700,403,98967,1700,2103,361.6623377,2.545454545,13.53896104,26152.23377,1689.824675,16.16233766,98549.27273,0.263361216,0.016945494,0.000163349,0.808368997,0.021249507,22,13
D:0| T0: 0.17| T1: 32.00| R0: 0.0| R1: 0.0| WTP: 0,0,0.173076923,32,0,0,0,0,0,-2171611986,341384587,10377.79317,1652722327,165272232.7,1,78975,3373,518,1724,1206,518,78975,1206,1724,230.9679144,2.695187166,9.096256684,43613.90909,1431.032086,11.86631016,98861.60428,0.439601863,0.01434678,0.000120265,0.699535963,0.021829693,27,18
D:0| T0: 0.17| T1: 32.00| R0: 0.0| R1: 0.0| WTP: 0,0,0.173076923,32,0,0,0,0,0,-3486445479,2032000160,12001.58091,2886366434,288636643.4,2,89428,3801,1260,1994,734,1260,89428,734,1994,85.92164179,2.195895522,3.542910448,61663.35075,1127.88806,5.889925373,99190.32836,0.618827641,0.011370569,6.11733E-05,0.368104313,0.022297267,77,32
D:0| T0: 0.17| T1: 32.00| R0: 0.0| R1: 0.0| WTP: 0,0,0.173076923,32,0,0,0,0,0,-2311998142,779488939,9722.511255,1825872580,182587258,1,76020,3316,566,1615,1049,566,76020,1049,1615,207.7821782,2.683168317,7.811881188,47341.05446,1430.034653,10.63861386,98974.18812,0.47678371,0.014336003,0.000108321,0.649535604,0.021244409,29,20
D:0| T0: 0.17| T1: 32.00| R0: 0.0| R1: 0.0| WTP: 0,0,0.173076923,32,0,0,0,0,0,-2403071716,1449019578,643.9927093,2370872080,237087208,1,4312,177,107,107,0,107,4312,0,107,9.519379845,0.290697674,0.290697674,97104.62791,105.1395349,0.724806202,99933.52326,0.971714509,0.001050298,8.26683E-06,0,0.024825986,36,27
D:0| T0: 0.17| T1: 32.00| R0: 0.0| R1: 0.0| WTP: 0,0,0.173076923,32,0,0,0,0,0,-1231066491,351952211,66.26538164,1227753222,122775322.2,1,521,28,11,11,0,11,521,0,11,2.541935484,0.006451613,0.006451613,99682.72903,14.9483871,0.096774194,99994.78065,0.996884685,0.000151096,1.41033E-06,0,0.021113244,23,14
D:0| T0: 0.17| T1: 32.00| R0: 0.0| R1: 0.0| WTP: 0,0,0.173076923,32,0,0,0,0,0,-1493321373,486595046,60.13217012,1490314765,149031476.5,1,385,16,10,10,0,10,385,0,10,0.798969072,0,0,99792.07732,15.70103093,0.051546392,99995.45876,0.997968414,0.000158418,1.02569E-06,0,0.026041667,26,17
D:0| T0: 0.17| T1: 32.00| R0: 0.0| R1: 0.0| WTP: 0,0,0.173076923,32,0,0,0,0,0,-2037782249,296745624,4954.595422,1790052477,179005247.7,1,39226,1736,481,823,342,481,39226,342,823,107.213198,2.294416244,4.005076142,73475.38579,975.6294416,6.446700508,99485.8731,0.738318974,0.00974749,6.6131E-05,0.415552855,0.020980982,29,20
D:0| T0: 0.17| T1: 32.00| R0: 0.0| R1: 0.0| WTP: 0,0,0.173076923,32,0,0,0,0,0,-1689278952,1671484194,409.4919052,1668804357,166880435.7,1,3384,161,68,68,0,68,3384,0,68,10.31606218,0.243523316,0.243523316,97859.04145,89.84974093,0.606217617,99960.7772,0.978995441,0.000896637,7.0126E-06,0,0.020106446,28,19
D:0| T0: 0.17| T1: 32.00| R0: 0.0| R1: 0.0| WTP: 0,0,0.173076923,32,0,0,0,0,0,-2177830809,422157396,11879.18551,1583871533,158387153.3,1,98334,4369,476,1973,1497,476,98334,1497,1973,303.9050279,2.592178771,10.92178771,26113.46927,2049.960894,13.58100559,98631.15642,0.262861855,0.020571472,0.000137384,0.758743031,0.020064271,26,17
D:0| T0: 0.17| T1: 32.00| R0: 0.0| R1: 0.0| WTP: 0,0,0.173076923,32,0,0,0,0,0,-1963423376,1916599091,12816.58979,1322593886,132259388.6,1,98431,4258,447,2129,1682,447,98431,1682,2129,350.1329114,2.753164557,13.34810127,27640.51899,2168.949367,16.1835443,98569.12025,0.278220405,0.021755487,0.000163717,0.790042273,0.021629365,23,14
D:0| T0: 0.17| T1: 32.00| R0: 0.0| R1: 0.0| WTP: 0,0,0.173076923,32,0,0,0,0,0,-1846254200,1005953941,12216.23243,1235442578,123544257.8,1,98342,4312,495,2029,1534,495,98342,1534,2029,368.8013245,3.225165563,13.32450331,30384.56954,2637.046358,16.58940397,98711.46358,0.305556772,0.026435801,0.000167715,0.756037457,0.02063208,22,13
D:0| T0: 0.17| T1: 32.00| R0: 0.0| R1: 0.0| WTP: 0,0,0.173076923,32,0,0,0,0,0,-1922051942,1422765615,12241.99292,1309952296,130995229.6,1,88872,3789,548,2034,1486,548,88872,1486,2034,297.05,3.31875,12.5375,40028.55,1926.55,16.00625,98767.19375,0.402835345,0.019329845,0.000161992,0.730580138,0.022886849,23,14
D:0| T0: 0.17| T1: 32.00| R0: 0.0| R1: 0.0| WTP: 0,0,0.173076923,32,0,0,0,0,0,-1141173493,699740192,30.09482132,1139668752,113966875.2,1,339,16,5,5,0,5,339,0,5,0.805194805,0.012987013,0.012987013,99795.20779,13.00649351,0.045454545,99997.74026,0.997978703,0.000131615,6.45172E-07,0,0.014749263,22,13
D:0| T0: 0.17| T1: 32.00| R0: 0.0| R1: 0.0| WTP: 0,0,0.173076923,32,0,0,0,0,0,-877077009.2,240885764,6.0931291,876772352.8,87677235.28,1,99,9,1,1,0,1,99,0,1,1.3046875,0,0,99939.54688,3.9609375,0.0078125,99999.63281,0.999401857,4.1628E-05,1.55039E-07,0,0.01010101,19,10
D:0| T0: 0.17| T1: 32.00| R0: 0.0| R1: 0.0| WTP: 0,0,0.173076923,32,0,0,0,0,0,-1751226524,2023806564,7473.239389,1377564554,137756455.4,1,64820,2923,579,1241,662,579,64820,662,1241,217.0898204,3.335329341,7.251497006,57969.91018,1628.628743,10.71856287,99283.88024,0.582960091,0.016284955,0.000109006,0.533440774,0.019145326,24,15
D:0| T0: 0.17| T1: 32.00| R0: 0.0| R1: 0.0| WTP: 0,0,0.173076923,32,0,0,0,0,0,-1409573787,1907493879,132.2933622,1402959119,140295911.9,1,938,34,22,22,0,22,938,0,22,1.761363636,0.051136364,0.051136364,99451.4375,32.5625,0.176136364,99987.76705,0.994641665,0.000326367,2.48613E-06,0,0.023454158,25,16
D:0| T0: 0.17| T1: 32.00| R0: 0.0| R1: 0.0| WTP: 0,0,0.173076923,32,0,0,0,0,0,-3468977165,1565815291,11647.35269,2886609530,288660953,2,90043,3803,1291,1935,644,1291,90043,644,1935,95.19547325,2.471193416,3.775720165,65136.72016,1492.510288,6.4218107,99305.33128,0.653314853,0.0150378,6.68573E-05,0.332816537,0.021489733,70,32
D:0| T0: 0.17| T1: 32.00| R0: 0.0| R1: 0.0| WTP: 0,0,0.173076923,32,0,0,0,0,0,-1772682733,784442364,343.1211169,1755526677,175552667.7,1,2611,121,57,57,0,57,2611,0,57,7.09223301,0.145631068,0.145631068,98276.67476,65.99029126,0.412621359,99967.82039,0.983102311,0.000659235,5.50875E-06,0,0.021830716,29,20
D:0| T0: 0.17| T1: 32.00| R0: 0.0| R1: 0.0| WTP: 0,0,0.173076923,32,0,0,0,0,0,-2026022510,206369745,9224.662745,1564789373,156478937.3,1,76953,3443,550,1532,982,550,76953,982,1532,238.8176796,2.928176796,8.303867403,48480.9116,1774.883978,11.3480663,99067.62431,0.487857087,0.017778876,0.00011528,0.640992167,0.019908256,26,17
D:0| T0: 0.17| T1: 32.00| R0: 0.0| R1: 0.0| WTP: 0,0,0.173076923,32,0,0,0,0,0,-2169931348,2087235992,11811.70151,1579346272,157934627.2,1,94449,4081,555,1962,1407,555,94449,1407,1962,284.9779006,2.983425414,10.68508287,32573.52486,2271.955801,13.75138122,98736.20994,0.327710743,0.022793562,0.00013965,0.717125382,0.020773116,26,17
D:0| T0: 0.17| T1: 32.00| R0: 0.0| R1: 0.0| WTP: 0,0,0.173076923,32,0,0,0,0,0,-2413545917,1019092536,795.0901621,2373791409,237379140.9,1,7491,319,132,132,0,132,7491,0,132,16.7983871,0.435483871,0.435483871,94738.0121,168.4798387,0.935483871,99912.95161,0.948251484,0.001681734,1.06092E-05,0,0.017621145,36,27
D:0| T0: 0.17| T1: 32.00| R0: 0.0| R1: 0.0| WTP: 0,0,0.173076923,32,0,0,0,0,0,-3378315903,1885906113,10040.59466,2876286170,287628617,2,77684,3245,1251,1668,417,1251,77684,417,1668,72.77075812,2.13898917,2.871841155,64497.31047,430.1768953,5.135379061,99273.50722,0.648273837,0.004331482,5.30222E-05,0.25,0.021471603,80,32
D:0| T0: 0.17| T1: 32.00| R0: 0.0| R1: 0.0| WTP: 0,0,0.173076923,32,0,0,0,0,0,-1475893206,2028637200,1264.513638,1412667524,141266752.4,1,11082,498,207,210,3,207,11082,3,210,33.42528736,1.051724138,1.063218391,92742.43678,248.8793103,2.229885057,99875.66667,0.928634903,0.002479365,2.38523E-05,0.014285714,0.018951358,25,16
D:0| T0: 0.17| T1: 32.00| R0: 0.0| R1: 0.0| WTP: 0,0,0.173076923,32,0,0,0,0,0,-2193661260,181476086,10709.8204,1658170240,165817024,1,86739,3824,537,1779,1242,537,86739,1242,1779,249.2956989,2.806451613,9.424731183,39414.52688,2185.919355,12.32258065,98865.46237,0.396737754,0.021924178,0.000124957,0.698145025,0.020509805,27,18
D:0| T0: 0.17| T1: 32.00| R0: 0.0| R1: 0.0| WTP: 0,0,0.173076923,32,0,0,0,0,0,-2203342319,2097578470,10842.9697,1661193834,166119383.4,1,85558,3814,584,1801,1217,584,85558,1217,1801,259.1290323,3.059139785,9.548387097,40090.06452,2490.709677,12.67204301,98856.64516,0.403672229,0.024981195,0.000128687,0.675735702,0.021050048,27,18
D:0| T0: 0.17| T1: 32.00| R0: 0.0| R1: 0.0| WTP: 0,0,0.173076923,32,0,0,0,0,0,-3463519124,119646392,11533.2428,2886856984,288685698.4,2,86704,3786,1075,1916,841,1075,86704,841,1916,91.07407407,1.918128655,3.528265107,70731.51852,1066.85575,5.645224172,99396.51852,0.708684822,0.010751181,5.87372E-05,0.438935282,0.022098173,74,32
D:0| T0: 0.17| T1: 32.00| R0: 0.0| R1: 0.0| WTP: 0,0,0.173076923,32,0,0,0,0,0,-1822268896,1298895859,11824.44223,1231046784,123104678.4,1,95331,4196,512,1964,1452,512,95331,1452,1964,353.56,3.333333333,12.93333333,35246.99333,2644.933333,16.35333333,98804.68,0.354356787,0.026513078,0.000165562,0.739307536,0.020601903,22,13
D:0| T0: 0.17| T1: 32.00| R0: 0.0| R1: 0.0| WTP: 0,0,0.173076923,32,0,0,0,0,0,-2537887848,1489316290,10625.0589,2006634903,200663490.3,1,82534,3668,529,1765,1236,529,82534,1236,1765,211.7887324,2.403755869,8.154929577,38400.00469,1348.258216,10.63849765,98764.79343,0.387276667,0.013528474,0.000108127,0.700283286,0.021385126,31,22
D:0| T0: 0.17| T1: 32.00| R0: 0.0| R1: 0.0| WTP: 0,0,0.173076923,32,0,0,0,0,0,-2717563507,855602142,14009.49354,2017088830,201708883,1,96194,3955,472,2328,1856,472,96194,1856,2328,236.6604651,2.153488372,10.74883721,26336.70233,1594.795349,12.94418605,98322.34419,0.265324005,0.016043383,0.000131127,0.797250859,0.024201094,31,22
D:0| T0: 0.17| T1: 32.00| R0: 0.0| R1: 0.0| WTP: 0,0,0.173076923,32,0,0,0,0,0,-2290824425,1438649896,3304.247164,2125612066,212561206.6,1,24979,1036,479,549,70,479,24979,70,549,52.61373391,1.922746781,2.210300429,83049.94421,545.1287554,4.244635193,99662.40773,0.833268084,0.005443653,4.40512E-05,0.127504554,0.021978462,33,24
D:0| T0: 0.17| T1: 32.00| R0: 0.0| R1: 0.0| WTP: 0,0,0.173076923,32,0,0,0,0,0,-1667490841,952489126,36.13731856,1665683975,166568397.5,1,393,13,6,6,0,6,393,0,6,1.036458333,0.005208333,0.005208333,99749.71354,16.3125,0.03125,99997.29688,0.997528192,0.000164252,6.21777E-07,0,0.015267176,28,19
D:0| T0: 0.17| T1: 32.00| R0: 0.0| R1: 0.0| WTP: 0,0,0.173076923,32,0,0,0,0,0,-1687488373,1550779155,12652.83926,1054846410,105484641,1,99140,4210,405,2102,1697,405,99140,1697,2102,388.0444444,2.925925926,15.45185185,25772.78519,2053.718519,18.45185185,98562.6,0.259796048,0.020577355,0.00018625,0.807326356,0.02120234,20,11
D:0| T0: 0.17| T1: 32.00| R0: 0.0| R1: 0.0| WTP: 0,0,0.173076923,32,0,0,0,0,0,-1584538183,607323321,120.3671534,1578519826,157851982.6,1,958,46,20,20,0,20,958,0,20,2.515957447,0.042553191,0.042553191,99350.77128,24.48404255,0.138297872,99988.26596,0.993634788,0.000245896,2.1166E-06,0,0.019832985,27,18
D:0| T0: 0.17| T1: 32.00| R0: 0.0| R1: 0.0| WTP: 0,0,0.173076923,32,0,0,0,0,0,-1763967924,2103646485,6320.595797,1447938134,144793813.4,1,48476,2088,518,1050,532,518,48476,532,1050,152.8176471,2.923529412,6.017647059,68788.1,861.6882353,9.047058824,99382.15294,0.691607142,0.008609496,9.21735E-05,0.506666667,0.021660203,25,16
D:0| T0: 0.17| T1: 32.00| R0: 0.0| R1: 0.0| WTP: 0,0,0.173076923,32,0,0,0,0,0,-1967351175,258120157,11146.97866,1410002242,141000224.2,1,97711,4438,441,1851,1410,441,97711,1410,1851,336.3151515,2.6,11.09090909,25085.55152,1505.909091,13.77575758,98682.07273,0.25287235,0.015096437,0.000139335,0.761750405,0.018943619,24,15
D:0| T0: 0.17| T1: 32.00| R0: 0.0| R1: 0.0| WTP: 0,0,0.173076923,32,0,0,0,0,0,-1881549754,1068951401,674.9467064,1847802418,184780241.8,1,6848,326,112,112,0,112,6848,0,112,19.8708134,0.435406699,0.435406699,95174.23445,127.6172249,0.976076555,99927.33971,0.952488261,0.001272629,1.06723E-05,0,0.01635514,30,21
D:0| T0: 0.17| T1: 32.00| R0: 0.0| R1: 0.0| WTP: 0,0,0.173076923,32,0,0,0,0,0,-3457247284,635956235,11395.32737,2887480915,288748091.5,2,86357,3795,997,1893,896,997,86357,896,1893,80.61367521,1.606837607,3.11965812,69769.14359,1120.386325,4.820512821,99389.62564,0.698681007,0.011286566,4.97816E-05,0.473322768,0.021920632,83,32
D:0| T0: 0.17| T1: 32.00| R0: 0.0| R1: 0.0| WTP: 0,0,0.173076923,32,0,0,0,0,0,-1056481164,1346693470,78.31500247,1052565414,105256541.4,1,830,35,13,13,0,13,830,0,13,3.167832168,0.034965035,0.034965035,99510.42657,29.68531469,0.104895105,99993.27972,0.995177696,0.00029731,1.80566E-06,0,0.015662651,21,12
D:0| T0: 0.17| T1: 32.00| R0: 0.0| R1: 0.0| WTP: 0,0,0.173076923,32,0,0,0,0,0,-2053644038,847102011,12959.21789,1405683144,140568314.4,1,98233,4205,472,2153,1681,472,98233,1681,2153,319.4573171,2.817073171,13,28185.04878,2044.310976,15.8597561,98563.80488,0.283633893,0.020520756,0.000160784,0.780771017,0.021917278,24,15
D:0| T0: 0.17| T1: 32.00| R0: 0.0| R1: 0.0| WTP: 0,0,0.173076923,32,0,0,0,0,0,-3519979267,812083272,12692.1509,2885371722,288537172.2,2,86845,3523,1871,2109,238,1871,86845,238,2109,82.93692022,3.261595547,3.684601113,52186.04638,979.4211503,7.178107607,98905.85158,0.525546818,0.009879598,7.44728E-05,0.112849692,0.024284645,77,32
D:0| T0: 0.17| T1: 32.00| R0: 0.0| R1: 0.0| WTP: 0,0,0.173076923,32,0,0,0,0,0,-2173799732,2146825809,11771.51154,1585224155,158522415.5,1,98874,4500,465,1955,1490,465,98874,1490,1955,310.3202247,2.556179775,10.8988764,22618.65169,1755.179775,13.51123596,98579.26404,0.228024452,0.017605376,0.000136496,0.762148338,0.01977264,26,17
D:0| T0: 0.17| T1: 32.00| R0: 0.0| R1: 0.0| WTP: 0,0,0.173076923,32,0,0,0,0,0,-2049126291,226186520,12851.40519,1406556032,140655603.2,1,97214,4231,468,2135,1667,468,97214,1667,2135,315.2619048,2.726190476,12.57738095,29346.85714,1687.755952,15.35714286,98566.32143,0.29534006,0.016944885,0.00015565,0.780796253,0.021961857,24,15
D:0| T0: 0.17| T1: 32.00| R0: 0.0| R1: 0.0| WTP: 0,0,0.173076923,32,0,0,0,0,0,-3470584660,1110225441,11624.39494,2889364913,288936491.3,2,89495,3826,1664,1931,267,1664,89495,267,1931,88.92523364,2.925233645,3.409345794,54990.13645,1283.951402,6.517757009,99080.6,0.552506767,0.01294075,6.77029E-05,0.138270326,0.021576624,77,32
D:0| T0: 0.17| T1: 32.00| R0: 0.0| R1: 0.0| WTP: 0,0,0.173076923,32,0,0,0,0,0,-2799752948,1190767082,2908.788215,2654313537,265431353.7,1,26849,1155,465,483,18,465,26849,18,483,51.7032967,1.553113553,1.608058608,80675.79121,528.6410256,3.318681319,99676.7033,0.809389278,0.00528117,3.46811E-05,0.037267081,0.017989497,39,30
D:0| T0: 0.17| T1: 32.00| R0: 0.0| R1: 0.0| WTP: 0,0,0.173076923,32,0,0,0,0,0,-2049038391,2108234095,589.7016078,2019553310,201955331,1,3816,156,98,98,0,98,3816,0,98,9.366972477,0.28440367,0.28440367,97486.00917,107.4311927,0.747706422,99940.77523,0.975460291,0.001072089,8.95402E-06,0,0.025681342,32,23
D:0| T0: 0.17| T1: 32.00| R0: 0.0| R1: 0.0| WTP: 0,0,0.173076923,32,0,0,0,0,0,-2062506633,465621985,13044.7896,1410267153,141026715.3,1,98735,4381,480,2167,1687,480,98735,1687,2167,334.5272727,2.83030303,13.01212121,26112.41818,2058.369697,15.90909091,98516.55758,0.262930085,0.020662792,0.000161171,0.778495616,0.021947638,24,15
D:0| T0: 0.17| T1: 32.00| R0: 0.0| R1: 0.0| WTP: 0,0,0.173076923,32,0,0,0,0,0,-1470907198,1487072553,1168.372375,1412488579,141248857.9,1,11183,472,192,194,2,192,11183,2,194,33.1849711,1,1.011560694,93079.32948,235.1213873,2.115606936,99890.27746,0.931853345,0.00234256,2.22045E-05,0.010309278,0.017350863,25,16
D:0| T0: 0.17| T1: 32.00| R0: 0.0| R1: 0.0| WTP: 0,0,0.173076923,32,0,0,0,0,0,-2731172781,1213733847,4875.330653,2487406248,248740624.8,1,37564,1534,620,810,190,620,37564,190,810,73.66798419,2.304347826,3.015810277,73460.26087,625.9367589,5.466403162,99463.34783,0.738383356,0.006261691,5.65317E-05,0.234567901,0.021563199,37,28
D:0| T0: 0.17| T1: 32.00| R0: 0.0| R1: 0.0| WTP: 0,0,0.173076923,32,0,0,0,0,0,-2702535570,2003658337,5922.419548,2406414593,240641459.3,1,44748,1879,596,984,388,596,44748,388,984,90.98785425,2.311740891,3.862348178,67670.89474,734.1012146,6.271255061,99330.82591,0.680937101,0.007347291,6.40309E-05,0.394308943,0.02198981,36,27
D:0| T0: 0.17| T1: 32.00| R0: 0.0| R1: 0.0| WTP: 0,0,0.173076923,32,0,0,0,0,0,-1056628393,1170868072,84.26888432,1052414949,105241494.9,1,737,34,14,14,0,14,737,0,14,2.5,0.027777778,0.027777778,99553.38889,29.02777778,0.111111111,99993.40972,0.995606114,0.000290569,1.93116E-06,0,0.018995929,21,12
D:0| T0: 0.17| T1: 32.00| R0: 0.0| R1: 0.0| WTP: 0,0,0.173076923,32,0,0,0,0,0,-2356850640,569919592,11915.80294,1761060493,176106049.3,1,99253,4499,426,1979,1553,426,99253,1553,1979,291.0471204,2.178010471,10.28272251,19861.66492,1353.65445,12.51308901,98501.8377,0.200403918,0.013586368,0.000126488,0.784739768,0.019938944,28,19
D:0| T0: 0.17| T1: 32.00| R0: 0.0| R1: 0.0| WTP: 0,0,0.173076923,32,0,0,0,0,0,-2101805493,1833180623,4362.033463,1883703819,188370381.9,1,40935,1924,502,724,222,502,40935,222,724,121.7902439,2.292682927,3.336585366,71794.22927,925.3512195,5.795121951,99541.13171,0.721111564,0.009242055,5.97295E-05,0.306629834,0.017686576,30,21
D:0| T0: 0.17| T1: 32.00| R0: 0.0| R1: 0.0| WTP: 0,0,0.173076923,32,0,0,0,0,0,-2250428039,1123666637,13397.49232,1580553424,158055342.4,1,97045,4088,484,2226,1742,484,97045,1742,2226,292.4382022,2.646067416,12.37640449,26979.19101,1643.123596,15.08988764,98445.79213,0.271790086,0.016507599,0.000153066,0.782569632,0.022937812,26,17
D:0| T0: 0.17| T1: 32.00| R0: 0.0| R1: 0.0| WTP: 0,0,0.173076923,32,0,0,0,0,0,-2712613295,1682024981,9030.975062,2261064541,226106454.1,1,71675,3165,735,1500,765,735,71675,765,1500,166.8791667,2.966666667,6.091666667,50887.09167,2447.845833,9.158333333,99065.55417,0.512325812,0.024550112,9.34585E-05,0.51,0.020927799,34,25
D:0| T0: 0.17| T1: 32.00| R0: 0.0| R1: 0.0| WTP: 0,0,0.173076923,32,0,0,0,0,0,-3471237432,1687523543,11612.54204,2890610330,289061033,2,90920,3931,1030,1929,899,1030,90920,899,1929,93.54580153,1.83778626,3.534351145,64053.19656,660.5400763,5.492366412,99281.94847,0.642371476,0.006656052,5.68783E-05,0.466044583,0.021216454,75,32
D:0| T0: 0.17| T1: 32.00| R0: 0.0| R1: 0.0| WTP: 0,0,0.173076923,32,0,0,0,0,0,-2098517827,178034412,12141.87123,1491424265,149142426.5,1,94595,4091,473,2017,1544,473,94595,1544,2017,302.4882353,2.705882353,11.71176471,32179.84706,1957.470588,14.5,98671.00588,0.323884412,0.01964123,0.000147066,0.765493307,0.02132248,25,16
D:0| T0: 0.17| T1: 32.00| R0: 0.0| R1: 0.0| WTP: 0,0,0.173076923,32,0,0,0,0,0,-1965558549,739490003,11252.80218,1402918440,140291844,1,93004,4063,472,1869,1397,472,93004,1397,1869,315.3580247,2.858024691,11.41358025,35432.75926,1602.95679,14.30864198,98812.0679,0.356447524,0.016067527,0.000144941,0.747458534,0.02009591,24,15
D:0| T0: 0.17| T1: 32.00| R0: 0.0| R1: 0.0| WTP: 0,0,0.173076923,32,0,0,0,0,0,-1973734689,178482706,8510.628926,1548203243,154820324.3,1,63172,2774,540,1414,874,540,63172,874,1414,187.3446328,2.95480226,7.836158192,57986.71186,1529.644068,10.87570621,99144.86441,0.58376196,0.01531079,0.000110547,0.618104668,0.022383334,26,17
D:0| T0: 0.17| T1: 32.00| R0: 0.0| R1: 0.0| WTP: 0,0,0.173076923,32,0,0,0,0,0,-2022576101,1919366370,3196.185014,1862766851,186276685.1,1,24018,1000,446,531,85,446,24018,85,531,59.85990338,2.033816425,2.429951691,84146.29469,401.7487923,4.599033816,99674.77295,0.844168403,0.004010565,4.70942E-05,0.16007533,0.022109339,30,21
D:0| T0: 0.17| T1: 32.00| R0: 0.0| R1: 0.0| WTP: 0,0,0.173076923,32,0,0,0,0,0,-1981487002,1819796913,11429.23864,1410025070,141002507,1,97451,4460,447,1898,1451,447,97451,1451,1898,331.8562874,2.622754491,11.25149701,29956.10778,2402.502994,13.91616766,98757.13174,0.301268217,0.024087167,0.000140892,0.764488936,0.019476455,24,15
D:0| T0: 0.17| T1: 32.00| R0: 0.0| R1: 0.0| WTP: 0,0,0.173076923,32,0,0,0,0,0,-3519952436,1866591913,12532.2497,2893339951,289333995.1,2,95142,4047,1065,2082,1017,1065,95142,1017,2082,101.1623246,1.971943888,3.983967936,63727.01202,1571.144289,6.138276553,99271.21643,0.638123127,0.015842846,6.35768E-05,0.488472622,0.02188308,72,32
D:0| T0: 0.17| T1: 32.00| R0: 0.0| R1: 0.0| WTP: 0,0,0.173076923,32,0,0,0,0,0,-1854053111,1219425989,12401.84865,1233960679,123396067.9,1,99237,4466,445,2060,1615,445,99237,1615,2060,367.2281879,2.899328859,13.69798658,25378.61074,1725.073826,16.67785235,98582.61074,0.255690659,0.017298075,0.000168699,0.783980583,0.020758386,22,13
D:0| T0: 0.17| T1: 32.00| R0: 0.0| R1: 0.0| WTP: 0,0,0.173076923,32,0,0,0,0,0,-2081001749,502409586,11734.42741,1494280379,149428037.9,1,97438,4267,475,1949,1474,475,97438,1474,1949,306.0287356,2.655172414,11.08045977,28094.3908,2257.413793,13.83333333,98682,0.282737,0.022643698,0.00013985,0.756285274,0.020002463,25,16
D:0| T0: 0.17| T1: 32.00| R0: 0.0| R1: 0.0| WTP: 0,0,0.173076923,32,0,0,0,0,0,-1956592972,1405887957,9608.669848,1476159480,147615948,1,76415,3438,512,1596,1084,512,76415,1084,1596,251.7869822,2.940828402,9.313609467,49101.85207,1371.710059,12.32544379,99030.04142,0.494238164,0.013737337,0.000124981,0.679197995,0.020885952,25,16
D:0| T0: 0.17| T1: 32.00| R0: 0.0| R1: 0.0| WTP: 0,0,0.173076923,32,0,0,0,0,0,-2094420002,283033753,12288.32318,1480003843,148000384.3,1,87277,3583,531,2042,1511,531,87277,1511,2042,255.9884393,2.994219653,11.67052023,38554.0578,1341.491329,14.74566474,98675.24855,0.388482073,0.013467474,0.000149366,0.739960823,0.023396771,25,16
D:0| T0: 0.17| T1: 32.00| R0: 0.0| R1: 0.0| WTP: 0,0,0.173076923,32,0,0,0,0,0,-2442906241,1083157068,5947.128611,2145549811,214554981.1,1,44084,1891,611,988,377,611,44084,377,988,104.8193833,2.528634361,4.158590308,68445.04405,986.5770925,6.889867841,99350.94714,0.688615203,0.009869687,7.0484E-05,0.381578947,0.022411759,33,24
D:0| T0: 0.17| T1: 32.00| R0: 0.0| R1: 0.0| WTP: 0,0,0.173076923,32,0,0,0,0,0,-2195326163,1988704626,3189.468904,2035852718,203585271.8,1,21682,887,470,530,60,470,21682,60,530,49.40358744,1.97309417,2.228699552,85041.75785,249.4080717,4.340807175,99658.37668,0.853324847,0.002491796,4.47597E-05,0.113207547,0.02444875,32,23
D:0| T0: 0.17| T1: 32.00| R0: 0.0| R1: 0.0| WTP: 0,0,0.173076923,32,0,0,0,0,0,-1782919123,884761309,12743.97338,1145720455,114572045.5,1,99069,4387,436,2117,1681,436,99069,1681,2117,369.3673469,2.911564626,14.29251701,24302.81633,1752.081633,17.2585034,98511.2381,0.245066138,0.017571463,0.00017431,0.794048181,0.021368945,21,12
D:0| T0: 0.17| T1: 32.00| R0: 0.0| R1: 0.0| WTP: 0,0,0.173076923,32,0,0,0,0,0,-1357033682,533485933,716.7577695,1321195794,132119579.4,1,6560,306,119,119,0,119,6560,0,119,22.79012346,0.617283951,0.617283951,95949.82099,110.5246914,1.351851852,99933.99383,0.960166,0.001101319,1.46094E-05,0,0.018140244,24,15
D:0| T0: 0.17| T1: 32.00| R0: 0.0| R1: 0.0| WTP: 0,0,0.173076923,32,0,0,0,0,0,-1541710028,632196071,897.0507331,1496857491,149685749.1,1,7021,309,148,149,1,148,7021,1,149,21.58988764,0.724719101,0.730337079,95478.35393,102.4719101,1.584269663,99911.10674,0.955671149,0.001022034,1.66039E-05,0.006711409,0.021222048,26,17
D:0| T0: 0.17| T1: 32.00| R0: 0.0| R1: 0.0| WTP: 0,0,0.173076923,32,0,0,0,0,0,-2132995666,393400457,12797.00807,1493145262,149314526.2,1,96342,4175,447,2126,1679,447,96342,1679,2126,304.3430233,2.540697674,12.26162791,30650.72093,1753.767442,14.8372093,98579.56395,0.30840584,0.017605094,0.000150281,0.789746002,0.022067219,25,16
D:0| T0: 0.17| T1: 32.00| R0: 0.0| R1: 0.0| WTP: 0,0,0.173076923,32,0,0,0,0,0,-1929437168,398973227,10756.71502,1391601417,139160141.7,1,82399,3546,541,1787,1246,541,82399,1246,1787,262.9107143,3.136904762,10.48809524,44001.22024,1467.214286,13.69642857,98895.46429,0.443037157,0.014703408,0.000138964,0.697257974,0.021687156,24,15
D:0| T0: 0.17| T1: 32.00| R0: 0.0| R1: 0.0| WTP: 0,0,0.173076923,32,0,0,0,0,0,-3422522459,1402256491,10746.25412,2885209753,288520975.3,2,84485,3701,1673,1785,112,1673,84485,112,1785,76.97955707,2.679727428,2.858603066,52045.81772,911.6132879,5.713798978,99025.96593,0.524200237,0.009183508,5.93338E-05,0.062745098,0.021128011,84,32
D:0| T0: 0.17| T1: 32.00| R0: 0.0| R1: 0.0| WTP: 0,0,0.173076923,32,0,0,0,0,0,-2499058230,2102527413,9944.961666,2001810146,200181014.6,1,75044,3333,654,1652,998,654,75044,998,1652,199.9952607,3,7.696682464,47394.36019,2057.260664,10.81042654,98944.08531,0.4775157,0.020634822,0.00010969,0.604116223,0.022013752,31,22
D:0| T0: 0.17| T1: 32.00| R0: 0.0| R1: 0.0| WTP: 0,0,0.173076923,32,0,0,0,0,0,-2223863970,1748031099,11322.31507,1657748216,165774821.6,1,84820,3584,627,1881,1254,627,84820,1254,1881,249.6793478,3.331521739,10.09782609,42318.53804,2486.804348,13.48369565,98840.16304,0.42603791,0.024958767,0.000136848,0.666666667,0.022176373,27,18
D:0| T0: 0.17| T1: 32.00| R0: 0.0| R1: 0.0| WTP: 0,0,0.173076923,32,0,0,0,0,0,-2430745683,1946754629,1125.618252,2374464770,237446477,1,8598,349,187,187,0,187,8598,0,187,18.12195122,0.62601626,0.62601626,93951.59756,134.6626016,1.398373984,99876.96341,0.940719103,0.001344662,1.51554E-05,0,0.021749244,36,27
D:0| T0: 0.17| T1: 32.00| R0: 0.0| R1: 0.0| WTP: 0,0,0.173076923,32,0,0,0,0,0,-2053296278,2097712204,2149.705652,1945810995,194581099.5,1,17589,805,348,357,9,348,17589,9,357,45.97222222,1.444444444,1.49537037,88200.31481,251.962963,3.111111111,99778.14815,0.883997055,0.002514567,3.25451E-05,0.025210084,0.020296776,31,22
D:0| T0: 0.17| T1: 32.00| R0: 0.0| R1: 0.0| WTP: 0,0,0.173076923,32,0,0,0,0,0,-3434590282,1198827119,11009.87568,2884096498,288409649.8,2,84637,3625,957,1829,872,957,84637,872,1829,82.80586081,1.657509158,3.228937729,75048.21429,994.1483516,4.996336996,99507.37363,0.751237693,0.010012066,5.13993E-05,0.476763259,0.021609934,78,32
D:0| T0: 0.17| T1: 32.00| R0: 0.0| R1: 0.0| WTP: 0,0,0.173076923,32,0,0,0,0,0,-1404184043,109253198,30.1143433,1402678326,140267832.6,1,294,12,5,5,0,5,294,0,5,0.91160221,0.005524862,0.005524862,99818.67956,11.40331492,0.027624309,99997,0.998220311,0.000115882,5.49461E-07,0,0.017064846,25,16
D:0| T0: 0.17| T1: 32.00| R0: 0.0| R1: 0.0| WTP: 0,0,0.173076923,32,0,0,0,0,0,-1438170899,314481292,614.2164209,1407460078,140746007.8,1,4927,215,102,102,0,102,4927,0,102,17.11242604,0.49704142,0.49704142,96855.05917,87.1183432,1.100591716,99941.61538,0.969148319,0.000868848,1.20058E-05,0,0.020702253,25,16
D:0| T0: 0.17| T1: 36.00| R0: 0.0| R1: 0.0| WTP: 0,0,0.173076923,36,0,0,0,0,0,-1491858231,1178568022,30.12067847,1490352197,149035219.7,1,312,15,5,5,0,5,312,0,5,0.978378378,0,0,99803.43784,8.740540541,0.027027027,99996.95676,0.998068409,8.91422E-05,5.37645E-07,0,0.01607717,26,17
D:0| T0: 0.17| T1: 36.00| R0: 0.0| R1: 0.0| WTP: 0,0,0.173076923,36,0,0,0,0,0,-1906711473,2029998696,11746.56513,1319383216,131938321.6,1,95757,4310,471,1951,1480,471,95757,1480,1951,338.5,2.917721519,12.23417722,34133.97468,2047.259494,15.20253165,98787.36076,0.343134047,0.020521127,0.000153792,0.758585341,0.02037449,23,14
D:0| T0: 0.17| T1: 36.00| R0: 0.0| R1: 0.0| WTP: 0,0,0.173076923,36,0,0,0,0,0,-2792176117,776062361,10592.82938,2262534648,226253464.8,1,78227,3339,743,1760,1017,743,78227,1017,1760,168.219917,2.987551867,7.157676349,45972.9751,2014.377593,10.2406639,98885.53527,0.463070186,0.020230734,0.00010437,0.577840909,0.022498626,34,25
D:0| T0: 0.17| T1: 36.00| R0: 0.0| R1: 0.0| WTP: 0,0,0.173076923,36,0,0,0,0,0,-1494647557,1813046880,78.28705192,1490733204,149073320.4,1,566,31,13,13,0,13,566,0,13,2.232044199,0.022099448,0.022099448,99628.38674,18.9558011,0.093922652,99992.45856,0.996365391,0.000191001,1.42865E-06,0,0.022968198,26,17
D:0| T0: 0.17| T1: 36.00| R0: 0.0| R1: 0.0| WTP: 0,0,0.173076923,36,0,0,0,0,0,-1432585441,2032407216,2029.219858,1331124449,133112444.9,1,17270,787,311,337,26,311,17270,26,337,56.13333333,1.757575758,1.903030303,89330.33939,364.8,3.793939394,99814.11515,0.894983692,0.003633692,3.90999E-05,0.077151335,0.019513607,24,15
D:0| T0: 0.17| T1: 36.00| R0: 0.0| R1: 0.0| WTP: 0,0,0.173076923,36,0,0,0,0,0,-789830023.7,1507873352,18.03885983,788928080.7,78892808.07,1,53,5,3,3,0,3,53,0,3,0.346153846,0,0,99969.92308,3.353846154,0.023076923,99999.23846,0.999708164,3.52674E-05,4.5802E-07,0,0.056603774,18,9
D:0| T0: 0.17| T1: 36.00| R0: 0.0| R1: 0.0| WTP: 0,0,0.173076923,36,0,0,0,0,0,-968754026.9,1855899401,78.28915632,964839569,96483956.9,1,825,38,13,13,0,13,825,0,13,2.927536232,0.036231884,0.036231884,99516.06522,21.85507246,0.115942029,99992.72464,0.995239322,0.000219585,1.87061E-06,0,0.015757576,20,11
D:0| T0: 0.17| T1: 36.00| R0: 0.0| R1: 0.0| WTP: 0,0,0.173076923,36,0,0,0,0,0,-2279444171,1819459251,7663.077644,1896290289,189629028.9,1,60030,2612,568,1273,705,568,60030,705,1273,154.3495146,2.669902913,6.04368932,58086.92233,1047.548544,8.82038835,99174.00971,0.584913616,0.010488404,8.9509E-05,0.553809898,0.021206064,30,21
D:0| T0: 0.17| T1: 36.00| R0: 0.0| R1: 0.0| WTP: 0,0,0.173076923,36,0,0,0,0,0,-879717430.9,909791748,48.30141192,877302360.3,87730236.03,1,712,35,8,8,0,8,712,0,8,3.715384615,0.023076923,0.023076923,99597.11538,18.2,0.092307692,99996.43846,0.996011817,0.000183516,1.22141E-06,0,0.011235955,19,10
D:0| T0: 0.17| T1: 36.00| R0: 0.0| R1: 0.0| WTP: 0,0,0.173076923,36,0,0,0,0,0,-2768908769,1339092841,5566.990827,2490559227,249055922.7,1,38479,1611,616,925,309,616,38479,309,925,79.49027237,2.284046693,3.455252918,72084.45136,538.9610895,5.859922179,99363.0856,0.725226854,0.005394489,6.00101E-05,0.334054054,0.024039711,37,28
D:0| T0: 0.17| T1: 36.00| R0: 0.0| R1: 0.0| WTP: 0,0,0.173076923,36,0,0,0,0,0,-2030729947,1365866345,12461.40314,1407659790,140765979,1,97538,4342,473,2070,1597,473,97538,1597,2070,323.5361446,2.777108434,12.3313253,30129.07229,1838.403614,15.18674699,98646.18072,0.303029949,0.018449069,0.000153835,0.771497585,0.021222498,24,15
D:0| T0: 0.17| T1: 36.00| R0: 0.0| R1: 0.0| WTP: 0,0,0.173076923,36,0,0,0,0,0,-3392187696,825453433,4046.971983,3189839097,318983909.7,2,34951,1594,606,672,66,606,34951,66,672,53.48773842,1.506811989,1.678474114,72970.61308,485.0681199,3.346049046,99506.3297,0.733266385,0.004854549,3.4845E-05,0.098214286,0.019226918,53,36
D:0| T0: 0.17| T1: 36.00| R0: 0.0| R1: 0.0| WTP: 0,0,0.173076923,36,0,0,0,0,0,-1951386180,939711378,12599.97694,1321387333,132138733.3,1,97565,4337,449,2093,1644,449,97565,1644,2093,352.1225806,2.806451613,13.36129032,32566.96774,2472.883871,16.23870968,98693.54839,0.327314107,0.024802877,0.000164638,0.785475394,0.021452365,23,14
D:0| T0: 0.17| T1: 36.00| R0: 0.0| R1: 0.0| WTP: 0,0,0.173076923,36,0,0,0,0,0,-3260378681,638950699,1835.991689,3168579096,316857909.6,1,13634,617,305,305,0,305,13634,0,305,23.7275641,0.836538462,0.836538462,90128.5,273.8685897,1.814102564,99790.58333,0.903214974,0.00273645,1.95179E-05,0,0.022370544,45,36
D:0| T0: 0.17| T1: 36.00| R0: 0.0| R1: 0.0| WTP: 0,0,0.173076923,36,0,0,0,0,0,-1898766432,938699148,1005.479527,1848492455,184849245.5,1,7893,374,167,167,0,167,7893,0,167,21.25358852,0.669856459,0.669856459,94570.48804,126.861244,1.473684211,99894.5311,0.946752186,0.001265693,1.59175E-05,0,0.021157988,30,21
D:0| T0: 0.17| T1: 36.00| R0: 0.0| R1: 0.0| WTP: 0,0,0.173076923,36,0,0,0,0,0,-1841682443,121790188,18.05415653,1840779735,184077973.5,1,194,10,3,3,0,3,194,0,3,0.349056604,0,0,99886.26415,7.735849057,0.014150943,99998.73585,0.998877489,7.92026E-05,2.81693E-07,0,0.015463918,30,21
D:0| T0: 0.17| T1: 36.00| R0: 0.0| R1: 0.0| WTP: 0,0,0.173076923,36,0,0,0,0,0,-2726625721,1331335240,9325.005643,2260375439,226037543.9,1,73333,3203,757,1549,792,757,73333,792,1549,168.8675214,3.115384615,6.444444444,48747.92735,2061.089744,9.670940171,99013.54274,0.491023269,0.020674628,9.89128E-05,0.511297611,0.021122823,34,25
D:0| T0: 0.17| T1: 36.00| R0: 0.0| R1: 0.0| WTP: 0,0,0.173076923,36,0,0,0,0,0,-2163737738,470935411,13362.35035,1495620221,149562022.1,1,98775,4173,475,2220,1745,475,98775,1745,2220,312.5,2.697674419,12.81395349,24473.4186,1485.94186,15.54651163,98426.86628,0.246574405,0.014924275,0.000157498,0.786036036,0.022475323,25,16
D:0| T0: 0.17| T1: 36.00| R0: 0.0| R1: 0.0| WTP: 0,0,0.173076923,36,0,0,0,0,0,-3851743736,823434397,12301.62897,3236662287,323666228.7,2,90001,3796,928,2044,1116,928,90001,1116,2044,89.43023256,1.678294574,3.817829457,73229.66667,890.4593023,5.624031008,99441.76938,0.733591536,0.008976048,5.80504E-05,0.545988258,0.022710859,74,36
D:0| T0: 0.17| T1: 36.00| R0: 0.0| R1: 0.0| WTP: 0,0,0.173076923,36,0,0,0,0,0,-1147243496,493045351,132.4932633,1140618833,114061883.3,1,1358,62,22,22,0,22,1358,0,22,4.570469799,0.073825503,0.073825503,99178.87919,23.2147651,0.228187919,99988.9396,0.991908714,0.000233087,2.93363E-06,0,0.016212233,22,13
D:0| T0: 0.17| T1: 36.00| R0: 0.0| R1: 0.0| WTP: 0,0,0.173076923,36,0,0,0,0,0,-3742453585,1700216563,10009.2989,3241988640,324198864,2,86927,4031,928,1662,734,928,86927,734,1662,93.0744879,1.592178771,2.932960894,73305.20112,874.4171322,4.662942272,99521.03352,0.734014955,0.0088014,4.85311E-05,0.441636582,0.019119491,77,36
D:0| T0: 0.17| T1: 36.00| R0: 0.0| R1: 0.0| WTP: 0,0,0.173076923,36,0,0,0,0,0,-1699750614,1744119059,3565.528496,1521474189,152147418.9,1,31573,1438,445,592,147,445,31573,147,592,99.06043956,2.307692308,3.093406593,79206.44505,480.7417582,5.543956044,99645.01648,0.794821436,0.004795986,5.68324E-05,0.248310811,0.018750198,26,17
D:0| T0: 0.17| T1: 36.00| R0: 0.0| R1: 0.0| WTP: 0,0,0.173076923,36,0,0,0,0,0,-2637402637,2036906360,138.4339748,2630480938,263048093.8,1,937,44,23,23,0,23,937,0,23,2.098540146,0.025547445,0.025547445,99364.10219,24.20437956,0.105839416,99985.16788,0.993795662,0.000243338,1.67291E-06,0,0.024546425,39,30
D:0| T0: 0.17| T1: 36.00| R0: 0.0| R1: 0.0| WTP: 0,0,0.173076923,36,0,0,0,0,0,-2984409255,809704121,1583.620931,2905228209,290522820.9,1,12835,557,263,263,0,263,12835,0,263,24.24252492,0.704318937,0.704318937,91370.31894,221.2724252,1.604651163,99831.9402,0.915263963,0.002210643,1.74397E-05,0,0.020490845,42,33
D:0| T0: 0.17| T1: 36.00| R0: 0.0| R1: 0.0| WTP: 0,0,0.173076923,36,0,0,0,0,0,-2784244625,1219866412,8689.013898,2349793930,234979393,1,72235,3207,716,1443,727,716,72235,727,1443,168.6735537,2.851239669,5.82231405,47027.10744,2452.42562,8.79338843,99033.02066,0.473864652,0.024589884,8.9506E-05,0.503811504,0.019976466,35,26
D:0| T0: 0.17| T1: 36.00| R0: 0.0| R1: 0.0| WTP: 0,0,0.173076923,36,0,0,0,0,0,-880548875.2,843498920,72.19973601,876938888.4,87693888.84,1,647,29,12,12,0,12,647,0,12,1.92481203,0.015037594,0.015037594,99623.25564,22.4887218,0.127819549,99993.54887,0.996302547,0.000225537,1.79114E-06,0,0.018547141,19,10
D:0| T0: 0.17| T1: 36.00| R0: 0.0| R1: 0.0| WTP: 0,0,0.173076923,36,0,0,0,0,0,-2524679514,107351963,1245.829185,2462388055,246238805.5,1,8161,347,207,207,0,207,8161,0,207,17.71705426,0.689922481,0.689922481,94185.12791,220.0503876,1.457364341,99867.32171,0.94314445,0.002196296,1.60006E-05,0,0.025364539,37,28
D:0| T0: 0.17| T1: 36.00| R0: 0.0| R1: 0.0| WTP: 0,0,0.173076923,36,0,0,0,0,0,-3041632502,773789021,1077.470422,2987758981,298775898.1,1,8544,375,179,179,0,179,8544,0,179,14.62837838,0.456081081,0.456081081,94020.33108,198.3277027,1.087837838,99885.50338,0.941317545,0.001980593,1.20644E-05,0,0.020950375,43,34
D:0| T0: 0.17| T1: 36.00| R0: 0.0| R1: 0.0| WTP: 0,0,0.173076923,36,0,0,0,0,0,-3189235663,850936611,2166.299289,3080920698,308092069.8,1,15098,619,353,360,7,353,15098,7,360,23.84590164,1,1.019672131,88922.51475,261.6196721,2.213114754,99749.76393,0.891492083,0.002614122,2.33417E-05,0.019444444,0.023844218,44,35
D:0| T0: 0.17| T1: 36.00| R0: 0.0| R1: 0.0| WTP: 0,0,0.173076923,36,0,0,0,0,0,-2208661717,1701318364,6440.879931,1886617720,188661772,1,48546,2066,593,1070,477,593,48546,477,1070,128.1617647,2.799019608,5.098039216,66123.78431,1013.656863,8.014705882,99316.60294,0.665356634,0.010138231,8.15597E-05,0.445794393,0.022040951,30,21
D:0| T0: 0.17| T1: 36.00| R0: 0.0| R1: 0.0| WTP: 0,0,0.173076923,36,0,0,0,0,0,-1140198407,778708269,12.05544501,1139595635,113959563.5,1,160,9,2,2,0,2,160,0,2,0.577181208,0,0,99907.56376,7.577181208,0.013422819,99999.52349,0.999082926,7.74669E-05,2.66668E-07,0,0.012578616,22,13
D:0| T0: 0.17| T1: 36.00| R0: 0.0| R1: 0.0| WTP: 0,0,0.173076923,36,0,0,0,0,0,-1581914065,1391938506,1619.063448,1500960893,150096089.3,1,12213,490,265,269,4,265,12213,4,269,34.41242938,1.322033898,1.333333333,91991.17514,246.559322,2.870056497,99838.23164,0.921450195,0.002457106,3.00386E-05,0.014869888,0.02202571,26,17
D:0| T0: 0.17| T1: 36.00| R0: 0.0| R1: 0.0| WTP: 0,0,0.173076923,36,0,0,0,0,0,-966359998.7,43418681,36.15789548,964552103.9,96455210.39,1,448,22,6,6,0,6,448,0,6,1.766423358,0,0,99738.22628,18.38686131,0.04379562,99996.93431,0.997417343,0.000185078,8.69587E-07,0,0.013392857,20,11
D:0| T0: 0.17| T1: 36.00| R0: 0.0| R1: 0.0| WTP: 0,0,0.173076923,36,0,0,0,0,0,-2757534997,817384966,13042.80165,2105394915,210539491.5,1,97822,4117,441,2167,1726,441,97822,1726,2167,235.1506849,1.96803653,9.808219178,20561.99087,1216.515982,11.82648402,98330.76712,0.207488953,0.012227703,0.000119801,0.796492847,0.022152481,32,23
D:0| T0: 0.17| T1: 36.00| R0: 0.0| R1: 0.0| WTP: 0,0,0.173076923,36,0,0,0,0,0,-1933910598,762053968,12269.39796,1320440700,132044070,1,95458,4290,497,2038,1541,497,95458,1541,2038,339.6918239,3.062893082,12.68553459,32651.35849,1878.163522,15.80503145,98698.81761,0.328496954,0.018836603,0.000160036,0.756133464,0.021349704,23,14
D:0| T0: 0.17| T1: 36.00| R0: 0.0| R1: 0.0| WTP: 0,0,0.173076923,36,0,0,0,0,0,-2580493242,1692506311,638.7625143,2548555116,254855511.6,1,6143,287,106,106,0,106,6143,0,106,14.67041199,0.288389513,0.288389513,95765.45318,154.3146067,0.685393258,99933.11236,0.958329567,0.001540373,7.9145E-06,0,0.017255413,38,29
D:0| T0: 0.17| T1: 36.00| R0: 0.0| R1: 0.0| WTP: 0,0,0.173076923,36,0,0,0,0,0,-615459852.2,1037620300,36.0634779,613656678.3,61365667.83,1,189,3,6,6,0,6,189,0,6,0.5625,0,0,99899.99107,6.258928571,0.0625,99997.875,0.999023061,6.41604E-05,1.06197E-06,0,0.031746032,16,7
D:0| T0: 0.17| T1: 36.00| R0: 0.0| R1: 0.0| WTP: 0,0,0.173076923,36,0,0,0,0,0,-1528169582,301400999,656.3266049,1495353251,149535325.1,1,5263,243,109,109,0,109,5263,0,109,16.64835165,0.467032967,0.467032967,96524.47802,120.7802198,1.054945055,99935.81319,0.965902233,0.001204021,1.19188E-05,0,0.020710621,26,17
D:0| T0: 0.17| T1: 36.00| R0: 0.0| R1: 0.0| WTP: 0,0,0.173076923,36,0,0,0,0,0,-2510059671,1868336855,8579.025629,2081108389,208110838.9,1,67252,2898,610,1425,815,610,67252,815,1425,171.0182648,2.689497717,6.365296804,52262.28311,1195.570776,9.155251142,99064.35616,0.526522568,0.011982025,9.31687E-05,0.571929825,0.021188961,32,23
D:0| T0: 0.17| T1: 36.00| R0: 0.0| R1: 0.0| WTP: 0,0,0.173076923,36,0,0,0,0,0,-2224097217,1868498144,8223.015062,1812946464,181294646.4,1,62583,2729,635,1366,731,635,62583,731,1366,168.8325123,3.019704433,6.581280788,57170.52709,1278.660099,9.684729064,99143.84236,0.575684899,0.012807541,9.877E-05,0.535139092,0.021827014,29,20
D:0| T0: 0.17| T1: 36.00| R0: 0.0| R1: 0.0| WTP: 0,0,0.173076923,36,0,0,0,0,0,-1851510385,2101566889,192.5684389,1841881963,184188196.3,1,1307,54,32,32,0,32,1307,0,32,3.470588235,0.078431373,0.078431373,99127.97059,35.24019608,0.230392157,99980.40686,0.991485172,0.000352835,3.12242E-06,0,0.02448355,30,21
D:0| T0: 0.17| T1: 36.00| R0: 0.0| R1: 0.0| WTP: 0,0,0.173076923,36,0,0,0,0,0,-1968416855,1665097450,13001.34028,1318349841,131834984.1,1,98303,4245,438,2160,1722,438,98303,1722,2160,335.0573248,2.732484076,13.63694268,28653.10191,2147.821656,16.41401274,98558.82803,0.28833457,0.021555904,0.000166186,0.797222222,0.02197288,23,14
D:0| T0: 0.17| T1: 36.00| R0: 0.0| R1: 0.0| WTP: 0,0,0.173076923,36,0,0,0,0,0,-1883626195,1716179948,11242.80387,1321486001,132148600.1,1,98040,4376,478,1867,1389,478,98040,1389,1867,349.6815287,2.98089172,11.75159236,31126.16561,2151.77707,14.78343949,98819.96815,0.312876334,0.021562003,0.000149784,0.74397429,0.019043248,23,14
D:0| T0: 0.17| T1: 36.00| R0: 0.0| R1: 0.0| WTP: 0,0,0.173076923,36,0,0,0,0,0,-1161076997,1560278715,391.0284409,1141525574,114152557.4,1,2287,99,65,65,0,65,2287,0,65,7.272151899,0.284810127,0.284810127,98698.41139,47.56962025,0.696202532,99967.28481,0.987315533,0.000475487,8.17863E-06,0,0.028421513,22,13
D:0| T0: 0.17| T1: 36.00| R0: 0.0| R1: 0.0| WTP: 0,0,0.173076923,36,0,0,0,0,0,-2330459506,991019385,10124.37815,1824240598,182424059.8,1,75581,3192,610,1682,1072,610,75581,1072,1682,207.2182741,3.015228426,8.401015228,47832.03046,2275.329949,11.49238579,98948.60914,0.48181966,0.02281456,0.000116747,0.637336504,0.02225427,29,20
D:0| T0: 0.17| T1: 36.00| R0: 0.0| R1: 0.0| WTP: 0,0,0.173076923,36,0,0,0,0,0,-3783113737,118052103,10920.81916,3237072779,323707277.9,2,86488,3674,1629,1814,185,1629,86488,185,1814,76.16721854,2.536423841,2.82615894,47462.90232,724.9254967,5.523178808,98941.44371,0.4783395,0.007304409,5.74296E-05,0.101984564,0.020974008,87,36
D:0| T0: 0.17| T1: 36.00| R0: 0.0| R1: 0.0| WTP: 0,0,0.173076923,36,0,0,0,0,0,-2018243144,1209758844,12487.00953,1393892667,139389266.7,1,88204,3609,528,2075,1547,528,88204,1547,2075,273.9515152,3.139393939,12.44848485,40211.76364,1568.357576,15.62424242,98708.38788,0.404832705,0.015744512,0.000158423,0.745542169,0.02352501,24,15
D:0| T0: 0.17| T1: 36.00| R0: 0.0| R1: 0.0| WTP: 0,0,0.173076923,36,0,0,0,0,0,-971295411.4,70671723,132.287538,964681034.5,96468103.45,1,879,37,22,22,0,22,879,0,22,2.096296296,0.096296296,0.096296296,99502.6,40.9037037,0.251851852,99989.91111,0.995132145,0.000408641,3.23562E-06,0,0.025028441,20,11
D:0| T0: 0.17| T1: 36.00| R0: 0.0| R1: 0.0| WTP: 0,0,0.173076923,36,0,0,0,0,0,-615724590.1,1722612191,42.05585974,613621797.1,61362179.71,1,154,7,7,7,0,7,154,0,7,0.339130435,0,0,99925.90435,6.269565217,0.069565217,99997.8,0.999282038,6.45706E-05,1.20693E-06,0,0.045454545,16,7
D:0| T0: 0.17| T1: 36.00| R0: 0.0| R1: 0.0| WTP: 0,0,0.173076923,36,0,0,0,0,0,-2019662922,1968291596,60.27458221,2016649193,201664919.3,1,480,31,10,10,0,10,480,0,10,1.887892377,0.004484305,0.004484305,99687.01794,8.713004484,0.049327354,99995.69507,0.99691812,8.91993E-05,8.92897E-07,0,0.020833333,32,23
D:0| T0: 0.17| T1: 36.00| R0: 0.0| R1: 0.0| WTP: 0,0,0.173076923,36,0,0,0,0,0,-2081251979,1877569084,13494.00386,1406551787,140655178.7,1,98396,4145,476,2242,1766,476,98396,1766,2242,326.0802469,2.895061728,13.75308642,28298.09259,1940.851852,16.66666667,98508.96296,0.284748422,0.019488655,0.000168597,0.787689563,0.022785479,24,15
D:0| T0: 0.17| T1: 36.00| R0: 0.0| R1: 0.0| WTP: 0,0,0.173076923,36,0,0,0,0,0,-2068572054,1726322189,13306.75095,1403234506,140323450.6,1,96304,4112,524,2211,1687,524,96304,1687,2211,307.5030303,3.109090909,13.26060606,31480.65455,1982.472727,16.44848485,98571.98788,0.316751669,0.019905308,0.000166567,0.763003166,0.022958548,24,15
D:0| T0: 0.17| T1: 36.00| R0: 0.0| R1: 0.0| WTP: 0,0,0.173076923,36,0,0,0,0,0,-1886903744,307848836,11497.9627,1312005608,131200560.8,1,90240,3972,507,1910,1403,507,90240,1403,1910,304.1552795,3.062111801,11.72049689,39548.54658,1977.285714,14.86956522,98843.35404,0.397740099,0.019823457,0.000150608,0.734554974,0.02116578,23,14
D:0| T0: 0.17| T1: 36.00| R0: 0.0| R1: 0.0| WTP: 0,0,0.173076923,36,0,0,0,0,0,-1835977801,1154000220,12035.59302,1234198150,123419815,1,98939,4480,439,1999,1560,439,98939,1560,1999,356.8766234,2.753246753,12.83766234,25431.02597,1673.532468,15.72077922,98620.52597,0.256197708,0.016774105,0.000158844,0.780390195,0.020204368,22,13
D:0| T0: 0.17| T1: 36.00| R0: 0.0| R1: 0.0| WTP: 0,0,0.173076923,36,0,0,0,0,0,-1848893629,2028661055,150.3633374,1841375462,184137546.2,1,905,37,25,25,0,25,905,0,25,2,0.048780488,0.048780488,99380.10732,23.08292683,0.165853659,99985.20976,0.993956921,0.000232011,2.42747E-06,0,0.027624309,30,21
D:0| T0: 0.17| T1: 36.00| R0: 0.0| R1: 0.0| WTP: 0,0,0.173076923,36,0,0,0,0,0,-3818463132,1629114640,11452.02363,3245861950,324586195,2,91692,4045,1308,1902,594,1308,91692,594,1902,91.92882562,2.174377224,3.209964413,60052.1548,1009.800712,5.533807829,99234.62811,0.603037683,0.010174383,5.75363E-05,0.312302839,0.020743358,81,36
D:0| T0: 0.17| T1: 36.00| R0: 0.0| R1: 0.0| WTP: 0,0,0.173076923,36,0,0,0,0,0,-1964457217,1439048174,12952.84406,1316815014,131681501.4,1,97218,4091,501,2152,1651,501,97218,1651,2152,320.6583851,3.049689441,13.26708075,31550.6646,2571.826087,16.38509317,98626.93789,0.317283489,0.025819004,0.000165513,0.767193309,0.022135818,23,14
D:0| T0: 0.17| T1: 36.00| R0: 0.0| R1: 0.0| WTP: 0,0,0.173076923,36,0,0,0,0,0,-2606194342,865227006,13487.76317,1931806183,193180618.3,1,99171,4141,440,2241,1801,440,99171,1801,2241,253.4975845,2.062801932,10.73429952,18111.4058,1287.507246,12.87439614,98252.28502,0.182903911,0.012941058,0.000130328,0.803659081,0.022597332,30,21
D:0| T0: 0.17| T1: 36.00| R0: 0.0| R1: 0.0| WTP: 0,0,0.173076923,36,0,0,0,0,0,-3541606123,890479738,8194.431474,3131884549,313188454.9,1,65502,2868,855,1361,506,855,65502,506,1361,119.7679739,2.669934641,4.284313725,51526.37582,1528.915033,7.071895425,99057.38889,0.519313149,0.015341459,7.26885E-05,0.372058824,0.020763042,44,35
D:0| T0: 0.17| T1: 36.00| R0: 0.0| R1: 0.0| WTP: 0,0,0.173076923,36,0,0,0,0,0,-1260009283,1017049163,571.924303,1231413068,123141306.8,1,4882,218,95,95,0,95,4882,0,95,15.35220126,0.471698113,0.471698113,97010.84906,111.0251572,1.088050314,99947.66667,0.970643074,0.001106399,1.18804E-05,0,0.019459238,23,14
D:0| T0: 0.17| T1: 36.00| R0: 0.0| R1: 0.0| WTP: 0,0,0.173076923,36,0,0,0,0,0,-1316046176,1707305064,18.14171148,1315139090,131513909,1,304,12,3,3,0,3,304,0,3,1.43902439,0.006097561,0.006097561,99809.40854,9.384146341,0.018292683,99998.14634,0.998116373,9.53351E-05,3.63639E-07,0,0.009868421,24,15
D:0| T0: 0.17| T1: 36.00| R0: 0.0| R1: 0.0| WTP: 0,0,0.173076923,36,0,0,0,0,0,-2256163780,400145663,13458.37785,1583244887,158324488.7,1,99063,4296,416,2236,1820,416,99063,1820,2236,305.3125,2.301136364,12.61363636,21244.23864,1511.471591,14.97727273,98336.77273,0.214354435,0.015179205,0.000151496,0.813953488,0.022571495,26,17
D:0| T0: 0.17| T1: 36.00| R0: 0.0| R1: 0.0| WTP: 0,0,0.173076923,36,0,0,0,0,0,-1146840749,1662654181,120.5449117,1140813503,114081350.3,1,1480,66,20,20,0,20,1480,0,20,5.25974026,0.051948052,0.051948052,99114.72078,38.96753247,0.168831169,99989.98701,0.991256664,0.000389447,2.58088E-06,0,0.013513514,22,13
D:0| T0: 0.17| T1: 36.00| R0: 0.0| R1: 0.0| WTP: 0,0,0.173076923,36,0,0,0,0,0,-2028784179,182136456,12413.50839,1408108760,140810876,1,98235,4374,473,2062,1589,473,98235,1589,2062,333.2037037,2.87037037,12.62345679,28120.00617,2101.364198,15.5308642,98623.17284,0.282984097,0.021080113,0.000157104,0.770611057,0.020990482,24,15
D:0| T0: 0.17| T1: 36.00| R0: 0.0| R1: 0.0| WTP: 0,0,0.173076923,36,0,0,0,0,0,-1403902093,979575387,24.11458233,1402696364,140269636.4,1,290,12,4,4,0,4,290,0,4,1.046783626,0,0,99823.53216,11.45614035,0.023391813,99998.20468,0.99825693,0.000116223,4.65123E-07,0,0.013793103,25,16
D:0| T0: 0.17| T1: 36.00| R0: 0.0| R1: 0.0| WTP: 0,0,0.173076923,36,0,0,0,0,0,-2114530231,2142525414,10984.42846,1565308808,156530880.8,1,81403,3435,588,1825,1237,588,81403,1237,1825,240.7653631,3.201117318,10.05027933,45963.01676,1782.201117,13.33519553,98902.11732,0.462652857,0.017876666,0.000135287,0.677808219,0.022419321,26,17
D:0| T0: 0.17| T1: 36.00| R0: 0.0| R1: 0.0| WTP: 0,0,0.173076923,36,0,0,0,0,0,-3760846078,1464057597,10470.49099,3237321529,323732152.9,2,83320,3619,1592,1739,147,1592,83320,147,1739,78.28209459,2.516891892,2.748310811,51726.55236,527.9679054,5.451013514,99037.51689,0.521146348,0.005318148,5.66661E-05,0.08453134,0.02087159,85,36
D:0| T0: 0.17| T1: 36.00| R0: 0.0| R1: 0.0| WTP: 0,0,0.173076923,36,0,0,0,0,0,-2062133212,364562610,11580.68812,1483098806,148309880.6,1,87956,3757,530,1924,1394,530,87956,1394,1924,266.3275862,2.965517241,10.93678161,39138.09195,1709.189655,14,98782.65517,0.394011626,0.017143152,0.000141569,0.724532225,0.021874574,25,16
D:0| T0: 0.17| T1: 36.00| R0: 0.0| R1: 0.0| WTP: 0,0,0.173076923,36,0,0,0,0,0,-2257783547,40350784,10400.98761,1737734166,173773416.6,1,77125,3268,605,1728,1123,605,77125,1123,1728,212.625641,3.01025641,8.717948718,47288.47692,1529.682051,11.81538462,98915.11282,0.476332949,0.015341981,0.000120075,0.649884259,0.022405186,28,19
D:0| T0: 0.17| T1: 36.00| R0: 0.0| R1: 0.0| WTP: 0,0,0.173076923,36,0,0,0,0,0,-2074109977,804064356,9890.023559,1579608799,157960879.9,1,89264,4116,438,1642,1204,438,89264,1204,1642,292.2011173,2.379888268,9.072625698,36867.4581,1444.03352,11.50837989,98925.40223,0.370984933,0.014467612,0.000116487,0.733252132,0.018394874,26,17
D:0| T0: 0.17| T1: 36.00| R0: 0.0| R1: 0.0| WTP: 0,0,0.173076923,36,0,0,0,0,0,-1628227273,2125493986,5507.451387,1352854703,135285470.3,1,39738,1695,465,915,450,465,39738,450,915,129.0059524,2.654761905,5.303571429,74078.57738,742.8690476,8.041666667,99455.19643,0.744512211,0.007417016,8.20256E-05,0.491803279,0.023025819,24,15
D:0| T0: 0.17| T1: 36.00| R0: 0.0| R1: 0.0| WTP: 0,0,0.173076923,36,0,0,0,0,0,-2022145136,23154253,7499.412326,1647174520,164717452,1,69083,3146,519,1245,726,519,69083,726,1245,219.8315217,2.695652174,6.60326087,53171.11413,1000.472826,9.461956522,99223.38043,0.53493693,0.010008325,9.59413E-05,0.58313253,0.0180218,27,18
D:0| T0: 0.17| T1: 36.00| R0: 0.0| R1: 0.0| WTP: 0,0,0.173076923,36,0,0,0,0,0,-2038013103,1391367689,385.2502514,2018750591,201875059.1,1,3102,138,64,64,0,64,3102,0,64,7.206278027,0.170403587,0.170403587,97810.30493,47.04932735,0.452914798,99958.0583,0.97853964,0.000470982,5.71604E-06,0,0.020638504,32,23
D:0| T0: 0.17| T1: 36.00| R0: 0.0| R1: 0.0| WTP: 0,0,0.173076923,36,0,0,0,0,0,-2403329841,574142276,2173.165102,2294671586,229467158.6,1,16719,710,356,361,5,356,16719,5,361,36.45679012,1.304526749,1.325102881,88596.55556,316.4115226,2.794238683,99771.09053,0.888025751,0.003158796,2.94371E-05,0.013850416,0.021593492,35,26
D:0| T0: 0.17| T1: 36.00| R0: 0.0| R1: 0.0| WTP: 0,0,0.173076923,36,0,0,0,0,0,-701611202.7,898736779,6.039854375,701309210,70130921,1,92,4,1,1,0,1,92,0,1,0.578947368,0,0,99953.01754,5.789473684,0.00877193,99999.17544,0.999539648,5.9218E-05,1.73913E-07,0,0.010869565,17,8
D:0| T0: 0.17| T1: 36.00| R0: 0.0| R1: 0.0| WTP: 0,0,0.173076923,36,0,0,0,0,0,-2997621159,346473503,4705.084077,2762366955,276236695.5,1,43699,2075,632,781,149,632,43699,149,781,93.00357143,2.139285714,2.65,68346.65714,891.5892857,4.892857143,99475.89643,0.686883565,0.008918335,5.04839E-05,0.19078105,0.017872263,40,31
D:0| T0: 0.17| T1: 36.00| R0: 0.0| R1: 0.0| WTP: 0,0,0.173076923,36,0,0,0,0,0,-2795541010,445552282,4436.49241,2573716390,257371639,1,33491,1483,592,737,145,592,33491,145,737,66.94776119,2.063432836,2.593283582,76622.03358,719.0186567,4.809701493,99519.27239,0.769761245,0.007190865,4.95886E-05,0.196743555,0.022005912,38,29
D:0| T0: 0.17| T1: 36.00| R0: 0.0| R1: 0.0| WTP: 0,0,0.173076923,36,0,0,0,0,0,-1746013496,911758476,11946.23269,1148701861,114870186.1,1,99146,4479,437,1984,1547,437,99146,1547,1984,396.7676056,2.985915493,13.83098592,27636.58451,1954.535211,16.9084507,98686.9507,0.278200211,0.019581078,0.000170959,0.779737903,0.020010893,21,12
D:0| T0: 0.17| T1: 36.00| R0: 0.0| R1: 0.0| WTP: 0,0,0.173076923,36,0,0,0,0,0,-2141479453,1464197940,11111.20923,1585918992,158591899.2,1,93996,4382,552,1845,1293,552,93996,1293,1845,311.6256983,3.005586592,10.18994413,33594.05028,3063.877095,13.24581006,98820.50279,0.337879763,0.03073005,0.000134389,0.700813008,0.019628495,26,17
D:0| T0: 0.17| T1: 36.00| R0: 0.0| R1: 0.0| WTP: 0,0,0.173076923,36,0,0,0,0,0,-1687163374,500405854,1908.361708,1591745289,159174528.9,1,13849,600,307,317,10,307,13849,10,317,42.3315508,1.465240642,1.524064171,91001.3262,304.6149733,3.160427807,99814.31551,0.911740735,0.003036852,3.32424E-05,0.031545741,0.022894699,27,18
D:0| T0: 0.17| T1: 36.00| R0: 0.0| R1: 0.0| WTP: 0,0,0.173076923,36,0,0,0,0,0,-2004424760,772037341,12110.26047,1398911737,139891173.7,1,92766,3897,464,2012,1548,464,92766,1548,2012,293.5333333,2.739393939,12.06666667,35320.81818,1842.612121,14.87272727,98710.27879,0.355418127,0.018482671,0.000150624,0.769383698,0.021688981,24,15
D:0| T0: 0.17| T1: 36.00| R0: 0.0| R1: 0.0| WTP: 0,0,0.173076923,36,0,0,0,0,0,-967790505.6,1543158763,66.16145856,964482432.7,96448243.27,1,464,23,11,11,0,11,464,0,11,1.379562044,0.02189781,0.02189781,99731.39416,15.99270073,0.102189781,99993.85401,0.997379249,0.000161025,1.59428E-06,0,0.023706897,20,11
D:0| T0: 0.17| T1: 36.00| R0: 0.0| R1: 0.0| WTP: 0,0,0.173076923,36,0,0,0,0,0,-1832721565,1604932531,13782.2358,1143609775,114360977.5,1,98721,4189,442,2290,1848,442,98721,1848,2290,361.6438356,2.938356164,15.55479452,28998.41781,1995.582192,18.5890411,98497.54795,0.291808024,0.020024328,0.000187945,0.8069869,0.023196686,21,12
D:0| T0: 0.17| T1: 36.00| R0: 0.0| R1: 0.0| WTP: 0,0,0.173076923,36,0,0,0,0,0,-2606397423,539051477,10270.38144,2092878350,209287835,1,77413,3439,689,1706,1017,689,77413,1017,1706,202.8027523,3.059633028,7.669724771,45165.97248,2037.399083,10.82568807,98900.74771,0.45512808,0.0204447,0.000110323,0.596131301,0.022037642,32,23
D:0| T0: 0.17| T1: 36.00| R0: 0.0| R1: 0.0| WTP: 0,0,0.173076923,36,0,0,0,0,0,-1235046152,1743124675,144.3604116,1227828131,122782813.1,1,733,30,24,24,0,24,733,0,24,2.662420382,0.057324841,0.057324841,99529.2293,15.29299363,0.21656051,99986.01911,0.99543861,0.000153751,3.03832E-06,0,0.032742156,23,14
D:0| T0: 0.17| T1: 36.00| R0: 0.0| R1: 0.0| WTP: 0,0,0.173076923,36,0,0,0,0,0,-3814541165,1965983789,11551.12756,3236984787,323698478.7,2,87585,3709,1112,1919,807,1112,87585,807,1919,82.44049734,1.802841918,3.213143872,68524.09947,907.4316163,5.184724689,99343.22558,0.686853135,0.009145872,5.42412E-05,0.420531527,0.021910144,81,36
D:0| T0: 0.17| T1: 36.00| R0: 0.0| R1: 0.0| WTP: 0,0,0.173076923,36,0,0,0,0,0,-2320546455,516774280,728.3701541,2284127947,228412794.7,1,5542,243,121,121,0,121,5542,0,121,11.99186992,0.394308943,0.394308943,96125.00407,145.6747967,0.886178862,99922.0935,0.962033873,0.001453907,9.80332E-06,0,0.021833273,35,26
D:0| T0: 0.17| T1: 36.00| R0: 0.0| R1: 0.0| WTP: 0,0,0.173076923,36,0,0,0,0,0,-2296715272,86603142,12497.83911,1671823317,167182331.7,1,98877,4264,422,2076,1654,422,98877,1654,2076,296.4565217,2.239130435,11.19565217,20627.42391,1394.456522,13.48913043,98429.9837,0.20817992,0.013998365,0.000136404,0.79672447,0.020995783,27,18
D:0| T0: 0.17| T1: 36.00| R0: 0.0| R1: 0.0| WTP: 0,0,0.173076923,36,0,0,0,0,0,-965989593.7,1431870609,30.13122792,964483032.3,96448303.23,1,447,16,5,5,0,5,447,0,5,1.467153285,0,0,99737.33577,22.10948905,0.03649635,99997.13139,0.997406558,0.000221746,7.24652E-07,0,0.011185682,20,11
D:0| T0: 0.17| T1: 36.00| R0: 0.0| R1: 0.0| WTP: 0,0,0.173076923,36,0,0,0,0,0,-2561069609,1592383984,4882.931227,2316923047,231692304.7,1,38645,1653,625,811,186,625,38645,186,811,89.30165289,2.462809917,3.20661157,73345.36777,466.8347107,5.785123967,99478.17769,0.73708206,0.00466913,5.9338E-05,0.229346486,0.020985897,35,26
D:0| T0: 0.17| T1: 36.00| R0: 0.0| R1: 0.0| WTP: 0,0,0.173076923,36,0,0,0,0,0,-3258267433,1440183867,1728.954876,3171819689,317181968.9,2,15407,738,287,287,0,287,15407,0,287,29.37383178,0.791277259,0.791277259,88320.2866,231.3956386,1.647975078,99792.72274,0.885098164,0.002312016,1.7851E-05,0,0.018627896,46,36
D:0| T0: 0.17| T1: 36.00| R0: 0.0| R1: 0.0| WTP: 0,0,0.173076923,36,0,0,0,0,0,-2216600266,1696510588,439.4901935,2194625756,219462575.6,1,4098,171,73,73,0,73,4098,0,73,8.274678112,0.214592275,0.214592275,97230.24893,83.35622318,0.527896996,99953.59657,0.972780595,0.000832626,6.24149E-06,0,0.017813568,34,25
D:0| T0: 0.17| T1: 36.00| R0: 0.0| R1: 0.0| WTP: 0,0,0.173076923,36,0,0,0,0,0,-2298715397,895039877,11046.3651,1746397142,174639714.2,1,84956,3665,584,1835,1251,584,84956,1251,1835,240.5206186,2.93814433,9.319587629,39528.04124,2295.494845,12.31443299,98817.30412,0.398154226,0.02302829,0.000125193,0.681743869,0.021599416,28,19
D:0| T0: 0.17| T1: 36.00| R0: 0.0| R1: 0.0| WTP: 0,0,0.173076923,36,0,0,0,0,0,-3185527409,129565953,2076.479023,3081703458,308170345.8,1,13873,615,345,345,0,345,13873,0,345,25.1516129,0.961290323,0.961290323,90059.8129,316.2645161,2.080645161,99770.82903,0.902692706,0.003159971,2.2224E-05,0,0.024796367,44,35
D:0| T0: 0.17| T1: 36.00| R0: 0.0| R1: 0.0| WTP: 0,0,0.173076923,36,0,0,0,0,0,-1865188265,1902565669,415.5966057,1844408435,184440843.5,1,4219,196,69,69,0,69,4219,0,69,10.41545894,0.256038647,0.256038647,97168.86473,75.99033816,0.574879227,99955.94203,0.972147651,0.000759016,6.63677E-06,0,0.016362343,30,21
D:0| T0: 0.17| T1: 36.00| R0: 0.0| R1: 0.0| WTP: 0,0,0.173076923,36,0,0,0,0,0,-1413891858,1984179288,198.6784526,1403957935,140395793.5,1,1788,69,33,33,0,33,1788,0,33,5.296511628,0.087209302,0.087209302,98850.1686,78.55813953,0.284883721,99982.40116,0.988690847,0.000783459,3.81563E-06,0,0.018456376,25,16
D:0| T0: 0.17| T1: 36.00| R0: 0.0| R1: 0.0| WTP: 0,0,0.173076923,36,0,0,0,0,0,-3803583049,677377223,11317.421,3237711999,323771199.9,2,84948,3667,1756,1880,124,1756,84948,124,1880,69.18562874,2.44760479,2.625748503,47412.13323,1033.943114,5.269461078,98898.25898,0.478093082,0.010420804,5.48708E-05,0.065957447,0.022131186,95,36
D:0| T0: 0.17| T1: 36.00| R0: 0.0| R1: 0.0| WTP: 0,0,0.173076923,36,0,0,0,0,0,-3793808642,973583301,11018.71091,3242873096,324287309.6,2,90376,4060,1528,1830,302,1528,90376,302,1830,89.45225225,2.56036036,3.088288288,57085.04324,1327.194595,5.837837838,99166.90811,0.573436757,0.013372832,6.09325E-05,0.165027322,0.020248739,80,36
D:0| T0: 0.17| T1: 36.00| R0: 0.0| R1: 0.0| WTP: 0,0,0.173076923,36,0,0,0,0,0,-2037402907,781062938,1819.595345,1946423140,194642314,1,16669,807,300,302,2,300,16669,2,302,49.28301887,1.254716981,1.264150943,88793.16038,365.2264151,2.693396226,99814.68396,0.889631333,0.003642702,2.83044E-05,0.006622517,0.018117464,31,22
D:0| T0: 0.17| T1: 36.00| R0: 0.0| R1: 0.0| WTP: 0,0,0.173076923,36,0,0,0,0,0,-3833925328,338783425,11740.4836,3246901148,324690114.8,2,94131,4148,1013,1950,937,1013,94131,937,1950,92.38664323,1.632688928,3.253075571,63907.28647,1348.753954,5.026362039,99307.92267,0.640060384,0.013593821,5.24758E-05,0.480512821,0.020715811,82,36
D:0| T0: 0.17| T1: 36.00| R0: 0.0| R1: 0.0| WTP: 0,0,0.173076923,36,0,0,0,0,0,-1496594806,1027579040,114.3679034,1490876411,149087641.1,1,917,39,19,19,0,19,917,0,19,2.531914894,0.053191489,0.053191489,99416.66489,37.12234043,0.154255319,99988.96809,0.994283973,0.000371146,2.01075E-06,0,0.020765027,26,17
D:0| T0: 0.17| T1: 36.00| R0: 0.0| R1: 0.0| WTP: 0,0,0.173076923,36,0,0,0,0,0,-2935803379,764973813,2281.639231,2821721417,282172141.7,1,17440,762,378,379,1,378,17440,1,379,32.72852234,1.151202749,1.151202749,87800.37113,406.7869416,2.457044674,99752.73196,0.880195361,0.004063582,2.59727E-05,0.002638522,0.021731651,41,32
D:0| T0: 0.17| T1: 36.00| R0: 0.0| R1: 0.0| WTP: 0,0,0.173076923,36,0,0,0,0,0,-3436564257,1245753446,4894.419079,3191843304,319184330.4,1,37398,1650,633,813,180,633,37398,180,813,65.80511182,1.926517572,2.495207668,71759.77316,815.9392971,4.485623003,99420.11182,0.721640252,0.008167931,4.6243E-05,0.221402214,0.02173913,45,36
D:0| T0: 0.17| T1: 36.00| R0: 0.0| R1: 0.0| WTP: 0,0,0.173076923,36,0,0,0,0,0,-2115271545,1013177794,3310.063447,1949768372,194976837.2,1,24433,1013,457,550,93,457,24433,93,550,56.13615023,1.981220657,2.408450704,83444.0892,480.6244131,4.577464789,99656.82629,0.837286831,0.004798261,4.71851E-05,0.169090909,0.022510539,31,22
D:0| T0: 0.17| T1: 36.00| R0: 0.0| R1: 0.0| WTP: 0,0,0.173076923,36,0,0,0,0,0,-1668898538,1395089249,54.31437069,1666182819,166618281.9,1,867,37,9,9,0,9,867,0,9,2.642105263,0.010526316,0.010526316,99400.07895,24.06315789,0.052631579,99994.11053,0.994069425,0.000241844,9.42445E-07,0,0.010380623,28,19
D:0| T0: 0.17| T1: 36.00| R0: 0.0| R1: 0.0| WTP: 0,0,0.173076923,36,0,0,0,0,0,-438852878.3,1339545835,12.01008238,438252374.2,43825237.42,1,66,0,2,2,0,2,66,0,2,0,0,0,99962.31579,4.557894737,0.021052632,99998.72632,0.99963791,4.76049E-05,4.16669E-07,0,0.03030303,14,5
D:0| T0: 0.17| T1: 36.00| R0: 0.0| R1: 0.0| WTP: 0,0,0.173076923,36,0,0,0,0,0,-1803808453,219139554,11410.78146,1233269380,123326938,1,95408,4273,467,1895,1428,467,95408,1428,1895,366.147651,3.060402685,12.57718121,32898,1681.52349,15.7114094,98779.59732,0.331041421,0.016848896,0.000158928,0.753562005,0.019862066,22,13
D:0| T0: 0.17| T1: 36.00| R0: 0.0| R1: 0.0| WTP: 0,0,0.173076923,36,0,0,0,0,0,-1428864147,1336508942,451.6680232,1406280746,140628074.6,1,3698,167,75,75,0,75,3698,0,75,13.33727811,0.284023669,0.284023669,97760.78107,87.67455621,0.75739645,99962.23077,0.977996639,0.00087437,8.82671E-06,0,0.020281233,25,16
D:0| T0: 0.17| T1: 36.00| R0: 0.0| R1: 0.0| WTP: 0,0,0.173076923,36,0,0,0,0,0,-703999557.1,448559423,54.07595311,701295759.4,70129575.94,1,162,4,9,9,0,9,162,0,9,0.434782609,0.017391304,0.017391304,99910.31304,10.29565217,0.095652174,99997.29565,0.999132373,0.000104226,1.55178E-06,0,0.055555556,17,8
D:0| T0: 0.17| T1: 36.00| R0: 0.0| R1: 0.0| WTP: 0,0,0.173076923,36,0,0,0,0,0,-2341667252,2110028840,1089.701955,2287182154,228718215.4,1,8531,384,181,181,0,181,8531,0,181,19.525,0.629166667,0.629166667,94033.29583,172.9458333,1.3875,99883.17917,0.941479057,0.001726289,1.50339E-05,0,0.021216739,35,26
D:0| T0: 0.17| T1: 36.00| R0: 0.0| R1: 0.0| WTP: 0,0,0.173076923,36,0,0,0,0,0,-3883043180,1982030155,12938.08516,3236138922,323613892.2,2,90918,3735,1082,2150,1068,1082,90918,1068,2150,84.33148148,1.866666667,3.811111111,70150.01852,1117.701852,5.811111111,99341.24259,0.702950458,0.011277135,6.03644E-05,0.496744186,0.023647683,78,36
D:0| T0: 0.17| T1: 36.00| R0: 0.0| R1: 0.0| WTP: 0,0,0.173076923,36,0,0,0,0,0,-3350850333,696219407,3419.17834,3179891416,317989141.6,1,24467,1065,549,568,19,549,24467,19,568,43.66031746,1.571428571,1.628571429,82573.48254,257.3142857,3.393650794,99612.49206,0.828903879,0.002574202,3.54476E-05,0.033450704,0.023214943,45,36
D:0| T0: 0.17| T1: 36.00| R0: 0.0| R1: 0.0| WTP: 0,0,0.173076923,36,0,0,0,0,0,-1990826146,1402539442,10104.21028,1485615632,148561563.2,1,84628,3787,549,1678,1129,549,84628,1129,1678,283.7705882,3.147058824,9.741176471,44141.80588,2280.270588,12.94117647,99002.20588,0.443936197,0.022846769,0.000131338,0.672824791,0.019827953,25,16
D:0| T0: 0.17| T1: 36.00| R0: 0.0| R1: 0.0| WTP: 0,0,0.173076923,36,0,0,0,0,0,-2170138711,1319833493,10276.86929,1656295247,165629524.7,1,82058,3679,610,1707,1097,610,82058,1097,1707,240.6914894,3.159574468,8.95212766,43550.01596,2947.164894,12.18085106,98943.32447,0.438413347,0.029552063,0.000123649,0.64264792,0.020802359,27,18
D:0| T0: 0.17| T1: 36.00| R0: 0.0| R1: 0.0| WTP: 0,0,0.173076923,36,0,0,0,0,0,-1885052194,663608076,788.3451044,1845634939,184563493.9,1,5676,235,131,131,0,131,5676,0,131,13.57560976,0.502439024,0.502439024,96326.76585,165.702439,1.107317073,99923.73171,0.964032521,0.00165234,1.27265E-05,0,0.023079634,30,21
D:0| T0: 0.17| T1: 36.00| R0: 0.0| R1: 0.0| WTP: 0,0,0.173076923,36,0,0,0,0,0,-2020178004,414696500,72.25827997,2016565090,201656509,1,570,30,12,12,0,12,570,0,12,1.613333333,0.013333333,0.013333333,99633.01333,15.64444444,0.062222222,99993.08889,0.996404208,0.000158106,1.062E-06,0,0.021052632,32,23
D:0| T0: 0.17| T1: 36.00| R0: 0.0| R1: 0.0| WTP: 0,0,0.173076923,36,0,0,0,0,0,-1235681494,1249738535,150.4741011,1228157789,122815778.9,1,990,45,25,25,0,25,990,0,25,3.826086957,0.068322981,0.068322981,99391.55901,24.61490683,0.211180124,99987.7205,0.994045566,0.000246872,3.08678E-06,0,0.025252525,23,14
D:0| T0: 0.17| T1: 36.00| R0: 0.0| R1: 0.0| WTP: 0,0,0.173076923,36,0,0,0,0,0,-2025637172,614415382,168.55095,2017209625,201720962.5,1,1515,57,28,28,0,28,1515,0,28,3.399082569,0.041284404,0.041284404,99080.43119,44.09174312,0.174311927,99984.91284,0.990961812,0.000441702,2.55742E-06,0,0.018481848,32,23
D:0| T0: 0.17| T1: 36.00| R0: 0.0| R1: 0.0| WTP: 0,0,0.173076923,36,0,0,0,0,0,-1667325705,524899953,30.17289825,1665817060,166581706,1,480,28,5,5,0,5,480,0,5,1.458333333,0,0,99673.375,14.23958333,0.026041667,99996.66146,0.996772967,0.00014389,5.18145E-07,0,0.010438413,28,19
D:0| T0: 0.17| T1: 36.00| R0: 0.0| R1: 0.0| WTP: 0,0,0.173076923,36,0,0,0,0,0,-1868528488,1338977757,12660.58602,1235499187,123549918.7,1,98967,4419,403,2103,1700,403,98967,1700,2103,361.6623377,2.545454545,13.53896104,26152.23377,1689.824675,16.16233766,98549.27273,0.263361216,0.016945494,0.000163349,0.808368997,0.021249507,22,13
D:0| T0: 0.17| T1: 36.00| R0: 0.0| R1: 0.0| WTP: 0,0,0.173076923,36,0,0,0,0,0,-2171611986,341384587,10377.79317,1652722327,165272232.7,1,78975,3373,518,1724,1206,518,78975,1206,1724,230.9679144,2.695187166,9.096256684,43613.90909,1431.032086,11.86631016,98861.60428,0.439601863,0.01434678,0.000120265,0.699535963,0.021829693,27,18
D:0| T0: 0.17| T1: 36.00| R0: 0.0| R1: 0.0| WTP: 0,0,0.173076923,36,0,0,0,0,0,-3817213855,2032000160,11516.59596,3241384057,324138405.7,2,89036,3889,1256,1913,657,1256,89036,657,1913,93.22666667,2.220952381,3.455238095,67690.39238,1141.99619,5.834285714,99341.31619,0.679067028,0.011509358,6.08003E-05,0.343439624,0.021485691,75,36
D:0| T0: 0.17| T1: 36.00| R0: 0.0| R1: 0.0| WTP: 0,0,0.173076923,36,0,0,0,0,0,-2311998142,779488939,9722.511255,1825872580,182587258,1,76020,3316,566,1615,1049,566,76020,1049,1615,207.7821782,2.683168317,7.811881188,47341.05446,1430.034653,10.63861386,98974.18812,0.47678371,0.014336003,0.000108321,0.649535604,0.021244409,29,20
D:0| T0: 0.17| T1: 36.00| R0: 0.0| R1: 0.0| WTP: 0,0,0.173076923,36,0,0,0,0,0,-2403071716,1449019578,643.9927093,2370872080,237087208,1,4312,177,107,107,0,107,4312,0,107,9.519379845,0.290697674,0.290697674,97104.62791,105.1395349,0.724806202,99933.52326,0.971714509,0.001050298,8.26683E-06,0,0.024825986,36,27
D:0| T0: 0.17| T1: 36.00| R0: 0.0| R1: 0.0| WTP: 0,0,0.173076923,36,0,0,0,0,0,-1231066491,351952211,66.26538164,1227753222,122775322.2,1,521,28,11,11,0,11,521,0,11,2.541935484,0.006451613,0.006451613,99682.72903,14.9483871,0.096774194,99994.78065,0.996884685,0.000151096,1.41033E-06,0,0.021113244,23,14
D:0| T0: 0.17| T1: 36.00| R0: 0.0| R1: 0.0| WTP: 0,0,0.173076923,36,0,0,0,0,0,-1493321373,486595046,60.13217012,1490314765,149031476.5,1,385,16,10,10,0,10,385,0,10,0.798969072,0,0,99792.07732,15.70103093,0.051546392,99995.45876,0.997968414,0.000158418,1.02569E-06,0,0.026041667,26,17
D:0| T0: 0.17| T1: 36.00| R0: 0.0| R1: 0.0| WTP: 0,0,0.173076923,36,0,0,0,0,0,-2037782249,296745624,4954.595422,1790052477,179005247.7,1,39226,1736,481,823,342,481,39226,342,823,107.213198,2.294416244,4.005076142,73475.38579,975.6294416,6.446700508,99485.8731,0.738318974,0.00974749,6.6131E-05,0.415552855,0.020980982,29,20
D:0| T0: 0.17| T1: 36.00| R0: 0.0| R1: 0.0| WTP: 0,0,0.173076923,36,0,0,0,0,0,-1689278952,1671484194,409.4919052,1668804357,166880435.7,1,3384,161,68,68,0,68,3384,0,68,10.31606218,0.243523316,0.243523316,97859.04145,89.84974093,0.606217617,99960.7772,0.978995441,0.000896637,7.0126E-06,0,0.020106446,28,19
D:0| T0: 0.17| T1: 36.00| R0: 0.0| R1: 0.0| WTP: 0,0,0.173076923,36,0,0,0,0,0,-2177830809,422157396,11879.18551,1583871533,158387153.3,1,98334,4369,476,1973,1497,476,98334,1497,1973,303.9050279,2.592178771,10.92178771,26113.46927,2049.960894,13.58100559,98631.15642,0.262861855,0.020571472,0.000137384,0.758743031,0.020064271,26,17
D:0| T0: 0.17| T1: 36.00| R0: 0.0| R1: 0.0| WTP: 0,0,0.173076923,36,0,0,0,0,0,-1963423376,1916599091,12816.58979,1322593886,132259388.6,1,98431,4258,447,2129,1682,447,98431,1682,2129,350.1329114,2.753164557,13.34810127,27640.51899,2168.949367,16.1835443,98569.12025,0.278220405,0.021755487,0.000163717,0.790042273,0.021629365,23,14
D:0| T0: 0.17| T1: 36.00| R0: 0.0| R1: 0.0| WTP: 0,0,0.173076923,36,0,0,0,0,0,-1846254200,1005953941,12216.23243,1235442578,123544257.8,1,98342,4312,495,2029,1534,495,98342,1534,2029,368.8013245,3.225165563,13.32450331,30384.56954,2637.046358,16.58940397,98711.46358,0.305556772,0.026435801,0.000167715,0.756037457,0.02063208,22,13
D:0| T0: 0.17| T1: 36.00| R0: 0.0| R1: 0.0| WTP: 0,0,0.173076923,36,0,0,0,0,0,-1922051942,1422765615,12241.99292,1309952296,130995229.6,1,88872,3789,548,2034,1486,548,88872,1486,2034,297.05,3.31875,12.5375,40028.55,1926.55,16.00625,98767.19375,0.402835345,0.019329845,0.000161992,0.730580138,0.022886849,23,14
D:0| T0: 0.17| T1: 36.00| R0: 0.0| R1: 0.0| WTP: 0,0,0.173076923,36,0,0,0,0,0,-1141173493,699740192,30.09482132,1139668752,113966875.2,1,339,16,5,5,0,5,339,0,5,0.805194805,0.012987013,0.012987013,99795.20779,13.00649351,0.045454545,99997.74026,0.997978703,0.000131615,6.45172E-07,0,0.014749263,22,13
D:0| T0: 0.17| T1: 36.00| R0: 0.0| R1: 0.0| WTP: 0,0,0.173076923,36,0,0,0,0,0,-877077009.2,240885764,6.0931291,876772352.8,87677235.28,1,99,9,1,1,0,1,99,0,1,1.3046875,0,0,99939.54688,3.9609375,0.0078125,99999.63281,0.999401857,4.1628E-05,1.55039E-07,0,0.01010101,19,10
D:0| T0: 0.17| T1: 36.00| R0: 0.0| R1: 0.0| WTP: 0,0,0.173076923,36,0,0,0,0,0,-1751226524,2023806564,7473.239389,1377564554,137756455.4,1,64820,2923,579,1241,662,579,64820,662,1241,217.0898204,3.335329341,7.251497006,57969.91018,1628.628743,10.71856287,99283.88024,0.582960091,0.016284955,0.000109006,0.533440774,0.019145326,24,15
D:0| T0: 0.17| T1: 36.00| R0: 0.0| R1: 0.0| WTP: 0,0,0.173076923,36,0,0,0,0,0,-1409573787,1907493879,132.2933622,1402959119,140295911.9,1,938,34,22,22,0,22,938,0,22,1.761363636,0.051136364,0.051136364,99451.4375,32.5625,0.176136364,99987.76705,0.994641665,0.000326367,2.48613E-06,0,0.023454158,25,16
D:0| T0: 0.17| T1: 36.00| R0: 0.0| R1: 0.0| WTP: 0,0,0.173076923,36,0,0,0,0,0,-3826113302,1565815291,11791.24797,3236550903,323655090.3,2,90054,3771,1278,1959,681,1278,90054,681,1959,82.21326165,2.105734767,3.301075269,61992.12903,1296.960573,5.591397849,99220.72939,0.622044136,0.01307348,5.8449E-05,0.34762634,0.021753614,80,36
D:0| T0: 0.17| T1: 36.00| R0: 0.0| R1: 0.0| WTP: 0,0,0.173076923,36,0,0,0,0,0,-1772682733,784442364,343.1211169,1755526677,175552667.7,1,2611,121,57,57,0,57,2611,0,57,7.09223301,0.145631068,0.145631068,98276.67476,65.99029126,0.412621359,99967.82039,0.983102311,0.000659235,5.50875E-06,0,0.021830716,29,20
D:0| T0: 0.17| T1: 36.00| R0: 0.0| R1: 0.0| WTP: 0,0,0.173076923,36,0,0,0,0,0,-2026022510,206369745,9224.662745,1564789373,156478937.3,1,76953,3443,550,1532,982,550,76953,982,1532,238.8176796,2.928176796,8.303867403,48480.9116,1774.883978,11.3480663,99067.62431,0.487857087,0.017778876,0.00011528,0.640992167,0.019908256,26,17
D:0| T0: 0.17| T1: 36.00| R0: 0.0| R1: 0.0| WTP: 0,0,0.173076923,36,0,0,0,0,0,-2169931348,2087235992,11811.70151,1579346272,157934627.2,1,94449,4081,555,1962,1407,555,94449,1407,1962,284.9779006,2.983425414,10.68508287,32573.52486,2271.955801,13.75138122,98736.20994,0.327710743,0.022793562,0.00013965,0.717125382,0.020773116,26,17
D:0| T0: 0.17| T1: 36.00| R0: 0.0| R1: 0.0| WTP: 0,0,0.173076923,36,0,0,0,0,0,-2413545917,1019092536,795.0901621,2373791409,237379140.9,1,7491,319,132,132,0,132,7491,0,132,16.7983871,0.435483871,0.435483871,94738.0121,168.4798387,0.935483871,99912.95161,0.948251484,0.001681734,1.06092E-05,0,0.017621145,36,27
D:0| T0: 0.17| T1: 36.00| R0: 0.0| R1: 0.0| WTP: 0,0,0.173076923,36,0,0,0,0,0,-3156727701,1885906113,3088.117528,3002321825,300232182.5,1,24403,1024,458,513,55,458,24403,55,513,41.84228188,1.432885906,1.610738255,81610.28859,249.2718121,3.134228188,99629.61745,0.819159924,0.002492919,3.25573E-05,0.107212476,0.021022867,43,34
D:0| T0: 0.17| T1: 36.00| R0: 0.0| R1: 0.0| WTP: 0,0,0.173076923,36,0,0,0,0,0,-1475893206,2028637200,1264.513638,1412667524,141266752.4,1,11082,498,207,210,3,207,11082,3,210,33.42528736,1.051724138,1.063218391,92742.43678,248.8793103,2.229885057,99875.66667,0.928634903,0.002479365,2.38523E-05,0.014285714,0.018951358,25,16
D:0| T0: 0.17| T1: 36.00| R0: 0.0| R1: 0.0| WTP: 0,0,0.173076923,36,0,0,0,0,0,-2193661260,181476086,10709.8204,1658170240,165817024,1,86739,3824,537,1779,1242,537,86739,1242,1779,249.2956989,2.806451613,9.424731183,39414.52688,2185.919355,12.32258065,98865.46237,0.396737754,0.021924178,0.000124957,0.698145025,0.020509805,27,18
D:0| T0: 0.17| T1: 36.00| R0: 0.0| R1: 0.0| WTP: 0,0,0.173076923,36,0,0,0,0,0,-2203342319,2097578470,10842.9697,1661193834,166119383.4,1,85558,3814,584,1801,1217,584,85558,1217,1801,259.1290323,3.059139785,9.548387097,40090.06452,2490.709677,12.67204301,98856.64516,0.403672229,0.024981195,0.000128687,0.675735702,0.021050048,27,18
D:0| T0: 0.17| T1: 36.00| R0: 0.0| R1: 0.0| WTP: 0,0,0.173076923,36,0,0,0,0,0,-3819016747,119646392,11653.01222,3236366136,323636613.6,2,86420,3723,1116,1936,820,1116,86420,820,1936,83.30615942,1.85326087,3.30615942,72175.10145,987.2826087,5.346014493,99415.82065,0.72316538,0.009952124,5.57124E-05,0.423553719,0.022402222,79,36
D:0| T0: 0.17| T1: 36.00| R0: 0.0| R1: 0.0| WTP: 0,0,0.173076923,36,0,0,0,0,0,-1822268896,1298895859,11824.44223,1231046784,123104678.4,1,95331,4196,512,1964,1452,512,95331,1452,1964,353.56,3.333333333,12.93333333,35246.99333,2644.933333,16.35333333,98804.68,0.354356787,0.026513078,0.000165562,0.739307536,0.020601903,22,13
D:0| T0: 0.17| T1: 36.00| R0: 0.0| R1: 0.0| WTP: 0,0,0.173076923,36,0,0,0,0,0,-2537887848,1489316290,10625.0589,2006634903,200663490.3,1,82534,3668,529,1765,1236,529,82534,1236,1765,211.7887324,2.403755869,8.154929577,38400.00469,1348.258216,10.63849765,98764.79343,0.387276667,0.013528474,0.000108127,0.700283286,0.021385126,31,22
D:0| T0: 0.17| T1: 36.00| R0: 0.0| R1: 0.0| WTP: 0,0,0.173076923,36,0,0,0,0,0,-2717563507,855602142,14009.49354,2017088830,201708883,1,96194,3955,472,2328,1856,472,96194,1856,2328,236.6604651,2.153488372,10.74883721,26336.70233,1594.795349,12.94418605,98322.34419,0.265324005,0.016043383,0.000131127,0.797250859,0.024201094,31,22
D:0| T0: 0.17| T1: 36.00| R0: 0.0| R1: 0.0| WTP: 0,0,0.173076923,36,0,0,0,0,0,-2290824425,1438649896,3304.247164,2125612066,212561206.6,1,24979,1036,479,549,70,479,24979,70,549,52.61373391,1.922746781,2.210300429,83049.94421,545.1287554,4.244635193,99662.40773,0.833268084,0.005443653,4.40512E-05,0.127504554,0.021978462,33,24
D:0| T0: 0.17| T1: 36.00| R0: 0.0| R1: 0.0| WTP: 0,0,0.173076923,36,0,0,0,0,0,-1667490841,952489126,36.13731856,1665683975,166568397.5,1,393,13,6,6,0,6,393,0,6,1.036458333,0.005208333,0.005208333,99749.71354,16.3125,0.03125,99997.29688,0.997528192,0.000164252,6.21777E-07,0,0.015267176,28,19
D:0| T0: 0.17| T1: 36.00| R0: 0.0| R1: 0.0| WTP: 0,0,0.173076923,36,0,0,0,0,0,-1687488373,1550779155,12652.83926,1054846410,105484641,1,99140,4210,405,2102,1697,405,99140,1697,2102,388.0444444,2.925925926,15.45185185,25772.78519,2053.718519,18.45185185,98562.6,0.259796048,0.020577355,0.00018625,0.807326356,0.02120234,20,11
D:0| T0: 0.17| T1: 36.00| R0: 0.0| R1: 0.0| WTP: 0,0,0.173076923,36,0,0,0,0,0,-1584538183,607323321,120.3671534,1578519826,157851982.6,1,958,46,20,20,0,20,958,0,20,2.515957447,0.042553191,0.042553191,99350.77128,24.48404255,0.138297872,99988.26596,0.993634788,0.000245896,2.1166E-06,0,0.019832985,27,18
D:0| T0: 0.17| T1: 36.00| R0: 0.0| R1: 0.0| WTP: 0,0,0.173076923,36,0,0,0,0,0,-1763967924,2103646485,6320.595797,1447938134,144793813.4,1,48476,2088,518,1050,532,518,48476,532,1050,152.8176471,2.923529412,6.017647059,68788.1,861.6882353,9.047058824,99382.15294,0.691607142,0.008609496,9.21735E-05,0.506666667,0.021660203,25,16
D:0| T0: 0.17| T1: 36.00| R0: 0.0| R1: 0.0| WTP: 0,0,0.173076923,36,0,0,0,0,0,-1967351175,258120157,11146.97866,1410002242,141000224.2,1,97711,4438,441,1851,1410,441,97711,1410,1851,336.3151515,2.6,11.09090909,25085.55152,1505.909091,13.77575758,98682.07273,0.25287235,0.015096437,0.000139335,0.761750405,0.018943619,24,15
D:0| T0: 0.17| T1: 36.00| R0: 0.0| R1: 0.0| WTP: 0,0,0.173076923,36,0,0,0,0,0,-1881549754,1068951401,674.9467064,1847802418,184780241.8,1,6848,326,112,112,0,112,6848,0,112,19.8708134,0.435406699,0.435406699,95174.23445,127.6172249,0.976076555,99927.33971,0.952488261,0.001272629,1.06723E-05,0,0.01635514,30,21
D:0| T0: 0.17| T1: 36.00| R0: 0.0| R1: 0.0| WTP: 0,0,0.173076923,36,0,0,0,0,0,-3812980280,635956235,11550.6086,3235449850,323544985,2,85870,3704,1004,1919,915,1004,85870,915,1919,73.36451613,1.530645161,2.979032258,70956.13871,1047.827419,4.601612903,99399.21129,0.710567258,0.01055984,4.75198E-05,0.476810839,0.022347735,88,36
D:0| T0: 0.17| T1: 36.00| R0: 0.0| R1: 0.0| WTP: 0,0,0.173076923,36,0,0,0,0,0,-1056481164,1346693470,78.31500247,1052565414,105256541.4,1,830,35,13,13,0,13,830,0,13,3.167832168,0.034965035,0.034965035,99510.42657,29.68531469,0.104895105,99993.27972,0.995177696,0.00029731,1.80566E-06,0,0.015662651,21,12
D:0| T0: 0.17| T1: 36.00| R0: 0.0| R1: 0.0| WTP: 0,0,0.173076923,36,0,0,0,0,0,-2053644038,847102011,12959.21789,1405683144,140568314.4,1,98233,4205,472,2153,1681,472,98233,1681,2153,319.4573171,2.817073171,13,28185.04878,2044.310976,15.8597561,98563.80488,0.283633893,0.020520756,0.000160784,0.780771017,0.021917278,24,15
D:0| T0: 0.17| T1: 36.00| R0: 0.0| R1: 0.0| WTP: 0,0,0.173076923,36,0,0,0,0,0,-3868566309,812083272,12644.23087,3236354766,323635476.6,2,87068,3533,1875,2101,226,1875,87068,226,2101,76.84957265,3.005128205,3.372649573,51803.5094,910.8769231,6.605128205,98897.16068,0.521842685,0.009190082,6.85554E-05,0.107567825,0.024130565,84,36
D:0| T0: 0.17| T1: 36.00| R0: 0.0| R1: 0.0| WTP: 0,0,0.173076923,36,0,0,0,0,0,-2173799732,2146825809,11771.51154,1585224155,158522415.5,1,98874,4500,465,1955,1490,465,98874,1490,1955,310.3202247,2.556179775,10.8988764,22618.65169,1755.179775,13.51123596,98579.26404,0.228024452,0.017605376,0.000136496,0.762148338,0.01977264,26,17
D:0| T0: 0.17| T1: 36.00| R0: 0.0| R1: 0.0| WTP: 0,0,0.173076923,36,0,0,0,0,0,-2049126291,226186520,12851.40519,1406556032,140655603.2,1,97214,4231,468,2135,1667,468,97214,1667,2135,315.2619048,2.726190476,12.57738095,29346.85714,1687.755952,15.35714286,98566.32143,0.29534006,0.016944885,0.00015565,0.780796253,0.021961857,24,15
D:0| T0: 0.17| T1: 36.00| R0: 0.0| R1: 0.0| WTP: 0,0,0.173076923,36,0,0,0,0,0,-3840626082,1110225441,11914.30238,3244910963,324491096.3,2,89301,3950,1719,1979,260,1719,89301,260,1979,85.19224283,2.735244519,3.160202361,53798.57167,1158.613828,6.037099494,99027.91906,0.540801771,0.011683173,6.2859E-05,0.131379485,0.022161006,85,36
D:0| T0: 0.17| T1: 36.00| R0: 0.0| R1: 0.0| WTP: 0,0,0.173076923,36,0,0,0,0,0,-2799752948,1190767082,2908.788215,2654313537,265431353.7,1,26849,1155,465,483,18,465,26849,18,483,51.7032967,1.553113553,1.608058608,80675.79121,528.6410256,3.318681319,99676.7033,0.809389278,0.00528117,3.46811E-05,0.037267081,0.017989497,39,30
D:0| T0: 0.17| T1: 36.00| R0: 0.0| R1: 0.0| WTP: 0,0,0.173076923,36,0,0,0,0,0,-2049038391,2108234095,589.7016078,2019553310,201955331,1,3816,156,98,98,0,98,3816,0,98,9.366972477,0.28440367,0.28440367,97486.00917,107.4311927,0.747706422,99940.77523,0.975460291,0.001072089,8.95402E-06,0,0.025681342,32,23
D:0| T0: 0.17| T1: 36.00| R0: 0.0| R1: 0.0| WTP: 0,0,0.173076923,36,0,0,0,0,0,-2062506633,465621985,13044.7896,1410267153,141026715.3,1,98735,4381,480,2167,1687,480,98735,1687,2167,334.5272727,2.83030303,13.01212121,26112.41818,2058.369697,15.90909091,98516.55758,0.262930085,0.020662792,0.000161171,0.778495616,0.021947638,24,15
D:0| T0: 0.17| T1: 36.00| R0: 0.0| R1: 0.0| WTP: 0,0,0.173076923,36,0,0,0,0,0,-1470907198,1487072553,1168.372375,1412488579,141248857.9,1,11183,472,192,194,2,192,11183,2,194,33.1849711,1,1.011560694,93079.32948,235.1213873,2.115606936,99890.27746,0.931853345,0.00234256,2.22045E-05,0.010309278,0.017350863,25,16
D:0| T0: 0.17| T1: 36.00| R0: 0.0| R1: 0.0| WTP: 0,0,0.173076923,36,0,0,0,0,0,-2731172781,1213733847,4875.330653,2487406248,248740624.8,1,37564,1534,620,810,190,620,37564,190,810,73.66798419,2.304347826,3.015810277,73460.26087,625.9367589,5.466403162,99463.34783,0.738383356,0.006261691,5.65317E-05,0.234567901,0.021563199,37,28
D:0| T0: 0.17| T1: 36.00| R0: 0.0| R1: 0.0| WTP: 0,0,0.173076923,36,0,0,0,0,0,-2702535570,2003658337,5922.419548,2406414593,240641459.3,1,44748,1879,596,984,388,596,44748,388,984,90.98785425,2.311740891,3.862348178,67670.89474,734.1012146,6.271255061,99330.82591,0.680937101,0.007347291,6.40309E-05,0.394308943,0.02198981,36,27
D:0| T0: 0.17| T1: 36.00| R0: 0.0| R1: 0.0| WTP: 0,0,0.173076923,36,0,0,0,0,0,-1056628393,1170868072,84.26888432,1052414949,105241494.9,1,737,34,14,14,0,14,737,0,14,2.5,0.027777778,0.027777778,99553.38889,29.02777778,0.111111111,99993.40972,0.995606114,0.000290569,1.93116E-06,0,0.018995929,21,12
D:0| T0: 0.17| T1: 36.00| R0: 0.0| R1: 0.0| WTP: 0,0,0.173076923,36,0,0,0,0,0,-2356850640,569919592,11915.80294,1761060493,176106049.3,1,99253,4499,426,1979,1553,426,99253,1553,1979,291.0471204,2.178010471,10.28272251,19861.66492,1353.65445,12.51308901,98501.8377,0.200403918,0.013586368,0.000126488,0.784739768,0.019938944,28,19
D:0| T0: 0.17| T1: 36.00| R0: 0.0| R1: 0.0| WTP: 0,0,0.173076923,36,0,0,0,0,0,-2101805493,1833180623,4362.033463,1883703819,188370381.9,1,40935,1924,502,724,222,502,40935,222,724,121.7902439,2.292682927,3.336585366,71794.22927,925.3512195,5.795121951,99541.13171,0.721111564,0.009242055,5.97295E-05,0.306629834,0.017686576,30,21
D:0| T0: 0.17| T1: 36.00| R0: 0.0| R1: 0.0| WTP: 0,0,0.173076923,36,0,0,0,0,0,-2250428039,1123666637,13397.49232,1580553424,158055342.4,1,97045,4088,484,2226,1742,484,97045,1742,2226,292.4382022,2.646067416,12.37640449,26979.19101,1643.123596,15.08988764,98445.79213,0.271790086,0.016507599,0.000153066,0.782569632,0.022937812,26,17
D:0| T0: 0.17| T1: 36.00| R0: 0.0| R1: 0.0| WTP: 0,0,0.173076923,36,0,0,0,0,0,-2712613295,1682024981,9030.975062,2261064541,226106454.1,1,71675,3165,735,1500,765,735,71675,765,1500,166.8791667,2.966666667,6.091666667,50887.09167,2447.845833,9.158333333,99065.55417,0.512325812,0.024550112,9.34585E-05,0.51,0.020927799,34,25
D:0| T0: 0.17| T1: 36.00| R0: 0.0| R1: 0.0| WTP: 0,0,0.173076923,36,0,0,0,0,0,-3093503296,1687523543,1992.336254,2993886483,299388648.3,1,15603,650,331,331,0,331,15603,0,331,25.96632997,0.95959596,0.95959596,89222.13468,196.3131313,2.074074074,99784.98316,0.894166904,0.001961911,2.22508E-05,0,0.021215229,43,34
D:0| T0: 0.17| T1: 36.00| R0: 0.0| R1: 0.0| WTP: 0,0,0.173076923,36,0,0,0,0,0,-2098517827,178034412,12141.87123,1491424265,149142426.5,1,94595,4091,473,2017,1544,473,94595,1544,2017,302.4882353,2.705882353,11.71176471,32179.84706,1957.470588,14.5,98671.00588,0.323884412,0.01964123,0.000147066,0.765493307,0.02132248,25,16
D:0| T0: 0.17| T1: 36.00| R0: 0.0| R1: 0.0| WTP: 0,0,0.173076923,36,0,0,0,0,0,-1965558549,739490003,11252.80218,1402918440,140291844,1,93004,4063,472,1869,1397,472,93004,1397,1869,315.3580247,2.858024691,11.41358025,35432.75926,1602.95679,14.30864198,98812.0679,0.356447524,0.016067527,0.000144941,0.747458534,0.02009591,24,15
D:0| T0: 0.17| T1: 36.00| R0: 0.0| R1: 0.0| WTP: 0,0,0.173076923,36,0,0,0,0,0,-1973734689,178482706,8510.628926,1548203243,154820324.3,1,63172,2774,540,1414,874,540,63172,874,1414,187.3446328,2.95480226,7.836158192,57986.71186,1529.644068,10.87570621,99144.86441,0.58376196,0.01531079,0.000110547,0.618104668,0.022383334,26,17
D:0| T0: 0.17| T1: 36.00| R0: 0.0| R1: 0.0| WTP: 0,0,0.173076923,36,0,0,0,0,0,-2022576101,1919366370,3196.185014,1862766851,186276685.1,1,24018,1000,446,531,85,446,24018,85,531,59.85990338,2.033816425,2.429951691,84146.29469,401.7487923,4.599033816,99674.77295,0.844168403,0.004010565,4.70942E-05,0.16007533,0.022109339,30,21
D:0| T0: 0.17| T1: 36.00| R0: 0.0| R1: 0.0| WTP: 0,0,0.173076923,36,0,0,0,0,0,-1981487002,1819796913,11429.23864,1410025070,141002507,1,97451,4460,447,1898,1451,447,97451,1451,1898,331.8562874,2.622754491,11.25149701,29956.10778,2402.502994,13.91616766,98757.13174,0.301268217,0.024087167,0.000140892,0.764488936,0.019476455,24,15
D:0| T0: 0.17| T1: 36.00| R0: 0.0| R1: 0.0| WTP: 0,0,0.173076923,36,0,0,0,0,0,-3863400704,1866591913,12394.05927,3243697740,324369774,2,94853,4104,1134,2059,925,1134,94853,925,2059,97.59417476,2.036893204,3.809708738,66450.86602,1512.31068,6.027184466,99335.95534,0.665426014,0.015246517,6.24945E-05,0.449247207,0.021707273,74,36
D:0| T0: 0.17| T1: 36.00| R0: 0.0| R1: 0.0| WTP: 0,0,0.173076923,36,0,0,0,0,0,-1854053111,1219425989,12401.84865,1233960679,123396067.9,1,99237,4466,445,2060,1615,445,99237,1615,2060,367.2281879,2.899328859,13.69798658,25378.61074,1725.073826,16.67785235,98582.61074,0.255690659,0.017298075,0.000168699,0.783980583,0.020758386,22,13
D:0| T0: 0.17| T1: 36.00| R0: 0.0| R1: 0.0| WTP: 0,0,0.173076923,36,0,0,0,0,0,-2081001749,502409586,11734.42741,1494280379,149428037.9,1,97438,4267,475,1949,1474,475,97438,1474,1949,306.0287356,2.655172414,11.08045977,28094.3908,2257.413793,13.83333333,98682,0.282737,0.022643698,0.00013985,0.756285274,0.020002463,25,16
D:0| T0: 0.17| T1: 36.00| R0: 0.0| R1: 0.0| WTP: 0,0,0.173076923,36,0,0,0,0,0,-1956592972,1405887957,9608.669848,1476159480,147615948,1,76415,3438,512,1596,1084,512,76415,1084,1596,251.7869822,2.940828402,9.313609467,49101.85207,1371.710059,12.32544379,99030.04142,0.494238164,0.013737337,0.000124981,0.679197995,0.020885952,25,16
D:0| T0: 0.17| T1: 36.00| R0: 0.0| R1: 0.0| WTP: 0,0,0.173076923,36,0,0,0,0,0,-2094420002,283033753,12288.32318,1480003843,148000384.3,1,87277,3583,531,2042,1511,531,87277,1511,2042,255.9884393,2.994219653,11.67052023,38554.0578,1341.491329,14.74566474,98675.24855,0.388482073,0.013467474,0.000149366,0.739960823,0.023396771,25,16
D:0| T0: 0.17| T1: 36.00| R0: 0.0| R1: 0.0| WTP: 0,0,0.173076923,36,0,0,0,0,0,-2442906241,1083157068,5947.128611,2145549811,214554981.1,1,44084,1891,611,988,377,611,44084,377,988,104.8193833,2.528634361,4.158590308,68445.04405,986.5770925,6.889867841,99350.94714,0.688615203,0.009869687,7.0484E-05,0.381578947,0.022411759,33,24
D:0| T0: 0.17| T1: 36.00| R0: 0.0| R1: 0.0| WTP: 0,0,0.173076923,36,0,0,0,0,0,-2195326163,1988704626,3189.468904,2035852718,203585271.8,1,21682,887,470,530,60,470,21682,60,530,49.40358744,1.97309417,2.228699552,85041.75785,249.4080717,4.340807175,99658.37668,0.853324847,0.002491796,4.47597E-05,0.113207547,0.02444875,32,23
D:0| T0: 0.17| T1: 36.00| R0: 0.0| R1: 0.0| WTP: 0,0,0.173076923,36,0,0,0,0,0,-1782919123,884761309,12743.97338,1145720455,114572045.5,1,99069,4387,436,2117,1681,436,99069,1681,2117,369.3673469,2.911564626,14.29251701,24302.81633,1752.081633,17.2585034,98511.2381,0.245066138,0.017571463,0.00017431,0.794048181,0.021368945,21,12
D:0| T0: 0.17| T1: 36.00| R0: 0.0| R1: 0.0| WTP: 0,0,0.173076923,36,0,0,0,0,0,-1357033682,533485933,716.7577695,1321195794,132119579.4,1,6560,306,119,119,0,119,6560,0,119,22.79012346,0.617283951,0.617283951,95949.82099,110.5246914,1.351851852,99933.99383,0.960166,0.001101319,1.46094E-05,0,0.018140244,24,15
D:0| T0: 0.17| T1: 36.00| R0: 0.0| R1: 0.0| WTP: 0,0,0.173076923,36,0,0,0,0,0,-1541710028,632196071,897.0507331,1496857491,149685749.1,1,7021,309,148,149,1,148,7021,1,149,21.58988764,0.724719101,0.730337079,95478.35393,102.4719101,1.584269663,99911.10674,0.955671149,0.001022034,1.66039E-05,0.006711409,0.021222048,26,17
D:0| T0: 0.17| T1: 36.00| R0: 0.0| R1: 0.0| WTP: 0,0,0.173076923,36,0,0,0,0,0,-2132995666,393400457,12797.00807,1493145262,149314526.2,1,96342,4175,447,2126,1679,447,96342,1679,2126,304.3430233,2.540697674,12.26162791,30650.72093,1753.767442,14.8372093,98579.56395,0.30840584,0.017605094,0.000150281,0.789746002,0.022067219,25,16
D:0| T0: 0.17| T1: 36.00| R0: 0.0| R1: 0.0| WTP: 0,0,0.173076923,36,0,0,0,0,0,-1929437168,398973227,10756.71502,1391601417,139160141.7,1,82399,3546,541,1787,1246,541,82399,1246,1787,262.9107143,3.136904762,10.48809524,44001.22024,1467.214286,13.69642857,98895.46429,0.443037157,0.014703408,0.000138964,0.697257974,0.021687156,24,15
D:0| T0: 0.17| T1: 36.00| R0: 0.0| R1: 0.0| WTP: 0,0,0.173076923,36,0,0,0,0,0,-3801275420,1402256491,11269.40593,3237805124,323780512.4,2,84641,3753,1746,1872,126,1746,84641,126,1872,70.5648855,2.517557252,2.690076336,51399.90382,817.2916031,5.335877863,98985.08397,0.517895218,0.008236935,5.5668E-05,0.067307692,0.022116941,94,36
D:0| T0: 0.17| T1: 36.00| R0: 0.0| R1: 0.0| WTP: 0,0,0.173076923,36,0,0,0,0,0,-2499058230,2102527413,9944.961666,2001810146,200181014.6,1,75044,3333,654,1652,998,654,75044,998,1652,199.9952607,3,7.696682464,47394.36019,2057.260664,10.81042654,98944.08531,0.4775157,0.020634822,0.00010969,0.604116223,0.022013752,31,22
D:0| T0: 0.17| T1: 36.00| R0: 0.0| R1: 0.0| WTP: 0,0,0.173076923,36,0,0,0,0,0,-2223863970,1748031099,11322.31507,1657748216,165774821.6,1,84820,3584,627,1881,1254,627,84820,1254,1881,249.6793478,3.331521739,10.09782609,42318.53804,2486.804348,13.48369565,98840.16304,0.42603791,0.024958767,0.000136848,0.666666667,0.022176373,27,18
D:0| T0: 0.17| T1: 36.00| R0: 0.0| R1: 0.0| WTP: 0,0,0.173076923,36,0,0,0,0,0,-2430745683,1946754629,1125.618252,2374464770,237446477,1,8598,349,187,187,0,187,8598,0,187,18.12195122,0.62601626,0.62601626,93951.59756,134.6626016,1.398373984,99876.96341,0.940719103,0.001344662,1.51554E-05,0,0.021749244,36,27
D:0| T0: 0.17| T1: 36.00| R0: 0.0| R1: 0.0| WTP: 0,0,0.173076923,36,0,0,0,0,0,-2053296278,2097712204,2149.705652,1945810995,194581099.5,1,17589,805,348,357,9,348,17589,9,357,45.97222222,1.444444444,1.49537037,88200.31481,251.962963,3.111111111,99778.14815,0.883997055,0.002514567,3.25451E-05,0.025210084,0.020296776,31,22
D:0| T0: 0.17| T1: 36.00| R0: 0.0| R1: 0.0| WTP: 0,0,0.173076923,36,0,0,0,0,0,-3780803671,1198827119,10937.53053,3233927144,323392714.4,2,84506,3632,904,1817,913,904,84506,913,1817,76.97938144,1.465635739,3.006872852,75499.89691,929.8969072,4.565292096,99516.12543,0.75574261,0.009365443,4.70942E-05,0.502753304,0.021489598,84,36
D:0| T0: 0.17| T1: 36.00| R0: 0.0| R1: 0.0| WTP: 0,0,0.173076923,36,0,0,0,0,0,-1404184043,109253198,30.1143433,1402678326,140267832.6,1,294,12,5,5,0,5,294,0,5,0.91160221,0.005524862,0.005524862,99818.67956,11.40331492,0.027624309,99997,0.998220311,0.000115882,5.49461E-07,0,0.017064846,25,16
D:0| T0: 0.17| T1: 36.00| R0: 0.0| R1: 0.0| WTP: 0,0,0.173076923,36,0,0,0,0,0,-1438170899,314481292,614.2164209,1407460078,140746007.8,1,4927,215,102,102,0,102,4927,0,102,17.11242604,0.49704142,0.49704142,96855.05917,87.1183432,1.100591716,99941.61538,0.969148319,0.000868848,1.20058E-05,0,0.020702253,25,16
D:0| T0: 0.17| T1: 40.00| R0: 0.0| R1: 0.0| WTP: 0,0,0.173076923,40,0,0,0,0,0,-1491858231,1178568022,30.12067847,1490352197,149035219.7,1,312,15,5,5,0,5,312,0,5,0.978378378,0,0,99803.43784,8.740540541,0.027027027,99996.95676,0.998068409,8.91422E-05,5.37645E-07,0,0.01607717,26,17
D:0| T0: 0.17| T1: 40.00| R0: 0.0| R1: 0.0| WTP: 0,0,0.173076923,40,0,0,0,0,0,-1906711473,2029998696,11746.56513,1319383216,131938321.6,1,95757,4310,471,1951,1480,471,95757,1480,1951,338.5,2.917721519,12.23417722,34133.97468,2047.259494,15.20253165,98787.36076,0.343134047,0.020521127,0.000153792,0.758585341,0.02037449,23,14
D:0| T0: 0.17| T1: 40.00| R0: 0.0| R1: 0.0| WTP: 0,0,0.173076923,40,0,0,0,0,0,-2792176117,776062361,10592.82938,2262534648,226253464.8,1,78227,3339,743,1760,1017,743,78227,1017,1760,168.219917,2.987551867,7.157676349,45972.9751,2014.377593,10.2406639,98885.53527,0.463070186,0.020230734,0.00010437,0.577840909,0.022498626,34,25
D:0| T0: 0.17| T1: 40.00| R0: 0.0| R1: 0.0| WTP: 0,0,0.173076923,40,0,0,0,0,0,-1494647557,1813046880,78.28705192,1490733204,149073320.4,1,566,31,13,13,0,13,566,0,13,2.232044199,0.022099448,0.022099448,99628.38674,18.9558011,0.093922652,99992.45856,0.996365391,0.000191001,1.42865E-06,0,0.022968198,26,17
D:0| T0: 0.17| T1: 40.00| R0: 0.0| R1: 0.0| WTP: 0,0,0.173076923,40,0,0,0,0,0,-1432585441,2032407216,2029.219858,1331124449,133112444.9,1,17270,787,311,337,26,311,17270,26,337,56.13333333,1.757575758,1.903030303,89330.33939,364.8,3.793939394,99814.11515,0.894983692,0.003633692,3.90999E-05,0.077151335,0.019513607,24,15
D:0| T0: 0.17| T1: 40.00| R0: 0.0| R1: 0.0| WTP: 0,0,0.173076923,40,0,0,0,0,0,-789830023.7,1507873352,18.03885983,788928080.7,78892808.07,1,53,5,3,3,0,3,53,0,3,0.346153846,0,0,99969.92308,3.353846154,0.023076923,99999.23846,0.999708164,3.52674E-05,4.5802E-07,0,0.056603774,18,9
D:0| T0: 0.17| T1: 40.00| R0: 0.0| R1: 0.0| WTP: 0,0,0.173076923,40,0,0,0,0,0,-968754026.9,1855899401,78.28915632,964839569,96483956.9,1,825,38,13,13,0,13,825,0,13,2.927536232,0.036231884,0.036231884,99516.06522,21.85507246,0.115942029,99992.72464,0.995239322,0.000219585,1.87061E-06,0,0.015757576,20,11
D:0| T0: 0.17| T1: 40.00| R0: 0.0| R1: 0.0| WTP: 0,0,0.173076923,40,0,0,0,0,0,-2279444171,1819459251,7663.077644,1896290289,189629028.9,1,60030,2612,568,1273,705,568,60030,705,1273,154.3495146,2.669902913,6.04368932,58086.92233,1047.548544,8.82038835,99174.00971,0.584913616,0.010488404,8.9509E-05,0.553809898,0.021206064,30,21
D:0| T0: 0.17| T1: 40.00| R0: 0.0| R1: 0.0| WTP: 0,0,0.173076923,40,0,0,0,0,0,-879717430.9,909791748,48.30141192,877302360.3,87730236.03,1,712,35,8,8,0,8,712,0,8,3.715384615,0.023076923,0.023076923,99597.11538,18.2,0.092307692,99996.43846,0.996011817,0.000183516,1.22141E-06,0,0.011235955,19,10
D:0| T0: 0.17| T1: 40.00| R0: 0.0| R1: 0.0| WTP: 0,0,0.173076923,40,0,0,0,0,0,-2768908769,1339092841,5566.990827,2490559227,249055922.7,1,38479,1611,616,925,309,616,38479,309,925,79.49027237,2.284046693,3.455252918,72084.45136,538.9610895,5.859922179,99363.0856,0.725226854,0.005394489,6.00101E-05,0.334054054,0.024039711,37,28
D:0| T0: 0.17| T1: 40.00| R0: 0.0| R1: 0.0| WTP: 0,0,0.173076923,40,0,0,0,0,0,-2030729947,1365866345,12461.40314,1407659790,140765979,1,97538,4342,473,2070,1597,473,97538,1597,2070,323.5361446,2.777108434,12.3313253,30129.07229,1838.403614,15.18674699,98646.18072,0.303029949,0.018449069,0.000153835,0.771497585,0.021222498,24,15
D:0| T0: 0.17| T1: 40.00| R0: 0.0| R1: 0.0| WTP: 0,0,0.173076923,40,0,0,0,0,0,-3654810209,825453433,4040.957975,3452762310,345276231,1,34920,1594,605,671,66,605,34920,66,671,58.54626866,1.650746269,1.83880597,73727.01791,531.0716418,3.662686567,99523.34925,0.740728272,0.005313382,3.81037E-05,0.098360656,0.019215349,48,39
D:0| T0: 0.17| T1: 40.00| R0: 0.0| R1: 0.0| WTP: 0,0,0.173076923,40,0,0,0,0,0,-1951386180,939711378,12599.97694,1321387333,132138733.3,1,97565,4337,449,2093,1644,449,97565,1644,2093,352.1225806,2.806451613,13.36129032,32566.96774,2472.883871,16.23870968,98693.54839,0.327314107,0.024802877,0.000164638,0.785475394,0.021452365,23,14
D:0| T0: 0.17| T1: 40.00| R0: 0.0| R1: 0.0| WTP: 0,0,0.173076923,40,0,0,0,0,0,-3260378681,638950699,1835.991689,3168579096,316857909.6,1,13634,617,305,305,0,305,13634,0,305,23.7275641,0.836538462,0.836538462,90128.5,273.8685897,1.814102564,99790.58333,0.903214974,0.00273645,1.95179E-05,0,0.022370544,45,36
D:0| T0: 0.17| T1: 40.00| R0: 0.0| R1: 0.0| WTP: 0,0,0.173076923,40,0,0,0,0,0,-1898766432,938699148,1005.479527,1848492455,184849245.5,1,7893,374,167,167,0,167,7893,0,167,21.25358852,0.669856459,0.669856459,94570.48804,126.861244,1.473684211,99894.5311,0.946752186,0.001265693,1.59175E-05,0,0.021157988,30,21
D:0| T0: 0.17| T1: 40.00| R0: 0.0| R1: 0.0| WTP: 0,0,0.173076923,40,0,0,0,0,0,-1841682443,121790188,18.05415653,1840779735,184077973.5,1,194,10,3,3,0,3,194,0,3,0.349056604,0,0,99886.26415,7.735849057,0.014150943,99998.73585,0.998877489,7.92026E-05,2.81693E-07,0,0.015463918,30,21
D:0| T0: 0.17| T1: 40.00| R0: 0.0| R1: 0.0| WTP: 0,0,0.173076923,40,0,0,0,0,0,-2726625721,1331335240,9325.005643,2260375439,226037543.9,1,73333,3203,757,1549,792,757,73333,792,1549,168.8675214,3.115384615,6.444444444,48747.92735,2061.089744,9.670940171,99013.54274,0.491023269,0.020674628,9.89128E-05,0.511297611,0.021122823,34,25
D:0| T0: 0.17| T1: 40.00| R0: 0.0| R1: 0.0| WTP: 0,0,0.173076923,40,0,0,0,0,0,-2163737738,470935411,13362.35035,1495620221,149562022.1,1,98775,4173,475,2220,1745,475,98775,1745,2220,312.5,2.697674419,12.81395349,24473.4186,1485.94186,15.54651163,98426.86628,0.246574405,0.014924275,0.000157498,0.786036036,0.022475323,25,16
D:0| T0: 0.17| T1: 40.00| R0: 0.0| R1: 0.0| WTP: 0,0,0.173076923,40,0,0,0,0,0,-3575003530,823434397,1215.788759,3514214092,351421409.2,2,9043,400,202,202,0,202,9043,0,202,13.1747851,0.46991404,0.46991404,93163.37249,131.5530086,1.051575931,99854.6533,0.933032151,0.001315458,1.15542E-05,0,0.022342661,50,40
D:0| T0: 0.17| T1: 40.00| R0: 0.0| R1: 0.0| WTP: 0,0,0.173076923,40,0,0,0,0,0,-1147243496,493045351,132.4932633,1140618833,114061883.3,1,1358,62,22,22,0,22,1358,0,22,4.570469799,0.073825503,0.073825503,99178.87919,23.2147651,0.228187919,99988.9396,0.991908714,0.000233087,2.93363E-06,0,0.016212233,22,13
D:0| T0: 0.17| T1: 40.00| R0: 0.0| R1: 0.0| WTP: 0,0,0.173076923,40,0,0,0,0,0,-4103492576,1700216563,10207.62771,3593111190,359311119,2,87005,4080,904,1695,791,904,87005,791,1695,91.42,1.503636364,2.921818182,75511.49636,855.3345455,4.569090909,99556.88364,0.756017549,0.008609758,4.75585E-05,0.466666667,0.019481639,79,40
D:0| T0: 0.17| T1: 40.00| R0: 0.0| R1: 0.0| WTP: 0,0,0.173076923,40,0,0,0,0,0,-1699750614,1744119059,3565.528496,1521474189,152147418.9,1,31573,1438,445,592,147,445,31573,147,592,99.06043956,2.307692308,3.093406593,79206.44505,480.7417582,5.543956044,99645.01648,0.794821436,0.004795986,5.68324E-05,0.248310811,0.018750198,26,17
D:0| T0: 0.17| T1: 40.00| R0: 0.0| R1: 0.0| WTP: 0,0,0.173076923,40,0,0,0,0,0,-2637402637,2036906360,138.4339748,2630480938,263048093.8,1,937,44,23,23,0,23,937,0,23,2.098540146,0.025547445,0.025547445,99364.10219,24.20437956,0.105839416,99985.16788,0.993795662,0.000243338,1.67291E-06,0,0.024546425,39,30
D:0| T0: 0.17| T1: 40.00| R0: 0.0| R1: 0.0| WTP: 0,0,0.173076923,40,0,0,0,0,0,-2984409255,809704121,1583.620931,2905228209,290522820.9,1,12835,557,263,263,0,263,12835,0,263,24.24252492,0.704318937,0.704318937,91370.31894,221.2724252,1.604651163,99831.9402,0.915263963,0.002210643,1.74397E-05,0,0.020490845,42,33
D:0| T0: 0.17| T1: 40.00| R0: 0.0| R1: 0.0| WTP: 0,0,0.173076923,40,0,0,0,0,0,-2784244625,1219866412,8689.013898,2349793930,234979393,1,72235,3207,716,1443,727,716,72235,727,1443,168.6735537,2.851239669,5.82231405,47027.10744,2452.42562,8.79338843,99033.02066,0.473864652,0.024589884,8.9506E-05,0.503811504,0.019976466,35,26
D:0| T0: 0.17| T1: 40.00| R0: 0.0| R1: 0.0| WTP: 0,0,0.173076923,40,0,0,0,0,0,-880548875.2,843498920,72.19973601,876938888.4,87693888.84,1,647,29,12,12,0,12,647,0,12,1.92481203,0.015037594,0.015037594,99623.25564,22.4887218,0.127819549,99993.54887,0.996302547,0.000225537,1.79114E-06,0,0.018547141,19,10
D:0| T0: 0.17| T1: 40.00| R0: 0.0| R1: 0.0| WTP: 0,0,0.173076923,40,0,0,0,0,0,-2524679514,107351963,1245.829185,2462388055,246238805.5,1,8161,347,207,207,0,207,8161,0,207,17.71705426,0.689922481,0.689922481,94185.12791,220.0503876,1.457364341,99867.32171,0.94314445,0.002196296,1.60006E-05,0,0.025364539,37,28
D:0| T0: 0.17| T1: 40.00| R0: 0.0| R1: 0.0| WTP: 0,0,0.173076923,40,0,0,0,0,0,-3041632502,773789021,1077.470422,2987758981,298775898.1,1,8544,375,179,179,0,179,8544,0,179,14.62837838,0.456081081,0.456081081,94020.33108,198.3277027,1.087837838,99885.50338,0.941317545,0.001980593,1.20644E-05,0,0.020950375,43,34
D:0| T0: 0.17| T1: 40.00| R0: 0.0| R1: 0.0| WTP: 0,0,0.173076923,40,0,0,0,0,0,-3189235663,850936611,2166.299289,3080920698,308092069.8,1,15098,619,353,360,7,353,15098,7,360,23.84590164,1,1.019672131,88922.51475,261.6196721,2.213114754,99749.76393,0.891492083,0.002614122,2.33417E-05,0.019444444,0.023844218,44,35
D:0| T0: 0.17| T1: 40.00| R0: 0.0| R1: 0.0| WTP: 0,0,0.173076923,40,0,0,0,0,0,-2208661717,1701318364,6440.879931,1886617720,188661772,1,48546,2066,593,1070,477,593,48546,477,1070,128.1617647,2.799019608,5.098039216,66123.78431,1013.656863,8.014705882,99316.60294,0.665356634,0.010138231,8.15597E-05,0.445794393,0.022040951,30,21
D:0| T0: 0.17| T1: 40.00| R0: 0.0| R1: 0.0| WTP: 0,0,0.173076923,40,0,0,0,0,0,-1140198407,778708269,12.05544501,1139595635,113959563.5,1,160,9,2,2,0,2,160,0,2,0.577181208,0,0,99907.56376,7.577181208,0.013422819,99999.52349,0.999082926,7.74669E-05,2.66668E-07,0,0.012578616,22,13
D:0| T0: 0.17| T1: 40.00| R0: 0.0| R1: 0.0| WTP: 0,0,0.173076923,40,0,0,0,0,0,-1581914065,1391938506,1619.063448,1500960893,150096089.3,1,12213,490,265,269,4,265,12213,4,269,34.41242938,1.322033898,1.333333333,91991.17514,246.559322,2.870056497,99838.23164,0.921450195,0.002457106,3.00386E-05,0.014869888,0.02202571,26,17
D:0| T0: 0.17| T1: 40.00| R0: 0.0| R1: 0.0| WTP: 0,0,0.173076923,40,0,0,0,0,0,-966359998.7,43418681,36.15789548,964552103.9,96455210.39,1,448,22,6,6,0,6,448,0,6,1.766423358,0,0,99738.22628,18.38686131,0.04379562,99996.93431,0.997417343,0.000185078,8.69587E-07,0,0.013392857,20,11
D:0| T0: 0.17| T1: 40.00| R0: 0.0| R1: 0.0| WTP: 0,0,0.173076923,40,0,0,0,0,0,-2757534997,817384966,13042.80165,2105394915,210539491.5,1,97822,4117,441,2167,1726,441,97822,1726,2167,235.1506849,1.96803653,9.808219178,20561.99087,1216.515982,11.82648402,98330.76712,0.207488953,0.012227703,0.000119801,0.796492847,0.022152481,32,23
D:0| T0: 0.17| T1: 40.00| R0: 0.0| R1: 0.0| WTP: 0,0,0.173076923,40,0,0,0,0,0,-1933910598,762053968,12269.39796,1320440700,132044070,1,95458,4290,497,2038,1541,497,95458,1541,2038,339.6918239,3.062893082,12.68553459,32651.35849,1878.163522,15.80503145,98698.81761,0.328496954,0.018836603,0.000160036,0.756133464,0.021349704,23,14
D:0| T0: 0.17| T1: 40.00| R0: 0.0| R1: 0.0| WTP: 0,0,0.173076923,40,0,0,0,0,0,-2580493242,1692506311,638.7625143,2548555116,254855511.6,1,6143,287,106,106,0,106,6143,0,106,14.67041199,0.288389513,0.288389513,95765.45318,154.3146067,0.685393258,99933.11236,0.958329567,0.001540373,7.9145E-06,0,0.017255413,38,29
D:0| T0: 0.17| T1: 40.00| R0: 0.0| R1: 0.0| WTP: 0,0,0.173076923,40,0,0,0,0,0,-615459852.2,1037620300,36.0634779,613656678.3,61365667.83,1,189,3,6,6,0,6,189,0,6,0.5625,0,0,99899.99107,6.258928571,0.0625,99997.875,0.999023061,6.41604E-05,1.06197E-06,0,0.031746032,16,7
D:0| T0: 0.17| T1: 40.00| R0: 0.0| R1: 0.0| WTP: 0,0,0.173076923,40,0,0,0,0,0,-1528169582,301400999,656.3266049,1495353251,149535325.1,1,5263,243,109,109,0,109,5263,0,109,16.64835165,0.467032967,0.467032967,96524.47802,120.7802198,1.054945055,99935.81319,0.965902233,0.001204021,1.19188E-05,0,0.020710621,26,17
D:0| T0: 0.17| T1: 40.00| R0: 0.0| R1: 0.0| WTP: 0,0,0.173076923,40,0,0,0,0,0,-2510059671,1868336855,8579.025629,2081108389,208110838.9,1,67252,2898,610,1425,815,610,67252,815,1425,171.0182648,2.689497717,6.365296804,52262.28311,1195.570776,9.155251142,99064.35616,0.526522568,0.011982025,9.31687E-05,0.571929825,0.021188961,32,23
D:0| T0: 0.17| T1: 40.00| R0: 0.0| R1: 0.0| WTP: 0,0,0.173076923,40,0,0,0,0,0,-2224097217,1868498144,8223.015062,1812946464,181294646.4,1,62583,2729,635,1366,731,635,62583,731,1366,168.8325123,3.019704433,6.581280788,57170.52709,1278.660099,9.684729064,99143.84236,0.575684899,0.012807541,9.877E-05,0.535139092,0.021827014,29,20
D:0| T0: 0.17| T1: 40.00| R0: 0.0| R1: 0.0| WTP: 0,0,0.173076923,40,0,0,0,0,0,-1851510385,2101566889,192.5684389,1841881963,184188196.3,1,1307,54,32,32,0,32,1307,0,32,3.470588235,0.078431373,0.078431373,99127.97059,35.24019608,0.230392157,99980.40686,0.991485172,0.000352835,3.12242E-06,0,0.02448355,30,21
D:0| T0: 0.17| T1: 40.00| R0: 0.0| R1: 0.0| WTP: 0,0,0.173076923,40,0,0,0,0,0,-1968416855,1665097450,13001.34028,1318349841,131834984.1,1,98303,4245,438,2160,1722,438,98303,1722,2160,335.0573248,2.732484076,13.63694268,28653.10191,2147.821656,16.41401274,98558.82803,0.28833457,0.021555904,0.000166186,0.797222222,0.02197288,23,14
D:0| T0: 0.17| T1: 40.00| R0: 0.0| R1: 0.0| WTP: 0,0,0.173076923,40,0,0,0,0,0,-1883626195,1716179948,11242.80387,1321486001,132148600.1,1,98040,4376,478,1867,1389,478,98040,1389,1867,349.6815287,2.98089172,11.75159236,31126.16561,2151.77707,14.78343949,98819.96815,0.312876334,0.021562003,0.000149784,0.74397429,0.019043248,23,14
D:0| T0: 0.17| T1: 40.00| R0: 0.0| R1: 0.0| WTP: 0,0,0.173076923,40,0,0,0,0,0,-1161076997,1560278715,391.0284409,1141525574,114152557.4,1,2287,99,65,65,0,65,2287,0,65,7.272151899,0.284810127,0.284810127,98698.41139,47.56962025,0.696202532,99967.28481,0.987315533,0.000475487,8.17863E-06,0,0.028421513,22,13
D:0| T0: 0.17| T1: 40.00| R0: 0.0| R1: 0.0| WTP: 0,0,0.173076923,40,0,0,0,0,0,-2330459506,991019385,10124.37815,1824240598,182424059.8,1,75581,3192,610,1682,1072,610,75581,1072,1682,207.2182741,3.015228426,8.401015228,47832.03046,2275.329949,11.49238579,98948.60914,0.48181966,0.02281456,0.000116747,0.637336504,0.02225427,29,20
D:0| T0: 0.17| T1: 40.00| R0: 0.0| R1: 0.0| WTP: 0,0,0.173076923,40,0,0,0,0,0,-4153358410,118052103,11287.58055,3588979383,358897938.3,2,86537,3764,1669,1875,206,1669,86537,206,1875,68.72459499,2.313696613,2.605301915,46888.7187,644.5522828,5.060382916,98906.92047,0.472737567,0.006496918,5.261E-05,0.109866667,0.021667033,97,40
D:0| T0: 0.17| T1: 40.00| R0: 0.0| R1: 0.0| WTP: 0,0,0.173076923,40,0,0,0,0,0,-2018243144,1209758844,12487.00953,1393892667,139389266.7,1,88204,3609,528,2075,1547,528,88204,1547,2075,273.9515152,3.139393939,12.44848485,40211.76364,1568.357576,15.62424242,98708.38788,0.404832705,0.015744512,0.000158423,0.745542169,0.02352501,24,15
D:0| T0: 0.17| T1: 40.00| R0: 0.0| R1: 0.0| WTP: 0,0,0.173076923,40,0,0,0,0,0,-971295411.4,70671723,132.287538,964681034.5,96468103.45,1,879,37,22,22,0,22,879,0,22,2.096296296,0.096296296,0.096296296,99502.6,40.9037037,0.251851852,99989.91111,0.995132145,0.000408641,3.23562E-06,0,0.025028441,20,11
D:0| T0: 0.17| T1: 40.00| R0: 0.0| R1: 0.0| WTP: 0,0,0.173076923,40,0,0,0,0,0,-615724590.1,1722612191,42.05585974,613621797.1,61362179.71,1,154,7,7,7,0,7,154,0,7,0.339130435,0,0,99925.90435,6.269565217,0.069565217,99997.8,0.999282038,6.45706E-05,1.20693E-06,0,0.045454545,16,7
D:0| T0: 0.17| T1: 40.00| R0: 0.0| R1: 0.0| WTP: 0,0,0.173076923,40,0,0,0,0,0,-2019662922,1968291596,60.27458221,2016649193,201664919.3,1,480,31,10,10,0,10,480,0,10,1.887892377,0.004484305,0.004484305,99687.01794,8.713004484,0.049327354,99995.69507,0.99691812,8.91993E-05,8.92897E-07,0,0.020833333,32,23
D:0| T0: 0.17| T1: 40.00| R0: 0.0| R1: 0.0| WTP: 0,0,0.173076923,40,0,0,0,0,0,-2081251979,1877569084,13494.00386,1406551787,140655178.7,1,98396,4145,476,2242,1766,476,98396,1766,2242,326.0802469,2.895061728,13.75308642,28298.09259,1940.851852,16.66666667,98508.96296,0.284748422,0.019488655,0.000168597,0.787689563,0.022785479,24,15
D:0| T0: 0.17| T1: 40.00| R0: 0.0| R1: 0.0| WTP: 0,0,0.173076923,40,0,0,0,0,0,-2068572054,1726322189,13306.75095,1403234506,140323450.6,1,96304,4112,524,2211,1687,524,96304,1687,2211,307.5030303,3.109090909,13.26060606,31480.65455,1982.472727,16.44848485,98571.98788,0.316751669,0.019905308,0.000166567,0.763003166,0.022958548,24,15
D:0| T0: 0.17| T1: 40.00| R0: 0.0| R1: 0.0| WTP: 0,0,0.173076923,40,0,0,0,0,0,-1886903744,307848836,11497.9627,1312005608,131200560.8,1,90240,3972,507,1910,1403,507,90240,1403,1910,304.1552795,3.062111801,11.72049689,39548.54658,1977.285714,14.86956522,98843.35404,0.397740099,0.019823457,0.000150608,0.734554974,0.02116578,23,14
D:0| T0: 0.17| T1: 40.00| R0: 0.0| R1: 0.0| WTP: 0,0,0.173076923,40,0,0,0,0,0,-1835977801,1154000220,12035.59302,1234198150,123419815,1,98939,4480,439,1999,1560,439,98939,1560,1999,356.8766234,2.753246753,12.83766234,25431.02597,1673.532468,15.72077922,98620.52597,0.256197708,0.016774105,0.000158844,0.780390195,0.020204368,22,13
D:0| T0: 0.17| T1: 40.00| R0: 0.0| R1: 0.0| WTP: 0,0,0.173076923,40,0,0,0,0,0,-1848893629,2028661055,150.3633374,1841375462,184137546.2,1,905,37,25,25,0,25,905,0,25,2,0.048780488,0.048780488,99380.10732,23.08292683,0.165853659,99985.20976,0.993956921,0.000232011,2.42747E-06,0,0.027624309,30,21
D:0| T0: 0.17| T1: 40.00| R0: 0.0| R1: 0.0| WTP: 0,0,0.173076923,40,0,0,0,0,0,-4174484456,1629114640,11577.84345,3595592284,359559228.4,2,91353,4128,1329,1923,594,1329,91353,594,1923,82.41033926,2.022617124,2.954765751,61504.51696,913.4798061,5.100161551,99252.41195,0.617688193,0.009207551,5.29371E-05,0.308892356,0.021050212,89,40
D:0| T0: 0.17| T1: 40.00| R0: 0.0| R1: 0.0| WTP: 0,0,0.173076923,40,0,0,0,0,0,-1964457217,1439048174,12952.84406,1316815014,131681501.4,1,97218,4091,501,2152,1651,501,97218,1651,2152,320.6583851,3.049689441,13.26708075,31550.6646,2571.826087,16.38509317,98626.93789,0.317283489,0.025819004,0.000165513,0.767193309,0.022135818,23,14
D:0| T0: 0.17| T1: 40.00| R0: 0.0| R1: 0.0| WTP: 0,0,0.173076923,40,0,0,0,0,0,-2606194342,865227006,13487.76317,1931806183,193180618.3,1,99171,4141,440,2241,1801,440,99171,1801,2241,253.4975845,2.062801932,10.73429952,18111.4058,1287.507246,12.87439614,98252.28502,0.182903911,0.012941058,0.000130328,0.803659081,0.022597332,30,21
D:0| T0: 0.17| T1: 40.00| R0: 0.0| R1: 0.0| WTP: 0,0,0.173076923,40,0,0,0,0,0,-3541606123,890479738,8194.431474,3131884549,313188454.9,1,65502,2868,855,1361,506,855,65502,506,1361,119.7679739,2.669934641,4.284313725,51526.37582,1528.915033,7.071895425,99057.38889,0.519313149,0.015341459,7.26885E-05,0.372058824,0.020763042,44,35
D:0| T0: 0.17| T1: 40.00| R0: 0.0| R1: 0.0| WTP: 0,0,0.173076923,40,0,0,0,0,0,-1260009283,1017049163,571.924303,1231413068,123141306.8,1,4882,218,95,95,0,95,4882,0,95,15.35220126,0.471698113,0.471698113,97010.84906,111.0251572,1.088050314,99947.66667,0.970643074,0.001106399,1.18804E-05,0,0.019459238,23,14
D:0| T0: 0.17| T1: 40.00| R0: 0.0| R1: 0.0| WTP: 0,0,0.173076923,40,0,0,0,0,0,-1316046176,1707305064,18.14171148,1315139090,131513909,1,304,12,3,3,0,3,304,0,3,1.43902439,0.006097561,0.006097561,99809.40854,9.384146341,0.018292683,99998.14634,0.998116373,9.53351E-05,3.63639E-07,0,0.009868421,24,15
D:0| T0: 0.17| T1: 40.00| R0: 0.0| R1: 0.0| WTP: 0,0,0.173076923,40,0,0,0,0,0,-2256163780,400145663,13458.37785,1583244887,158324488.7,1,99063,4296,416,2236,1820,416,99063,1820,2236,305.3125,2.301136364,12.61363636,21244.23864,1511.471591,14.97727273,98336.77273,0.214354435,0.015179205,0.000151496,0.813953488,0.022571495,26,17
D:0| T0: 0.17| T1: 40.00| R0: 0.0| R1: 0.0| WTP: 0,0,0.173076923,40,0,0,0,0,0,-1146840749,1662654181,120.5449117,1140813503,114081350.3,1,1480,66,20,20,0,20,1480,0,20,5.25974026,0.051948052,0.051948052,99114.72078,38.96753247,0.168831169,99989.98701,0.991256664,0.000389447,2.58088E-06,0,0.013513514,22,13
D:0| T0: 0.17| T1: 40.00| R0: 0.0| R1: 0.0| WTP: 0,0,0.173076923,40,0,0,0,0,0,-2028784179,182136456,12413.50839,1408108760,140810876,1,98235,4374,473,2062,1589,473,98235,1589,2062,333.2037037,2.87037037,12.62345679,28120.00617,2101.364198,15.5308642,98623.17284,0.282984097,0.021080113,0.000157104,0.770611057,0.020990482,24,15
D:0| T0: 0.17| T1: 40.00| R0: 0.0| R1: 0.0| WTP: 0,0,0.173076923,40,0,0,0,0,0,-1403902093,979575387,24.11458233,1402696364,140269636.4,1,290,12,4,4,0,4,290,0,4,1.046783626,0,0,99823.53216,11.45614035,0.023391813,99998.20468,0.99825693,0.000116223,4.65123E-07,0,0.013793103,25,16
D:0| T0: 0.17| T1: 40.00| R0: 0.0| R1: 0.0| WTP: 0,0,0.173076923,40,0,0,0,0,0,-2114530231,2142525414,10984.42846,1565308808,156530880.8,1,81403,3435,588,1825,1237,588,81403,1237,1825,240.7653631,3.201117318,10.05027933,45963.01676,1782.201117,13.33519553,98902.11732,0.462652857,0.017876666,0.000135287,0.677808219,0.022419321,26,17
D:0| T0: 0.17| T1: 40.00| R0: 0.0| R1: 0.0| WTP: 0,0,0.173076923,40,0,0,0,0,0,-3750901039,1464057597,5726.414307,3464580324,346458032.4,1,46331,2043,855,951,96,855,46331,96,951,78.78078078,2.408408408,2.678678679,67203.39339,520.1921922,5.27027027,99360.99099,0.675967907,0.005212507,5.43294E-05,0.100946372,0.0205271,48,39
D:0| T0: 0.17| T1: 40.00| R0: 0.0| R1: 0.0| WTP: 0,0,0.173076923,40,0,0,0,0,0,-2062133212,364562610,11580.68812,1483098806,148309880.6,1,87956,3757,530,1924,1394,530,87956,1394,1924,266.3275862,2.965517241,10.93678161,39138.09195,1709.189655,14,98782.65517,0.394011626,0.017143152,0.000141569,0.724532225,0.021874574,25,16
D:0| T0: 0.17| T1: 40.00| R0: 0.0| R1: 0.0| WTP: 0,0,0.173076923,40,0,0,0,0,0,-2257783547,40350784,10400.98761,1737734166,173773416.6,1,77125,3268,605,1728,1123,605,77125,1123,1728,212.625641,3.01025641,8.717948718,47288.47692,1529.682051,11.81538462,98915.11282,0.476332949,0.015341981,0.000120075,0.649884259,0.022405186,28,19
D:0| T0: 0.17| T1: 40.00| R0: 0.0| R1: 0.0| WTP: 0,0,0.173076923,40,0,0,0,0,0,-2074109977,804064356,9890.023559,1579608799,157960879.9,1,89264,4116,438,1642,1204,438,89264,1204,1642,292.2011173,2.379888268,9.072625698,36867.4581,1444.03352,11.50837989,98925.40223,0.370984933,0.014467612,0.000116487,0.733252132,0.018394874,26,17
D:0| T0: 0.17| T1: 40.00| R0: 0.0| R1: 0.0| WTP: 0,0,0.173076923,40,0,0,0,0,0,-1628227273,2125493986,5507.451387,1352854703,135285470.3,1,39738,1695,465,915,450,465,39738,450,915,129.0059524,2.654761905,5.303571429,74078.57738,742.8690476,8.041666667,99455.19643,0.744512211,0.007417016,8.20256E-05,0.491803279,0.023025819,24,15
D:0| T0: 0.17| T1: 40.00| R0: 0.0| R1: 0.0| WTP: 0,0,0.173076923,40,0,0,0,0,0,-2022145136,23154253,7499.412326,1647174520,164717452,1,69083,3146,519,1245,726,519,69083,726,1245,219.8315217,2.695652174,6.60326087,53171.11413,1000.472826,9.461956522,99223.38043,0.53493693,0.010008325,9.59413E-05,0.58313253,0.0180218,27,18
D:0| T0: 0.17| T1: 40.00| R0: 0.0| R1: 0.0| WTP: 0,0,0.173076923,40,0,0,0,0,0,-2038013103,1391367689,385.2502514,2018750591,201875059.1,1,3102,138,64,64,0,64,3102,0,64,7.206278027,0.170403587,0.170403587,97810.30493,47.04932735,0.452914798,99958.0583,0.97853964,0.000470982,5.71604E-06,0,0.020638504,32,23
D:0| T0: 0.17| T1: 40.00| R0: 0.0| R1: 0.0| WTP: 0,0,0.173076923,40,0,0,0,0,0,-2403329841,574142276,2173.165102,2294671586,229467158.6,1,16719,710,356,361,5,356,16719,5,361,36.45679012,1.304526749,1.325102881,88596.55556,316.4115226,2.794238683,99771.09053,0.888025751,0.003158796,2.94371E-05,0.013850416,0.021593492,35,26
D:0| T0: 0.17| T1: 40.00| R0: 0.0| R1: 0.0| WTP: 0,0,0.173076923,40,0,0,0,0,0,-701611202.7,898736779,6.039854375,701309210,70130921,1,92,4,1,1,0,1,92,0,1,0.578947368,0,0,99953.01754,5.789473684,0.00877193,99999.17544,0.999539648,5.9218E-05,1.73913E-07,0,0.010869565,17,8
D:0| T0: 0.17| T1: 40.00| R0: 0.0| R1: 0.0| WTP: 0,0,0.173076923,40,0,0,0,0,0,-2997621159,346473503,4705.084077,2762366955,276236695.5,1,43699,2075,632,781,149,632,43699,149,781,93.00357143,2.139285714,2.65,68346.65714,891.5892857,4.892857143,99475.89643,0.686883565,0.008918335,5.04839E-05,0.19078105,0.017872263,40,31
D:0| T0: 0.17| T1: 40.00| R0: 0.0| R1: 0.0| WTP: 0,0,0.173076923,40,0,0,0,0,0,-2795541010,445552282,4436.49241,2573716390,257371639,1,33491,1483,592,737,145,592,33491,145,737,66.94776119,2.063432836,2.593283582,76622.03358,719.0186567,4.809701493,99519.27239,0.769761245,0.007190865,4.95886E-05,0.196743555,0.022005912,38,29
D:0| T0: 0.17| T1: 40.00| R0: 0.0| R1: 0.0| WTP: 0,0,0.173076923,40,0,0,0,0,0,-1746013496,911758476,11946.23269,1148701861,114870186.1,1,99146,4479,437,1984,1547,437,99146,1547,1984,396.7676056,2.985915493,13.83098592,27636.58451,1954.535211,16.9084507,98686.9507,0.278200211,0.019581078,0.000170959,0.779737903,0.020010893,21,12
D:0| T0: 0.17| T1: 40.00| R0: 0.0| R1: 0.0| WTP: 0,0,0.173076923,40,0,0,0,0,0,-2141479453,1464197940,11111.20923,1585918992,158591899.2,1,93996,4382,552,1845,1293,552,93996,1293,1845,311.6256983,3.005586592,10.18994413,33594.05028,3063.877095,13.24581006,98820.50279,0.337879763,0.03073005,0.000134389,0.700813008,0.019628495,26,17
D:0| T0: 0.17| T1: 40.00| R0: 0.0| R1: 0.0| WTP: 0,0,0.173076923,40,0,0,0,0,0,-1687163374,500405854,1908.361708,1591745289,159174528.9,1,13849,600,307,317,10,307,13849,10,317,42.3315508,1.465240642,1.524064171,91001.3262,304.6149733,3.160427807,99814.31551,0.911740735,0.003036852,3.32424E-05,0.031545741,0.022894699,27,18
D:0| T0: 0.17| T1: 40.00| R0: 0.0| R1: 0.0| WTP: 0,0,0.173076923,40,0,0,0,0,0,-2004424760,772037341,12110.26047,1398911737,139891173.7,1,92766,3897,464,2012,1548,464,92766,1548,2012,293.5333333,2.739393939,12.06666667,35320.81818,1842.612121,14.87272727,98710.27879,0.355418127,0.018482671,0.000150624,0.769383698,0.021688981,24,15
D:0| T0: 0.17| T1: 40.00| R0: 0.0| R1: 0.0| WTP: 0,0,0.173076923,40,0,0,0,0,0,-967790505.6,1543158763,66.16145856,964482432.7,96448243.27,1,464,23,11,11,0,11,464,0,11,1.379562044,0.02189781,0.02189781,99731.39416,15.99270073,0.102189781,99993.85401,0.997379249,0.000161025,1.59428E-06,0,0.023706897,20,11
D:0| T0: 0.17| T1: 40.00| R0: 0.0| R1: 0.0| WTP: 0,0,0.173076923,40,0,0,0,0,0,-1832721565,1604932531,13782.2358,1143609775,114360977.5,1,98721,4189,442,2290,1848,442,98721,1848,2290,361.6438356,2.938356164,15.55479452,28998.41781,1995.582192,18.5890411,98497.54795,0.291808024,0.020024328,0.000187945,0.8069869,0.023196686,21,12
D:0| T0: 0.17| T1: 40.00| R0: 0.0| R1: 0.0| WTP: 0,0,0.173076923,40,0,0,0,0,0,-2606397423,539051477,10270.38144,2092878350,209287835,1,77413,3439,689,1706,1017,689,77413,1017,1706,202.8027523,3.059633028,7.669724771,45165.97248,2037.399083,10.82568807,98900.74771,0.45512808,0.0204447,0.000110323,0.596131301,0.022037642,32,23
D:0| T0: 0.17| T1: 40.00| R0: 0.0| R1: 0.0| WTP: 0,0,0.173076923,40,0,0,0,0,0,-1235046152,1743124675,144.3604116,1227828131,122782813.1,1,733,30,24,24,0,24,733,0,24,2.662420382,0.057324841,0.057324841,99529.2293,15.29299363,0.21656051,99986.01911,0.99543861,0.000153751,3.03832E-06,0,0.032742156,23,14
D:0| T0: 0.17| T1: 40.00| R0: 0.0| R1: 0.0| WTP: 0,0,0.173076923,40,0,0,0,0,0,-4173061160,1965983789,11725.02893,3586809713,358680971.3,2,87863,3679,1125,1948,823,1125,87863,823,1948,75.48355263,1.680921053,3.009868421,68512.15954,843.8207237,4.868421053,99331.24013,0.686794782,0.008508351,5.09352E-05,0.4224846,0.02217088,87,40
D:0| T0: 0.17| T1: 40.00| R0: 0.0| R1: 0.0| WTP: 0,0,0.173076923,40,0,0,0,0,0,-2320546455,516774280,728.3701541,2284127947,228412794.7,1,5542,243,121,121,0,121,5542,0,121,11.99186992,0.394308943,0.394308943,96125.00407,145.6747967,0.886178862,99922.0935,0.962033873,0.001453907,9.80332E-06,0,0.021833273,35,26
D:0| T0: 0.17| T1: 40.00| R0: 0.0| R1: 0.0| WTP: 0,0,0.173076923,40,0,0,0,0,0,-2296715272,86603142,12497.83911,1671823317,167182331.7,1,98877,4264,422,2076,1654,422,98877,1654,2076,296.4565217,2.239130435,11.19565217,20627.42391,1394.456522,13.48913043,98429.9837,0.20817992,0.013998365,0.000136404,0.79672447,0.020995783,27,18
D:0| T0: 0.17| T1: 40.00| R0: 0.0| R1: 0.0| WTP: 0,0,0.173076923,40,0,0,0,0,0,-965989593.7,1431870609,30.13122792,964483032.3,96448303.23,1,447,16,5,5,0,5,447,0,5,1.467153285,0,0,99737.33577,22.10948905,0.03649635,99997.13139,0.997406558,0.000221746,7.24652E-07,0,0.011185682,20,11
D:0| T0: 0.17| T1: 40.00| R0: 0.0| R1: 0.0| WTP: 0,0,0.173076923,40,0,0,0,0,0,-2561069609,1592383984,4882.931227,2316923047,231692304.7,1,38645,1653,625,811,186,625,38645,186,811,89.30165289,2.462809917,3.20661157,73345.36777,466.8347107,5.785123967,99478.17769,0.73708206,0.00466913,5.9338E-05,0.229346486,0.020985897,35,26
D:0| T0: 0.17| T1: 40.00| R0: 0.0| R1: 0.0| WTP: 0,0,0.173076923,40,0,0,0,0,0,-3345917664,1440183867,1728.954876,3259469920,325946992,1,15407,738,287,287,0,287,15407,0,287,29.37383178,0.791277259,0.791277259,88320.2866,231.3956386,1.647975078,99792.72274,0.885098164,0.002312016,1.7851E-05,0,0.018627896,46,37
D:0| T0: 0.17| T1: 40.00| R0: 0.0| R1: 0.0| WTP: 0,0,0.173076923,40,0,0,0,0,0,-2216600266,1696510588,439.4901935,2194625756,219462575.6,1,4098,171,73,73,0,73,4098,0,73,8.274678112,0.214592275,0.214592275,97230.24893,83.35622318,0.527896996,99953.59657,0.972780595,0.000832626,6.24149E-06,0,0.017813568,34,25
D:0| T0: 0.17| T1: 40.00| R0: 0.0| R1: 0.0| WTP: 0,0,0.173076923,40,0,0,0,0,0,-2298715397,895039877,11046.3651,1746397142,174639714.2,1,84956,3665,584,1835,1251,584,84956,1251,1835,240.5206186,2.93814433,9.319587629,39528.04124,2295.494845,12.31443299,98817.30412,0.398154226,0.02302829,0.000125193,0.681743869,0.021599416,28,19
D:0| T0: 0.17| T1: 40.00| R0: 0.0| R1: 0.0| WTP: 0,0,0.173076923,40,0,0,0,0,0,-3185527409,129565953,2076.479023,3081703458,308170345.8,1,13873,615,345,345,0,345,13873,0,345,25.1516129,0.961290323,0.961290323,90059.8129,316.2645161,2.080645161,99770.82903,0.902692706,0.003159971,2.2224E-05,0,0.024796367,44,35
D:0| T0: 0.17| T1: 40.00| R0: 0.0| R1: 0.0| WTP: 0,0,0.173076923,40,0,0,0,0,0,-1865188265,1902565669,415.5966057,1844408435,184440843.5,1,4219,196,69,69,0,69,4219,0,69,10.41545894,0.256038647,0.256038647,97168.86473,75.99033816,0.574879227,99955.94203,0.972147651,0.000759016,6.63677E-06,0,0.016362343,30,21
D:0| T0: 0.17| T1: 40.00| R0: 0.0| R1: 0.0| WTP: 0,0,0.173076923,40,0,0,0,0,0,-1413891858,1984179288,198.6784526,1403957935,140395793.5,1,1788,69,33,33,0,33,1788,0,33,5.296511628,0.087209302,0.087209302,98850.1686,78.55813953,0.284883721,99982.40116,0.988690847,0.000783459,3.81563E-06,0,0.018456376,25,16
D:0| T0: 0.17| T1: 40.00| R0: 0.0| R1: 0.0| WTP: 0,0,0.173076923,40,0,0,0,0,0,-4144938379,677377223,11172.63129,3586306815,358630681.5,2,84646,3596,1736,1856,120,1736,84646,120,1856,57.65172855,2.070422535,2.218950064,46217.95006,879.603073,4.440460948,98866.25736,0.466276697,0.008867695,4.63684E-05,0.064655172,0.021926871,111,40
D:0| T0: 0.17| T1: 40.00| R0: 0.0| R1: 0.0| WTP: 0,0,0.173076923,40,0,0,0,0,0,-4162548871,973583301,11379.0965,3593594046,359359404.6,2,90164,3991,1556,1890,334,1556,90164,334,1890,83.28187919,2.429530201,2.97147651,57390.90436,1229.458054,5.575503356,99149.85067,0.576665016,0.012391736,5.8251E-05,0.176719577,0.020961803,86,40
D:0| T0: 0.17| T1: 40.00| R0: 0.0| R1: 0.0| WTP: 0,0,0.173076923,40,0,0,0,0,0,-2037402907,781062938,1819.595345,1946423140,194642314,1,16669,807,300,302,2,300,16669,2,302,49.28301887,1.254716981,1.264150943,88793.16038,365.2264151,2.693396226,99814.68396,0.889631333,0.003642702,2.83044E-05,0.006622517,0.018117464,31,22
D:0| T0: 0.17| T1: 40.00| R0: 0.0| R1: 0.0| WTP: 0,0,0.173076923,40,0,0,0,0,0,-4182763230,338783425,11751.71618,3595177421,359517742.1,2,94156,4163,1027,1952,925,1027,94156,925,1952,91.5483871,1.67921147,3.311827957,69845.50358,1379.28853,5.154121864,99432.89606,0.699368792,0.013900044,5.37973E-05,0.473872951,0.020731552,80,40
D:0| T0: 0.17| T1: 40.00| R0: 0.0| R1: 0.0| WTP: 0,0,0.173076923,40,0,0,0,0,0,-1496594806,1027579040,114.3679034,1490876411,149087641.1,1,917,39,19,19,0,19,917,0,19,2.531914894,0.053191489,0.053191489,99416.66489,37.12234043,0.154255319,99988.96809,0.994283973,0.000371146,2.01075E-06,0,0.020765027,26,17
D:0| T0: 0.17| T1: 40.00| R0: 0.0| R1: 0.0| WTP: 0,0,0.173076923,40,0,0,0,0,0,-2935803379,764973813,2281.639231,2821721417,282172141.7,1,17440,762,378,379,1,378,17440,1,379,32.72852234,1.151202749,1.151202749,87800.37113,406.7869416,2.457044674,99752.73196,0.880195361,0.004063582,2.59727E-05,0.002638522,0.021731651,41,32
D:0| T0: 0.17| T1: 40.00| R0: 0.0| R1: 0.0| WTP: 0,0,0.173076923,40,0,0,0,0,0,-3436564257,1245753446,4894.419079,3191843304,319184330.4,1,37398,1650,633,813,180,633,37398,180,813,65.80511182,1.926517572,2.495207668,71759.77316,815.9392971,4.485623003,99420.11182,0.721640252,0.008167931,4.6243E-05,0.221402214,0.02173913,45,36
D:0| T0: 0.17| T1: 40.00| R0: 0.0| R1: 0.0| WTP: 0,0,0.173076923,40,0,0,0,0,0,-2115271545,1013177794,3310.063447,1949768372,194976837.2,1,24433,1013,457,550,93,457,24433,93,550,56.13615023,1.981220657,2.408450704,83444.0892,480.6244131,4.577464789,99656.82629,0.837286831,0.004798261,4.71851E-05,0.169090909,0.022510539,31,22
D:0| T0: 0.17| T1: 40.00| R0: 0.0| R1: 0.0| WTP: 0,0,0.173076923,40,0,0,0,0,0,-1668898538,1395089249,54.31437069,1666182819,166618281.9,1,867,37,9,9,0,9,867,0,9,2.642105263,0.010526316,0.010526316,99400.07895,24.06315789,0.052631579,99994.11053,0.994069425,0.000241844,9.42445E-07,0,0.010380623,28,19
D:0| T0: 0.17| T1: 40.00| R0: 0.0| R1: 0.0| WTP: 0,0,0.173076923,40,0,0,0,0,0,-438852878.3,1339545835,12.01008238,438252374.2,43825237.42,1,66,0,2,2,0,2,66,0,2,0,0,0,99962.31579,4.557894737,0.021052632,99998.72632,0.99963791,4.76049E-05,4.16669E-07,0,0.03030303,14,5
D:0| T0: 0.17| T1: 40.00| R0: 0.0| R1: 0.0| WTP: 0,0,0.173076923,40,0,0,0,0,0,-1803808453,219139554,11410.78146,1233269380,123326938,1,95408,4273,467,1895,1428,467,95408,1428,1895,366.147651,3.060402685,12.57718121,32898,1681.52349,15.7114094,98779.59732,0.331041421,0.016848896,0.000158928,0.753562005,0.019862066,22,13
D:0| T0: 0.17| T1: 40.00| R0: 0.0| R1: 0.0| WTP: 0,0,0.173076923,40,0,0,0,0,0,-1428864147,1336508942,451.6680232,1406280746,140628074.6,1,3698,167,75,75,0,75,3698,0,75,13.33727811,0.284023669,0.284023669,97760.78107,87.67455621,0.75739645,99962.23077,0.977996639,0.00087437,8.82671E-06,0,0.020281233,25,16
D:0| T0: 0.17| T1: 40.00| R0: 0.0| R1: 0.0| WTP: 0,0,0.173076923,40,0,0,0,0,0,-703999557.1,448559423,54.07595311,701295759.4,70129575.94,1,162,4,9,9,0,9,162,0,9,0.434782609,0.017391304,0.017391304,99910.31304,10.29565217,0.095652174,99997.29565,0.999132373,0.000104226,1.55178E-06,0,0.055555556,17,8
D:0| T0: 0.17| T1: 40.00| R0: 0.0| R1: 0.0| WTP: 0,0,0.173076923,40,0,0,0,0,0,-2341667252,2110028840,1089.701955,2287182154,228718215.4,1,8531,384,181,181,0,181,8531,0,181,19.525,0.629166667,0.629166667,94033.29583,172.9458333,1.3875,99883.17917,0.941479057,0.001726289,1.50339E-05,0,0.021216739,35,26
D:0| T0: 0.17| T1: 40.00| R0: 0.0| R1: 0.0| WTP: 0,0,0.173076923,40,0,0,0,0,0,-4244122239,1982030155,13077.36309,3590254085,359025408.5,2,90928,3805,1083,2173,1090,1083,90928,1090,2173,81.56239316,1.711111111,3.553846154,69899.14872,1031.957265,5.415384615,99327.73504,0.700492826,0.010412343,5.61476E-05,0.501610676,0.023898029,84,40
D:0| T0: 0.17| T1: 40.00| R0: 0.0| R1: 0.0| WTP: 0,0,0.173076923,40,0,0,0,0,0,-3350850333,696219407,3419.17834,3179891416,317989141.6,1,24467,1065,549,568,19,549,24467,19,568,43.66031746,1.571428571,1.628571429,82573.48254,257.3142857,3.393650794,99612.49206,0.828903879,0.002574202,3.54476E-05,0.033450704,0.023214943,45,36
D:0| T0: 0.17| T1: 40.00| R0: 0.0| R1: 0.0| WTP: 0,0,0.173076923,40,0,0,0,0,0,-1990826146,1402539442,10104.21028,1485615632,148561563.2,1,84628,3787,549,1678,1129,549,84628,1129,1678,283.7705882,3.147058824,9.741176471,44141.80588,2280.270588,12.94117647,99002.20588,0.443936197,0.022846769,0.000131338,0.672824791,0.019827953,25,16
D:0| T0: 0.17| T1: 40.00| R0: 0.0| R1: 0.0| WTP: 0,0,0.173076923,40,0,0,0,0,0,-2170138711,1319833493,10276.86929,1656295247,165629524.7,1,82058,3679,610,1707,1097,610,82058,1097,1707,240.6914894,3.159574468,8.95212766,43550.01596,2947.164894,12.18085106,98943.32447,0.438413347,0.029552063,0.000123649,0.64264792,0.020802359,27,18
D:0| T0: 0.17| T1: 40.00| R0: 0.0| R1: 0.0| WTP: 0,0,0.173076923,40,0,0,0,0,0,-1885052194,663608076,788.3451044,1845634939,184563493.9,1,5676,235,131,131,0,131,5676,0,131,13.57560976,0.502439024,0.502439024,96326.76585,165.702439,1.107317073,99923.73171,0.964032521,0.00165234,1.27265E-05,0,0.023079634,30,21
D:0| T0: 0.17| T1: 40.00| R0: 0.0| R1: 0.0| WTP: 0,0,0.173076923,40,0,0,0,0,0,-2020178004,414696500,72.25827997,2016565090,201656509,1,570,30,12,12,0,12,570,0,12,1.613333333,0.013333333,0.013333333,99633.01333,15.64444444,0.062222222,99993.08889,0.996404208,0.000158106,1.062E-06,0,0.021052632,32,23
D:0| T0: 0.17| T1: 40.00| R0: 0.0| R1: 0.0| WTP: 0,0,0.173076923,40,0,0,0,0,0,-1235681494,1249738535,150.4741011,1228157789,122815778.9,1,990,45,25,25,0,25,990,0,25,3.826086957,0.068322981,0.068322981,99391.55901,24.61490683,0.211180124,99987.7205,0.994045566,0.000246872,3.08678E-06,0,0.025252525,23,14
D:0| T0: 0.17| T1: 40.00| R0: 0.0| R1: 0.0| WTP: 0,0,0.173076923,40,0,0,0,0,0,-2025637172,614415382,168.55095,2017209625,201720962.5,1,1515,57,28,28,0,28,1515,0,28,3.399082569,0.041284404,0.041284404,99080.43119,44.09174312,0.174311927,99984.91284,0.990961812,0.000441702,2.55742E-06,0,0.018481848,32,23
D:0| T0: 0.17| T1: 40.00| R0: 0.0| R1: 0.0| WTP: 0,0,0.173076923,40,0,0,0,0,0,-1667325705,524899953,30.17289825,1665817060,166581706,1,480,28,5,5,0,5,480,0,5,1.458333333,0,0,99673.375,14.23958333,0.026041667,99996.66146,0.996772967,0.00014389,5.18145E-07,0,0.010438413,28,19
D:0| T0: 0.17| T1: 40.00| R0: 0.0| R1: 0.0| WTP: 0,0,0.173076923,40,0,0,0,0,0,-1868528488,1338977757,12660.58602,1235499187,123549918.7,1,98967,4419,403,2103,1700,403,98967,1700,2103,361.6623377,2.545454545,13.53896104,26152.23377,1689.824675,16.16233766,98549.27273,0.263361216,0.016945494,0.000163349,0.808368997,0.021249507,22,13
D:0| T0: 0.17| T1: 40.00| R0: 0.0| R1: 0.0| WTP: 0,0,0.173076923,40,0,0,0,0,0,-2171611986,341384587,10377.79317,1652722327,165272232.7,1,78975,3373,518,1724,1206,518,78975,1206,1724,230.9679144,2.695187166,9.096256684,43613.90909,1431.032086,11.86631016,98861.60428,0.439601863,0.01434678,0.000120265,0.699535963,0.021829693,27,18
D:0| T0: 0.17| T1: 40.00| R0: 0.0| R1: 0.0| WTP: 0,0,0.173076923,40,0,0,0,0,0,-4176324402,2032000160,11732.03045,3589722879,358972287.9,2,89148,3900,1252,1949,697,1252,89148,697,1949,82.25649913,2.017331023,3.204506066,66882.62218,1038.608319,5.362218371,99310.43154,0.671085129,0.01047078,5.58966E-05,0.357802875,0.021851303,83,40
D:0| T0: 0.17| T1: 40.00| R0: 0.0| R1: 0.0| WTP: 0,0,0.173076923,40,0,0,0,0,0,-2311998142,779488939,9722.511255,1825872580,182587258,1,76020,3316,566,1615,1049,566,76020,1049,1615,207.7821782,2.683168317,7.811881188,47341.05446,1430.034653,10.63861386,98974.18812,0.47678371,0.014336003,0.000108321,0.649535604,0.021244409,29,20
D:0| T0: 0.17| T1: 40.00| R0: 0.0| R1: 0.0| WTP: 0,0,0.173076923,40,0,0,0,0,0,-2403071716,1449019578,643.9927093,2370872080,237087208,1,4312,177,107,107,0,107,4312,0,107,9.519379845,0.290697674,0.290697674,97104.62791,105.1395349,0.724806202,99933.52326,0.971714509,0.001050298,8.26683E-06,0,0.024825986,36,27
D:0| T0: 0.17| T1: 40.00| R0: 0.0| R1: 0.0| WTP: 0,0,0.173076923,40,0,0,0,0,0,-1231066491,351952211,66.26538164,1227753222,122775322.2,1,521,28,11,11,0,11,521,0,11,2.541935484,0.006451613,0.006451613,99682.72903,14.9483871,0.096774194,99994.78065,0.996884685,0.000151096,1.41033E-06,0,0.021113244,23,14
D:0| T0: 0.17| T1: 40.00| R0: 0.0| R1: 0.0| WTP: 0,0,0.173076923,40,0,0,0,0,0,-1493321373,486595046,60.13217012,1490314765,149031476.5,1,385,16,10,10,0,10,385,0,10,0.798969072,0,0,99792.07732,15.70103093,0.051546392,99995.45876,0.997968414,0.000158418,1.02569E-06,0,0.026041667,26,17
D:0| T0: 0.17| T1: 40.00| R0: 0.0| R1: 0.0| WTP: 0,0,0.173076923,40,0,0,0,0,0,-2037782249,296745624,4954.595422,1790052477,179005247.7,1,39226,1736,481,823,342,481,39226,342,823,107.213198,2.294416244,4.005076142,73475.38579,975.6294416,6.446700508,99485.8731,0.738318974,0.00974749,6.6131E-05,0.415552855,0.020980982,29,20
D:0| T0: 0.17| T1: 40.00| R0: 0.0| R1: 0.0| WTP: 0,0,0.173076923,40,0,0,0,0,0,-1689278952,1671484194,409.4919052,1668804357,166880435.7,1,3384,161,68,68,0,68,3384,0,68,10.31606218,0.243523316,0.243523316,97859.04145,89.84974093,0.606217617,99960.7772,0.978995441,0.000896637,7.0126E-06,0,0.020106446,28,19
D:0| T0: 0.17| T1: 40.00| R0: 0.0| R1: 0.0| WTP: 0,0,0.173076923,40,0,0,0,0,0,-2177830809,422157396,11879.18551,1583871533,158387153.3,1,98334,4369,476,1973,1497,476,98334,1497,1973,303.9050279,2.592178771,10.92178771,26113.46927,2049.960894,13.58100559,98631.15642,0.262861855,0.020571472,0.000137384,0.758743031,0.020064271,26,17
D:0| T0: 0.17| T1: 40.00| R0: 0.0| R1: 0.0| WTP: 0,0,0.173076923,40,0,0,0,0,0,-1963423376,1916599091,12816.58979,1322593886,132259388.6,1,98431,4258,447,2129,1682,447,98431,1682,2129,350.1329114,2.753164557,13.34810127,27640.51899,2168.949367,16.1835443,98569.12025,0.278220405,0.021755487,0.000163717,0.790042273,0.021629365,23,14
D:0| T0: 0.17| T1: 40.00| R0: 0.0| R1: 0.0| WTP: 0,0,0.173076923,40,0,0,0,0,0,-1846254200,1005953941,12216.23243,1235442578,123544257.8,1,98342,4312,495,2029,1534,495,98342,1534,2029,368.8013245,3.225165563,13.32450331,30384.56954,2637.046358,16.58940397,98711.46358,0.305556772,0.026435801,0.000167715,0.756037457,0.02063208,22,13
D:0| T0: 0.17| T1: 40.00| R0: 0.0| R1: 0.0| WTP: 0,0,0.173076923,40,0,0,0,0,0,-1922051942,1422765615,12241.99292,1309952296,130995229.6,1,88872,3789,548,2034,1486,548,88872,1486,2034,297.05,3.31875,12.5375,40028.55,1926.55,16.00625,98767.19375,0.402835345,0.019329845,0.000161992,0.730580138,0.022886849,23,14
D:0| T0: 0.17| T1: 40.00| R0: 0.0| R1: 0.0| WTP: 0,0,0.173076923,40,0,0,0,0,0,-1141173493,699740192,30.09482132,1139668752,113966875.2,1,339,16,5,5,0,5,339,0,5,0.805194805,0.012987013,0.012987013,99795.20779,13.00649351,0.045454545,99997.74026,0.997978703,0.000131615,6.45172E-07,0,0.014749263,22,13
D:0| T0: 0.17| T1: 40.00| R0: 0.0| R1: 0.0| WTP: 0,0,0.173076923,40,0,0,0,0,0,-877077009.2,240885764,6.0931291,876772352.8,87677235.28,1,99,9,1,1,0,1,99,0,1,1.3046875,0,0,99939.54688,3.9609375,0.0078125,99999.63281,0.999401857,4.1628E-05,1.55039E-07,0,0.01010101,19,10
D:0| T0: 0.17| T1: 40.00| R0: 0.0| R1: 0.0| WTP: 0,0,0.173076923,40,0,0,0,0,0,-1751226524,2023806564,7473.239389,1377564554,137756455.4,1,64820,2923,579,1241,662,579,64820,662,1241,217.0898204,3.335329341,7.251497006,57969.91018,1628.628743,10.71856287,99283.88024,0.582960091,0.016284955,0.000109006,0.533440774,0.019145326,24,15
D:0| T0: 0.17| T1: 40.00| R0: 0.0| R1: 0.0| WTP: 0,0,0.173076923,40,0,0,0,0,0,-1409573787,1907493879,132.2933622,1402959119,140295911.9,1,938,34,22,22,0,22,938,0,22,1.761363636,0.051136364,0.051136364,99451.4375,32.5625,0.176136364,99987.76705,0.994641665,0.000326367,2.48613E-06,0,0.023454158,25,16
D:0| T0: 0.17| T1: 40.00| R0: 0.0| R1: 0.0| WTP: 0,0,0.173076923,40,0,0,0,0,0,-4194818256,1565815291,12116.15766,3589010373,358901037.3,2,90024,3853,1305,2013,708,1305,90024,708,2013,84.2010772,2.166965889,3.414721724,65892.7684,1304.994614,5.746858169,99292.86176,0.661090533,0.013157781,6.00353E-05,0.35171386,0.022360704,80,40
D:0| T0: 0.17| T1: 40.00| R0: 0.0| R1: 0.0| WTP: 0,0,0.173076923,40,0,0,0,0,0,-1772682733,784442364,343.1211169,1755526677,175552667.7,1,2611,121,57,57,0,57,2611,0,57,7.09223301,0.145631068,0.145631068,98276.67476,65.99029126,0.412621359,99967.82039,0.983102311,0.000659235,5.50875E-06,0,0.021830716,29,20
D:0| T0: 0.17| T1: 40.00| R0: 0.0| R1: 0.0| WTP: 0,0,0.173076923,40,0,0,0,0,0,-2026022510,206369745,9224.662745,1564789373,156478937.3,1,76953,3443,550,1532,982,550,76953,982,1532,238.8176796,2.928176796,8.303867403,48480.9116,1774.883978,11.3480663,99067.62431,0.487857087,0.017778876,0.00011528,0.640992167,0.019908256,26,17
D:0| T0: 0.17| T1: 40.00| R0: 0.0| R1: 0.0| WTP: 0,0,0.173076923,40,0,0,0,0,0,-2169931348,2087235992,11811.70151,1579346272,157934627.2,1,94449,4081,555,1962,1407,555,94449,1407,1962,284.9779006,2.983425414,10.68508287,32573.52486,2271.955801,13.75138122,98736.20994,0.327710743,0.022793562,0.00013965,0.717125382,0.020773116,26,17
D:0| T0: 0.17| T1: 40.00| R0: 0.0| R1: 0.0| WTP: 0,0,0.173076923,40,0,0,0,0,0,-2413545917,1019092536,795.0901621,2373791409,237379140.9,1,7491,319,132,132,0,132,7491,0,132,16.7983871,0.435483871,0.435483871,94738.0121,168.4798387,0.935483871,99912.95161,0.948251484,0.001681734,1.06092E-05,0,0.017621145,36,27
D:0| T0: 0.17| T1: 40.00| R0: 0.0| R1: 0.0| WTP: 0,0,0.173076923,40,0,0,0,0,0,-3156727701,1885906113,3088.117528,3002321825,300232182.5,1,24403,1024,458,513,55,458,24403,55,513,41.84228188,1.432885906,1.610738255,81610.28859,249.2718121,3.134228188,99629.61745,0.819159924,0.002492919,3.25573E-05,0.107212476,0.021022867,43,34
D:0| T0: 0.17| T1: 40.00| R0: 0.0| R1: 0.0| WTP: 0,0,0.173076923,40,0,0,0,0,0,-1475893206,2028637200,1264.513638,1412667524,141266752.4,1,11082,498,207,210,3,207,11082,3,210,33.42528736,1.051724138,1.063218391,92742.43678,248.8793103,2.229885057,99875.66667,0.928634903,0.002479365,2.38523E-05,0.014285714,0.018951358,25,16
D:0| T0: 0.17| T1: 40.00| R0: 0.0| R1: 0.0| WTP: 0,0,0.173076923,40,0,0,0,0,0,-2193661260,181476086,10709.8204,1658170240,165817024,1,86739,3824,537,1779,1242,537,86739,1242,1779,249.2956989,2.806451613,9.424731183,39414.52688,2185.919355,12.32258065,98865.46237,0.396737754,0.021924178,0.000124957,0.698145025,0.020509805,27,18
D:0| T0: 0.17| T1: 40.00| R0: 0.0| R1: 0.0| WTP: 0,0,0.173076923,40,0,0,0,0,0,-2203342319,2097578470,10842.9697,1661193834,166119383.4,1,85558,3814,584,1801,1217,584,85558,1217,1801,259.1290323,3.059139785,9.548387097,40090.06452,2490.709677,12.67204301,98856.64516,0.403672229,0.024981195,0.000128687,0.675735702,0.021050048,27,18
D:0| T0: 0.17| T1: 40.00| R0: 0.0| R1: 0.0| WTP: 0,0,0.173076923,40,0,0,0,0,0,-4189382962,119646392,12049.3458,3586915672,358691567.2,2,86736,3751,1103,2002,899,1103,86736,899,2002,81.00176678,1.800353357,3.355123675,74256.52827,969,5.319787986,99450.70495,0.743930227,0.009770295,5.52991E-05,0.449050949,0.023081801,81,40
D:0| T0: 0.17| T1: 40.00| R0: 0.0| R1: 0.0| WTP: 0,0,0.173076923,40,0,0,0,0,0,-1822268896,1298895859,11824.44223,1231046784,123104678.4,1,95331,4196,512,1964,1452,512,95331,1452,1964,353.56,3.333333333,12.93333333,35246.99333,2644.933333,16.35333333,98804.68,0.354356787,0.026513078,0.000165562,0.739307536,0.020601903,22,13
D:0| T0: 0.17| T1: 40.00| R0: 0.0| R1: 0.0| WTP: 0,0,0.173076923,40,0,0,0,0,0,-2537887848,1489316290,10625.0589,2006634903,200663490.3,1,82534,3668,529,1765,1236,529,82534,1236,1765,211.7887324,2.403755869,8.154929577,38400.00469,1348.258216,10.63849765,98764.79343,0.387276667,0.013528474,0.000108127,0.700283286,0.021385126,31,22
D:0| T0: 0.17| T1: 40.00| R0: 0.0| R1: 0.0| WTP: 0,0,0.173076923,40,0,0,0,0,0,-2717563507,855602142,14009.49354,2017088830,201708883,1,96194,3955,472,2328,1856,472,96194,1856,2328,236.6604651,2.153488372,10.74883721,26336.70233,1594.795349,12.94418605,98322.34419,0.265324005,0.016043383,0.000131127,0.797250859,0.024201094,31,22
D:0| T0: 0.17| T1: 40.00| R0: 0.0| R1: 0.0| WTP: 0,0,0.173076923,40,0,0,0,0,0,-2290824425,1438649896,3304.247164,2125612066,212561206.6,1,24979,1036,479,549,70,479,24979,70,549,52.61373391,1.922746781,2.210300429,83049.94421,545.1287554,4.244635193,99662.40773,0.833268084,0.005443653,4.40512E-05,0.127504554,0.021978462,33,24
D:0| T0: 0.17| T1: 40.00| R0: 0.0| R1: 0.0| WTP: 0,0,0.173076923,40,0,0,0,0,0,-1667490841,952489126,36.13731856,1665683975,166568397.5,1,393,13,6,6,0,6,393,0,6,1.036458333,0.005208333,0.005208333,99749.71354,16.3125,0.03125,99997.29688,0.997528192,0.000164252,6.21777E-07,0,0.015267176,28,19
D:0| T0: 0.17| T1: 40.00| R0: 0.0| R1: 0.0| WTP: 0,0,0.173076923,40,0,0,0,0,0,-1687488373,1550779155,12652.83926,1054846410,105484641,1,99140,4210,405,2102,1697,405,99140,1697,2102,388.0444444,2.925925926,15.45185185,25772.78519,2053.718519,18.45185185,98562.6,0.259796048,0.020577355,0.00018625,0.807326356,0.02120234,20,11
D:0| T0: 0.17| T1: 40.00| R0: 0.0| R1: 0.0| WTP: 0,0,0.173076923,40,0,0,0,0,0,-1584538183,607323321,120.3671534,1578519826,157851982.6,1,958,46,20,20,0,20,958,0,20,2.515957447,0.042553191,0.042553191,99350.77128,24.48404255,0.138297872,99988.26596,0.993634788,0.000245896,2.1166E-06,0,0.019832985,27,18
D:0| T0: 0.17| T1: 40.00| R0: 0.0| R1: 0.0| WTP: 0,0,0.173076923,40,0,0,0,0,0,-1763967924,2103646485,6320.595797,1447938134,144793813.4,1,48476,2088,518,1050,532,518,48476,532,1050,152.8176471,2.923529412,6.017647059,68788.1,861.6882353,9.047058824,99382.15294,0.691607142,0.008609496,9.21735E-05,0.506666667,0.021660203,25,16
D:0| T0: 0.17| T1: 40.00| R0: 0.0| R1: 0.0| WTP: 0,0,0.173076923,40,0,0,0,0,0,-1967351175,258120157,11146.97866,1410002242,141000224.2,1,97711,4438,441,1851,1410,441,97711,1410,1851,336.3151515,2.6,11.09090909,25085.55152,1505.909091,13.77575758,98682.07273,0.25287235,0.015096437,0.000139335,0.761750405,0.018943619,24,15
D:0| T0: 0.17| T1: 40.00| R0: 0.0| R1: 0.0| WTP: 0,0,0.173076923,40,0,0,0,0,0,-1881549754,1068951401,674.9467064,1847802418,184780241.8,1,6848,326,112,112,0,112,6848,0,112,19.8708134,0.435406699,0.435406699,95174.23445,127.6172249,0.976076555,99927.33971,0.952488261,0.001272629,1.06723E-05,0,0.01635514,30,21
D:0| T0: 0.17| T1: 40.00| R0: 0.0| R1: 0.0| WTP: 0,0,0.173076923,40,0,0,0,0,0,-4149403754,635956235,11268.34799,3585986355,358598635.5,2,86169,3692,1041,1872,831,1041,86169,831,1872,72.65654952,1.563897764,2.869009585,74338.00319,1045.384984,4.533546326,99489.22364,0.744212614,0.0105336,4.68951E-05,0.443910256,0.02172475,89,40
D:0| T0: 0.17| T1: 40.00| R0: 0.0| R1: 0.0| WTP: 0,0,0.173076923,40,0,0,0,0,0,-1056481164,1346693470,78.31500247,1052565414,105256541.4,1,830,35,13,13,0,13,830,0,13,3.167832168,0.034965035,0.034965035,99510.42657,29.68531469,0.104895105,99993.27972,0.995177696,0.00029731,1.80566E-06,0,0.015662651,21,12
D:0| T0: 0.17| T1: 40.00| R0: 0.0| R1: 0.0| WTP: 0,0,0.173076923,40,0,0,0,0,0,-2053644038,847102011,12959.21789,1405683144,140568314.4,1,98233,4205,472,2153,1681,472,98233,1681,2153,319.4573171,2.817073171,13,28185.04878,2044.310976,15.8597561,98563.80488,0.283633893,0.020520756,0.000160784,0.780771017,0.021917278,24,15
D:0| T0: 0.17| T1: 40.00| R0: 0.0| R1: 0.0| WTP: 0,0,0.173076923,40,0,0,0,0,0,-4184255831,812083272,11965.27456,3585992103,358599210.3,2,86366,3519,1818,1988,170,1818,86366,170,1988,73.47116969,2.784184514,3.054365733,53735.08072,869.0741351,6.082372323,98966.22241,0.541314527,0.008766123,6.3218E-05,0.085513078,0.02301885,87,40
D:0| T0: 0.17| T1: 40.00| R0: 0.0| R1: 0.0| WTP: 0,0,0.173076923,40,0,0,0,0,0,-2173799732,2146825809,11771.51154,1585224155,158522415.5,1,98874,4500,465,1955,1490,465,98874,1490,1955,310.3202247,2.556179775,10.8988764,22618.65169,1755.179775,13.51123596,98579.26404,0.228024452,0.017605376,0.000136496,0.762148338,0.01977264,26,17
D:0| T0: 0.17| T1: 40.00| R0: 0.0| R1: 0.0| WTP: 0,0,0.173076923,40,0,0,0,0,0,-2049126291,226186520,12851.40519,1406556032,140655603.2,1,97214,4231,468,2135,1667,468,97214,1667,2135,315.2619048,2.726190476,12.57738095,29346.85714,1687.755952,15.35714286,98566.32143,0.29534006,0.016944885,0.00015565,0.780796253,0.021961857,24,15
D:0| T0: 0.17| T1: 40.00| R0: 0.0| R1: 0.0| WTP: 0,0,0.173076923,40,0,0,0,0,0,-4196795467,1110225441,12046.08878,3594491028,359449102.8,2,89242,3937,1757,2001,244,1757,89242,244,2001,83.59731544,2.768456376,3.16442953,56456.21812,1151.875839,6.098993289,99077.88087,0.56753136,0.011616302,6.35646E-05,0.12193903,0.022422178,86,40
D:0| T0: 0.17| T1: 40.00| R0: 0.0| R1: 0.0| WTP: 0,0,0.173076923,40,0,0,0,0,0,-2799752948,1190767082,2908.788215,2654313537,265431353.7,1,26849,1155,465,483,18,465,26849,18,483,51.7032967,1.553113553,1.608058608,80675.79121,528.6410256,3.318681319,99676.7033,0.809389278,0.00528117,3.46811E-05,0.037267081,0.017989497,39,30
D:0| T0: 0.17| T1: 40.00| R0: 0.0| R1: 0.0| WTP: 0,0,0.173076923,40,0,0,0,0,0,-2049038391,2108234095,589.7016078,2019553310,201955331,1,3816,156,98,98,0,98,3816,0,98,9.366972477,0.28440367,0.28440367,97486.00917,107.4311927,0.747706422,99940.77523,0.975460291,0.001072089,8.95402E-06,0,0.025681342,32,23
D:0| T0: 0.17| T1: 40.00| R0: 0.0| R1: 0.0| WTP: 0,0,0.173076923,40,0,0,0,0,0,-2062506633,465621985,13044.7896,1410267153,141026715.3,1,98735,4381,480,2167,1687,480,98735,1687,2167,334.5272727,2.83030303,13.01212121,26112.41818,2058.369697,15.90909091,98516.55758,0.262930085,0.020662792,0.000161171,0.778495616,0.021947638,24,15
D:0| T0: 0.17| T1: 40.00| R0: 0.0| R1: 0.0| WTP: 0,0,0.173076923,40,0,0,0,0,0,-1470907198,1487072553,1168.372375,1412488579,141248857.9,1,11183,472,192,194,2,192,11183,2,194,33.1849711,1,1.011560694,93079.32948,235.1213873,2.115606936,99890.27746,0.931853345,0.00234256,2.22045E-05,0.010309278,0.017350863,25,16
D:0| T0: 0.17| T1: 40.00| R0: 0.0| R1: 0.0| WTP: 0,0,0.173076923,40,0,0,0,0,0,-2731172781,1213733847,4875.330653,2487406248,248740624.8,1,37564,1534,620,810,190,620,37564,190,810,73.66798419,2.304347826,3.015810277,73460.26087,625.9367589,5.466403162,99463.34783,0.738383356,0.006261691,5.65317E-05,0.234567901,0.021563199,37,28
D:0| T0: 0.17| T1: 40.00| R0: 0.0| R1: 0.0| WTP: 0,0,0.173076923,40,0,0,0,0,0,-2702535570,2003658337,5922.419548,2406414593,240641459.3,1,44748,1879,596,984,388,596,44748,388,984,90.98785425,2.311740891,3.862348178,67670.89474,734.1012146,6.271255061,99330.82591,0.680937101,0.007347291,6.40309E-05,0.394308943,0.02198981,36,27
D:0| T0: 0.17| T1: 40.00| R0: 0.0| R1: 0.0| WTP: 0,0,0.173076923,40,0,0,0,0,0,-1056628393,1170868072,84.26888432,1052414949,105241494.9,1,737,34,14,14,0,14,737,0,14,2.5,0.027777778,0.027777778,99553.38889,29.02777778,0.111111111,99993.40972,0.995606114,0.000290569,1.93116E-06,0,0.018995929,21,12
D:0| T0: 0.17| T1: 40.00| R0: 0.0| R1: 0.0| WTP: 0,0,0.173076923,40,0,0,0,0,0,-2356850640,569919592,11915.80294,1761060493,176106049.3,1,99253,4499,426,1979,1553,426,99253,1553,1979,291.0471204,2.178010471,10.28272251,19861.66492,1353.65445,12.51308901,98501.8377,0.200403918,0.013586368,0.000126488,0.784739768,0.019938944,28,19
D:0| T0: 0.17| T1: 40.00| R0: 0.0| R1: 0.0| WTP: 0,0,0.173076923,40,0,0,0,0,0,-2101805493,1833180623,4362.033463,1883703819,188370381.9,1,40935,1924,502,724,222,502,40935,222,724,121.7902439,2.292682927,3.336585366,71794.22927,925.3512195,5.795121951,99541.13171,0.721111564,0.009242055,5.97295E-05,0.306629834,0.017686576,30,21
D:0| T0: 0.17| T1: 40.00| R0: 0.0| R1: 0.0| WTP: 0,0,0.173076923,40,0,0,0,0,0,-2250428039,1123666637,13397.49232,1580553424,158055342.4,1,97045,4088,484,2226,1742,484,97045,1742,2226,292.4382022,2.646067416,12.37640449,26979.19101,1643.123596,15.08988764,98445.79213,0.271790086,0.016507599,0.000153066,0.782569632,0.022937812,26,17
D:0| T0: 0.17| T1: 40.00| R0: 0.0| R1: 0.0| WTP: 0,0,0.173076923,40,0,0,0,0,0,-2712613295,1682024981,9030.975062,2261064541,226106454.1,1,71675,3165,735,1500,765,735,71675,765,1500,166.8791667,2.966666667,6.091666667,50887.09167,2447.845833,9.158333333,99065.55417,0.512325812,0.024550112,9.34585E-05,0.51,0.020927799,34,25
D:0| T0: 0.17| T1: 40.00| R0: 0.0| R1: 0.0| WTP: 0,0,0.173076923,40,0,0,0,0,0,-3093503296,1687523543,1992.336254,2993886483,299388648.3,1,15603,650,331,331,0,331,15603,0,331,25.96632997,0.95959596,0.95959596,89222.13468,196.3131313,2.074074074,99784.98316,0.894166904,0.001961911,2.22508E-05,0,0.021215229,43,34
D:0| T0: 0.17| T1: 40.00| R0: 0.0| R1: 0.0| WTP: 0,0,0.173076923,40,0,0,0,0,0,-2098517827,178034412,12141.87123,1491424265,149142426.5,1,94595,4091,473,2017,1544,473,94595,1544,2017,302.4882353,2.705882353,11.71176471,32179.84706,1957.470588,14.5,98671.00588,0.323884412,0.01964123,0.000147066,0.765493307,0.02132248,25,16
D:0| T0: 0.17| T1: 40.00| R0: 0.0| R1: 0.0| WTP: 0,0,0.173076923,40,0,0,0,0,0,-1965558549,739490003,11252.80218,1402918440,140291844,1,93004,4063,472,1869,1397,472,93004,1397,1869,315.3580247,2.858024691,11.41358025,35432.75926,1602.95679,14.30864198,98812.0679,0.356447524,0.016067527,0.000144941,0.747458534,0.02009591,24,15
D:0| T0: 0.17| T1: 40.00| R0: 0.0| R1: 0.0| WTP: 0,0,0.173076923,40,0,0,0,0,0,-1973734689,178482706,8510.628926,1548203243,154820324.3,1,63172,2774,540,1414,874,540,63172,874,1414,187.3446328,2.95480226,7.836158192,57986.71186,1529.644068,10.87570621,99144.86441,0.58376196,0.01531079,0.000110547,0.618104668,0.022383334,26,17
D:0| T0: 0.17| T1: 40.00| R0: 0.0| R1: 0.0| WTP: 0,0,0.173076923,40,0,0,0,0,0,-2022576101,1919366370,3196.185014,1862766851,186276685.1,1,24018,1000,446,531,85,446,24018,85,531,59.85990338,2.033816425,2.429951691,84146.29469,401.7487923,4.599033816,99674.77295,0.844168403,0.004010565,4.70942E-05,0.16007533,0.022109339,30,21
D:0| T0: 0.17| T1: 40.00| R0: 0.0| R1: 0.0| WTP: 0,0,0.173076923,40,0,0,0,0,0,-1981487002,1819796913,11429.23864,1410025070,141002507,1,97451,4460,447,1898,1451,447,97451,1451,1898,331.8562874,2.622754491,11.25149701,29956.10778,2402.502994,13.91616766,98757.13174,0.301268217,0.024087167,0.000140892,0.764488936,0.019476455,24,15
D:0| T0: 0.17| T1: 40.00| R0: 0.0| R1: 0.0| WTP: 0,0,0.173076923,40,0,0,0,0,0,-4217092017,1866591913,12436.41897,3595271068,359527106.8,2,94697,4079,1147,2066,919,1147,94697,919,2066,93.20512821,1.923076923,3.578754579,67130.34066,1429.562271,5.6996337,99341.26374,0.672332787,0.014417542,5.93238E-05,0.44482091,0.021816953,78,40
D:0| T0: 0.17| T1: 40.00| R0: 0.0| R1: 0.0| WTP: 0,0,0.173076923,40,0,0,0,0,0,-1854053111,1219425989,12401.84865,1233960679,123396067.9,1,99237,4466,445,2060,1615,445,99237,1615,2060,367.2281879,2.899328859,13.69798658,25378.61074,1725.073826,16.67785235,98582.61074,0.255690659,0.017298075,0.000168699,0.783980583,0.020758386,22,13
D:0| T0: 0.17| T1: 40.00| R0: 0.0| R1: 0.0| WTP: 0,0,0.173076923,40,0,0,0,0,0,-2081001749,502409586,11734.42741,1494280379,149428037.9,1,97438,4267,475,1949,1474,475,97438,1474,1949,306.0287356,2.655172414,11.08045977,28094.3908,2257.413793,13.83333333,98682,0.282737,0.022643698,0.00013985,0.756285274,0.020002463,25,16
D:0| T0: 0.17| T1: 40.00| R0: 0.0| R1: 0.0| WTP: 0,0,0.173076923,40,0,0,0,0,0,-1956592972,1405887957,9608.669848,1476159480,147615948,1,76415,3438,512,1596,1084,512,76415,1084,1596,251.7869822,2.940828402,9.313609467,49101.85207,1371.710059,12.32544379,99030.04142,0.494238164,0.013737337,0.000124981,0.679197995,0.020885952,25,16
D:0| T0: 0.17| T1: 40.00| R0: 0.0| R1: 0.0| WTP: 0,0,0.173076923,40,0,0,0,0,0,-2094420002,283033753,12288.32318,1480003843,148000384.3,1,87277,3583,531,2042,1511,531,87277,1511,2042,255.9884393,2.994219653,11.67052023,38554.0578,1341.491329,14.74566474,98675.24855,0.388482073,0.013467474,0.000149366,0.739960823,0.023396771,25,16
D:0| T0: 0.17| T1: 40.00| R0: 0.0| R1: 0.0| WTP: 0,0,0.173076923,40,0,0,0,0,0,-2442906241,1083157068,5947.128611,2145549811,214554981.1,1,44084,1891,611,988,377,611,44084,377,988,104.8193833,2.528634361,4.158590308,68445.04405,986.5770925,6.889867841,99350.94714,0.688615203,0.009869687,7.0484E-05,0.381578947,0.022411759,33,24
D:0| T0: 0.17| T1: 40.00| R0: 0.0| R1: 0.0| WTP: 0,0,0.173076923,40,0,0,0,0,0,-2195326163,1988704626,3189.468904,2035852718,203585271.8,1,21682,887,470,530,60,470,21682,60,530,49.40358744,1.97309417,2.228699552,85041.75785,249.4080717,4.340807175,99658.37668,0.853324847,0.002491796,4.47597E-05,0.113207547,0.02444875,32,23
D:0| T0: 0.17| T1: 40.00| R0: 0.0| R1: 0.0| WTP: 0,0,0.173076923,40,0,0,0,0,0,-1782919123,884761309,12743.97338,1145720455,114572045.5,1,99069,4387,436,2117,1681,436,99069,1681,2117,369.3673469,2.911564626,14.29251701,24302.81633,1752.081633,17.2585034,98511.2381,0.245066138,0.017571463,0.00017431,0.794048181,0.021368945,21,12
D:0| T0: 0.17| T1: 40.00| R0: 0.0| R1: 0.0| WTP: 0,0,0.173076923,40,0,0,0,0,0,-1357033682,533485933,716.7577695,1321195794,132119579.4,1,6560,306,119,119,0,119,6560,0,119,22.79012346,0.617283951,0.617283951,95949.82099,110.5246914,1.351851852,99933.99383,0.960166,0.001101319,1.46094E-05,0,0.018140244,24,15
D:0| T0: 0.17| T1: 40.00| R0: 0.0| R1: 0.0| WTP: 0,0,0.173076923,40,0,0,0,0,0,-1541710028,632196071,897.0507331,1496857491,149685749.1,1,7021,309,148,149,1,148,7021,1,149,21.58988764,0.724719101,0.730337079,95478.35393,102.4719101,1.584269663,99911.10674,0.955671149,0.001022034,1.66039E-05,0.006711409,0.021222048,26,17
D:0| T0: 0.17| T1: 40.00| R0: 0.0| R1: 0.0| WTP: 0,0,0.173076923,40,0,0,0,0,0,-2132995666,393400457,12797.00807,1493145262,149314526.2,1,96342,4175,447,2126,1679,447,96342,1679,2126,304.3430233,2.540697674,12.26162791,30650.72093,1753.767442,14.8372093,98579.56395,0.30840584,0.017605094,0.000150281,0.789746002,0.022067219,25,16
D:0| T0: 0.17| T1: 40.00| R0: 0.0| R1: 0.0| WTP: 0,0,0.173076923,40,0,0,0,0,0,-1929437168,398973227,10756.71502,1391601417,139160141.7,1,82399,3546,541,1787,1246,541,82399,1246,1787,262.9107143,3.136904762,10.48809524,44001.22024,1467.214286,13.69642857,98895.46429,0.443037157,0.014703408,0.000138964,0.697257974,0.021687156,24,15
D:0| T0: 0.17| T1: 40.00| R0: 0.0| R1: 0.0| WTP: 0,0,0.173076923,40,0,0,0,0,0,-4136671401,1402256491,11010.4219,3586150305,358615030.5,2,84895,3682,1714,1829,115,1714,84895,115,1829,63.45056497,2.278248588,2.427966102,51118.21893,760.8333333,4.854519774,98988.41384,0.515119875,0.007668592,5.04283E-05,0.062875888,0.021544261,102,40
D:0| T0: 0.17| T1: 40.00| R0: 0.0| R1: 0.0| WTP: 0,0,0.173076923,40,0,0,0,0,0,-2499058230,2102527413,9944.961666,2001810146,200181014.6,1,75044,3333,654,1652,998,654,75044,998,1652,199.9952607,3,7.696682464,47394.36019,2057.260664,10.81042654,98944.08531,0.4775157,0.020634822,0.00010969,0.604116223,0.022013752,31,22
D:0| T0: 0.17| T1: 40.00| R0: 0.0| R1: 0.0| WTP: 0,0,0.173076923,40,0,0,0,0,0,-2223863970,1748031099,11322.31507,1657748216,165774821.6,1,84820,3584,627,1881,1254,627,84820,1254,1881,249.6793478,3.331521739,10.09782609,42318.53804,2486.804348,13.48369565,98840.16304,0.42603791,0.024958767,0.000136848,0.666666667,0.022176373,27,18
D:0| T0: 0.17| T1: 40.00| R0: 0.0| R1: 0.0| WTP: 0,0,0.173076923,40,0,0,0,0,0,-2430745683,1946754629,1125.618252,2374464770,237446477,1,8598,349,187,187,0,187,8598,0,187,18.12195122,0.62601626,0.62601626,93951.59756,134.6626016,1.398373984,99876.96341,0.940719103,0.001344662,1.51554E-05,0,0.021749244,36,27
D:0| T0: 0.17| T1: 40.00| R0: 0.0| R1: 0.0| WTP: 0,0,0.173076923,40,0,0,0,0,0,-2053296278,2097712204,2149.705652,1945810995,194581099.5,1,17589,805,348,357,9,348,17589,9,357,45.97222222,1.444444444,1.49537037,88200.31481,251.962963,3.111111111,99778.14815,0.883997055,0.002514567,3.25451E-05,0.025210084,0.020296776,31,22
D:0| T0: 0.17| T1: 40.00| R0: 0.0| R1: 0.0| WTP: 0,0,0.173076923,40,0,0,0,0,0,-4141141852,1198827119,11123.85383,3584949160,358494916,2,84358,3629,934,1848,914,934,84358,914,1848,71.28843106,1.404120444,2.828843106,76708.33122,853.3011094,4.309033281,99528.76704,0.767824309,0.00859752,4.44241E-05,0.494588745,0.021906636,91,40
D:0| T0: 0.17| T1: 40.00| R0: 0.0| R1: 0.0| WTP: 0,0,0.173076923,40,0,0,0,0,0,-1404184043,109253198,30.1143433,1402678326,140267832.6,1,294,12,5,5,0,5,294,0,5,0.91160221,0.005524862,0.005524862,99818.67956,11.40331492,0.027624309,99997,0.998220311,0.000115882,5.49461E-07,0,0.017064846,25,16
D:0| T0: 0.17| T1: 40.00| R0: 0.0| R1: 0.0| WTP: 0,0,0.173076923,40,0,0,0,0,0,-1438170899,314481292,614.2164209,1407460078,140746007.8,1,4927,215,102,102,0,102,4927,0,102,17.11242604,0.49704142,0.49704142,96855.05917,87.1183432,1.100591716,99941.61538,0.969148319,0.000868848,1.20058E-05,0,0.020702253,25,16
D:0| T0: 0.17| T1: 44.00| R0: 0.0| R1: 0.0| WTP: 0,0,0.173076923,44,0,0,0,0,0,-1491858231,1178568022,30.12067847,1490352197,149035219.7,1,312,15,5,5,0,5,312,0,5,0.978378378,0,0,99803.43784,8.740540541,0.027027027,99996.95676,0.998068409,8.91422E-05,5.37645E-07,0,0.01607717,26,17
D:0| T0: 0.17| T1: 44.00| R0: 0.0| R1: 0.0| WTP: 0,0,0.173076923,44,0,0,0,0,0,-1906711473,2029998696,11746.56513,1319383216,131938321.6,1,95757,4310,471,1951,1480,471,95757,1480,1951,338.5,2.917721519,12.23417722,34133.97468,2047.259494,15.20253165,98787.36076,0.343134047,0.020521127,0.000153792,0.758585341,0.02037449,23,14
D:0| T0: 0.17| T1: 44.00| R0: 0.0| R1: 0.0| WTP: 0,0,0.173076923,44,0,0,0,0,0,-2792176117,776062361,10592.82938,2262534648,226253464.8,1,78227,3339,743,1760,1017,743,78227,1017,1760,168.219917,2.987551867,7.157676349,45972.9751,2014.377593,10.2406639,98885.53527,0.463070186,0.020230734,0.00010437,0.577840909,0.022498626,34,25
D:0| T0: 0.17| T1: 44.00| R0: 0.0| R1: 0.0| WTP: 0,0,0.173076923,44,0,0,0,0,0,-1494647557,1813046880,78.28705192,1490733204,149073320.4,1,566,31,13,13,0,13,566,0,13,2.232044199,0.022099448,0.022099448,99628.38674,18.9558011,0.093922652,99992.45856,0.996365391,0.000191001,1.42865E-06,0,0.022968198,26,17
D:0| T0: 0.17| T1: 44.00| R0: 0.0| R1: 0.0| WTP: 0,0,0.173076923,44,0,0,0,0,0,-1432585441,2032407216,2029.219858,1331124449,133112444.9,1,17270,787,311,337,26,311,17270,26,337,56.13333333,1.757575758,1.903030303,89330.33939,364.8,3.793939394,99814.11515,0.894983692,0.003633692,3.90999E-05,0.077151335,0.019513607,24,15
D:0| T0: 0.17| T1: 44.00| R0: 0.0| R1: 0.0| WTP: 0,0,0.173076923,44,0,0,0,0,0,-789830023.7,1507873352,18.03885983,788928080.7,78892808.07,1,53,5,3,3,0,3,53,0,3,0.346153846,0,0,99969.92308,3.353846154,0.023076923,99999.23846,0.999708164,3.52674E-05,4.5802E-07,0,0.056603774,18,9
D:0| T0: 0.17| T1: 44.00| R0: 0.0| R1: 0.0| WTP: 0,0,0.173076923,44,0,0,0,0,0,-968754026.9,1855899401,78.28915632,964839569,96483956.9,1,825,38,13,13,0,13,825,0,13,2.927536232,0.036231884,0.036231884,99516.06522,21.85507246,0.115942029,99992.72464,0.995239322,0.000219585,1.87061E-06,0,0.015757576,20,11
D:0| T0: 0.17| T1: 44.00| R0: 0.0| R1: 0.0| WTP: 0,0,0.173076923,44,0,0,0,0,0,-2279444171,1819459251,7663.077644,1896290289,189629028.9,1,60030,2612,568,1273,705,568,60030,705,1273,154.3495146,2.669902913,6.04368932,58086.92233,1047.548544,8.82038835,99174.00971,0.584913616,0.010488404,8.9509E-05,0.553809898,0.021206064,30,21
D:0| T0: 0.17| T1: 44.00| R0: 0.0| R1: 0.0| WTP: 0,0,0.173076923,44,0,0,0,0,0,-879717430.9,909791748,48.30141192,877302360.3,87730236.03,1,712,35,8,8,0,8,712,0,8,3.715384615,0.023076923,0.023076923,99597.11538,18.2,0.092307692,99996.43846,0.996011817,0.000183516,1.22141E-06,0,0.011235955,19,10
D:0| T0: 0.17| T1: 44.00| R0: 0.0| R1: 0.0| WTP: 0,0,0.173076923,44,0,0,0,0,0,-2768908769,1339092841,5566.990827,2490559227,249055922.7,1,38479,1611,616,925,309,616,38479,309,925,79.49027237,2.284046693,3.455252918,72084.45136,538.9610895,5.859922179,99363.0856,0.725226854,0.005394489,6.00101E-05,0.334054054,0.024039711,37,28
D:0| T0: 0.17| T1: 44.00| R0: 0.0| R1: 0.0| WTP: 0,0,0.173076923,44,0,0,0,0,0,-2030729947,1365866345,12461.40314,1407659790,140765979,1,97538,4342,473,2070,1597,473,97538,1597,2070,323.5361446,2.777108434,12.3313253,30129.07229,1838.403614,15.18674699,98646.18072,0.303029949,0.018449069,0.000153835,0.771497585,0.021222498,24,15
D:0| T0: 0.17| T1: 44.00| R0: 0.0| R1: 0.0| WTP: 0,0,0.173076923,44,0,0,0,0,0,-3654810209,825453433,4040.957975,3452762310,345276231,1,34920,1594,605,671,66,605,34920,66,671,58.54626866,1.650746269,1.83880597,73727.01791,531.0716418,3.662686567,99523.34925,0.740728272,0.005313382,3.81037E-05,0.098360656,0.019215349,48,39
D:0| T0: 0.17| T1: 44.00| R0: 0.0| R1: 0.0| WTP: 0,0,0.173076923,44,0,0,0,0,0,-1951386180,939711378,12599.97694,1321387333,132138733.3,1,97565,4337,449,2093,1644,449,97565,1644,2093,352.1225806,2.806451613,13.36129032,32566.96774,2472.883871,16.23870968,98693.54839,0.327314107,0.024802877,0.000164638,0.785475394,0.021452365,23,14
D:0| T0: 0.17| T1: 44.00| R0: 0.0| R1: 0.0| WTP: 0,0,0.173076923,44,0,0,0,0,0,-3260378681,638950699,1835.991689,3168579096,316857909.6,1,13634,617,305,305,0,305,13634,0,305,23.7275641,0.836538462,0.836538462,90128.5,273.8685897,1.814102564,99790.58333,0.903214974,0.00273645,1.95179E-05,0,0.022370544,45,36
D:0| T0: 0.17| T1: 44.00| R0: 0.0| R1: 0.0| WTP: 0,0,0.173076923,44,0,0,0,0,0,-1898766432,938699148,1005.479527,1848492455,184849245.5,1,7893,374,167,167,0,167,7893,0,167,21.25358852,0.669856459,0.669856459,94570.48804,126.861244,1.473684211,99894.5311,0.946752186,0.001265693,1.59175E-05,0,0.021157988,30,21
D:0| T0: 0.17| T1: 44.00| R0: 0.0| R1: 0.0| WTP: 0,0,0.173076923,44,0,0,0,0,0,-1841682443,121790188,18.05415653,1840779735,184077973.5,1,194,10,3,3,0,3,194,0,3,0.349056604,0,0,99886.26415,7.735849057,0.014150943,99998.73585,0.998877489,7.92026E-05,2.81693E-07,0,0.015463918,30,21
D:0| T0: 0.17| T1: 44.00| R0: 0.0| R1: 0.0| WTP: 0,0,0.173076923,44,0,0,0,0,0,-2726625721,1331335240,9325.005643,2260375439,226037543.9,1,73333,3203,757,1549,792,757,73333,792,1549,168.8675214,3.115384615,6.444444444,48747.92735,2061.089744,9.670940171,99013.54274,0.491023269,0.020674628,9.89128E-05,0.511297611,0.021122823,34,25
D:0| T0: 0.17| T1: 44.00| R0: 0.0| R1: 0.0| WTP: 0,0,0.173076923,44,0,0,0,0,0,-2163737738,470935411,13362.35035,1495620221,149562022.1,1,98775,4173,475,2220,1745,475,98775,1745,2220,312.5,2.697674419,12.81395349,24473.4186,1485.94186,15.54651163,98426.86628,0.246574405,0.014924275,0.000157498,0.786036036,0.022475323,25,16
D:0| T0: 0.17| T1: 44.00| R0: 0.0| R1: 0.0| WTP: 0,0,0.173076923,44,0,0,0,0,0,-3662653760,823434397,1215.788759,3601864323,360186432.3,1,9041,400,202,202,0,202,9041,0,202,13.21264368,0.471264368,0.471264368,93169.73851,131.9195402,1.054597701,99854.81609,0.933094389,0.001319084,1.15873E-05,0,0.022342661,50,41
D:0| T0: 0.17| T1: 44.00| R0: 0.0| R1: 0.0| WTP: 0,0,0.173076923,44,0,0,0,0,0,-1147243496,493045351,132.4932633,1140618833,114061883.3,1,1358,62,22,22,0,22,1358,0,22,4.570469799,0.073825503,0.073825503,99178.87919,23.2147651,0.228187919,99988.9396,0.991908714,0.000233087,2.93363E-06,0,0.016212233,22,13
D:0| T0: 0.17| T1: 44.00| R0: 0.0| R1: 0.0| WTP: 0,0,0.173076923,44,0,0,0,0,0,-4437996471,1700216563,9836.109716,3946190985,394619098.5,2,86902,4127,907,1633,726,907,86902,726,1633,86.10779436,1.373134328,2.550580431,75187.11774,777.4892206,4.058043118,99561.57048,0.752816403,0.007825113,4.23882E-05,0.444580527,0.018791282,87,44
D:0| T0: 0.17| T1: 44.00| R0: 0.0| R1: 0.0| WTP: 0,0,0.173076923,44,0,0,0,0,0,-1699750614,1744119059,3565.528496,1521474189,152147418.9,1,31573,1438,445,592,147,445,31573,147,592,99.06043956,2.307692308,3.093406593,79206.44505,480.7417582,5.543956044,99645.01648,0.794821436,0.004795986,5.68324E-05,0.248310811,0.018750198,26,17
D:0| T0: 0.17| T1: 44.00| R0: 0.0| R1: 0.0| WTP: 0,0,0.173076923,44,0,0,0,0,0,-2637402637,2036906360,138.4339748,2630480938,263048093.8,1,937,44,23,23,0,23,937,0,23,2.098540146,0.025547445,0.025547445,99364.10219,24.20437956,0.105839416,99985.16788,0.993795662,0.000243338,1.67291E-06,0,0.024546425,39,30
D:0| T0: 0.17| T1: 44.00| R0: 0.0| R1: 0.0| WTP: 0,0,0.173076923,44,0,0,0,0,0,-2984409255,809704121,1583.620931,2905228209,290522820.9,1,12835,557,263,263,0,263,12835,0,263,24.24252492,0.704318937,0.704318937,91370.31894,221.2724252,1.604651163,99831.9402,0.915263963,0.002210643,1.74397E-05,0,0.020490845,42,33
D:0| T0: 0.17| T1: 44.00| R0: 0.0| R1: 0.0| WTP: 0,0,0.173076923,44,0,0,0,0,0,-2784244625,1219866412,8689.013898,2349793930,234979393,1,72235,3207,716,1443,727,716,72235,727,1443,168.6735537,2.851239669,5.82231405,47027.10744,2452.42562,8.79338843,99033.02066,0.473864652,0.024589884,8.9506E-05,0.503811504,0.019976466,35,26
D:0| T0: 0.17| T1: 44.00| R0: 0.0| R1: 0.0| WTP: 0,0,0.173076923,44,0,0,0,0,0,-880548875.2,843498920,72.19973601,876938888.4,87693888.84,1,647,29,12,12,0,12,647,0,12,1.92481203,0.015037594,0.015037594,99623.25564,22.4887218,0.127819549,99993.54887,0.996302547,0.000225537,1.79114E-06,0,0.018547141,19,10
D:0| T0: 0.17| T1: 44.00| R0: 0.0| R1: 0.0| WTP: 0,0,0.173076923,44,0,0,0,0,0,-2524679514,107351963,1245.829185,2462388055,246238805.5,1,8161,347,207,207,0,207,8161,0,207,17.71705426,0.689922481,0.689922481,94185.12791,220.0503876,1.457364341,99867.32171,0.94314445,0.002196296,1.60006E-05,0,0.025364539,37,28
D:0| T0: 0.17| T1: 44.00| R0: 0.0| R1: 0.0| WTP: 0,0,0.173076923,44,0,0,0,0,0,-3041632502,773789021,1077.470422,2987758981,298775898.1,1,8544,375,179,179,0,179,8544,0,179,14.62837838,0.456081081,0.456081081,94020.33108,198.3277027,1.087837838,99885.50338,0.941317545,0.001980593,1.20644E-05,0,0.020950375,43,34
D:0| T0: 0.17| T1: 44.00| R0: 0.0| R1: 0.0| WTP: 0,0,0.173076923,44,0,0,0,0,0,-3189235663,850936611,2166.299289,3080920698,308092069.8,1,15098,619,353,360,7,353,15098,7,360,23.84590164,1,1.019672131,88922.51475,261.6196721,2.213114754,99749.76393,0.891492083,0.002614122,2.33417E-05,0.019444444,0.023844218,44,35
D:0| T0: 0.17| T1: 44.00| R0: 0.0| R1: 0.0| WTP: 0,0,0.173076923,44,0,0,0,0,0,-2208661717,1701318364,6440.879931,1886617720,188661772,1,48546,2066,593,1070,477,593,48546,477,1070,128.1617647,2.799019608,5.098039216,66123.78431,1013.656863,8.014705882,99316.60294,0.665356634,0.010138231,8.15597E-05,0.445794393,0.022040951,30,21
D:0| T0: 0.17| T1: 44.00| R0: 0.0| R1: 0.0| WTP: 0,0,0.173076923,44,0,0,0,0,0,-1140198407,778708269,12.05544501,1139595635,113959563.5,1,160,9,2,2,0,2,160,0,2,0.577181208,0,0,99907.56376,7.577181208,0.013422819,99999.52349,0.999082926,7.74669E-05,2.66668E-07,0,0.012578616,22,13
D:0| T0: 0.17| T1: 44.00| R0: 0.0| R1: 0.0| WTP: 0,0,0.173076923,44,0,0,0,0,0,-1581914065,1391938506,1619.063448,1500960893,150096089.3,1,12213,490,265,269,4,265,12213,4,269,34.41242938,1.322033898,1.333333333,91991.17514,246.559322,2.870056497,99838.23164,0.921450195,0.002457106,3.00386E-05,0.014869888,0.02202571,26,17
D:0| T0: 0.17| T1: 44.00| R0: 0.0| R1: 0.0| WTP: 0,0,0.173076923,44,0,0,0,0,0,-966359998.7,43418681,36.15789548,964552103.9,96455210.39,1,448,22,6,6,0,6,448,0,6,1.766423358,0,0,99738.22628,18.38686131,0.04379562,99996.93431,0.997417343,0.000185078,8.69587E-07,0,0.013392857,20,11
D:0| T0: 0.17| T1: 44.00| R0: 0.0| R1: 0.0| WTP: 0,0,0.173076923,44,0,0,0,0,0,-2757534997,817384966,13042.80165,2105394915,210539491.5,1,97822,4117,441,2167,1726,441,97822,1726,2167,235.1506849,1.96803653,9.808219178,20561.99087,1216.515982,11.82648402,98330.76712,0.207488953,0.012227703,0.000119801,0.796492847,0.022152481,32,23
D:0| T0: 0.17| T1: 44.00| R0: 0.0| R1: 0.0| WTP: 0,0,0.173076923,44,0,0,0,0,0,-1933910598,762053968,12269.39796,1320440700,132044070,1,95458,4290,497,2038,1541,497,95458,1541,2038,339.6918239,3.062893082,12.68553459,32651.35849,1878.163522,15.80503145,98698.81761,0.328496954,0.018836603,0.000160036,0.756133464,0.021349704,23,14
D:0| T0: 0.17| T1: 44.00| R0: 0.0| R1: 0.0| WTP: 0,0,0.173076923,44,0,0,0,0,0,-2580493242,1692506311,638.7625143,2548555116,254855511.6,1,6143,287,106,106,0,106,6143,0,106,14.67041199,0.288389513,0.288389513,95765.45318,154.3146067,0.685393258,99933.11236,0.958329567,0.001540373,7.9145E-06,0,0.017255413,38,29
D:0| T0: 0.17| T1: 44.00| R0: 0.0| R1: 0.0| WTP: 0,0,0.173076923,44,0,0,0,0,0,-615459852.2,1037620300,36.0634779,613656678.3,61365667.83,1,189,3,6,6,0,6,189,0,6,0.5625,0,0,99899.99107,6.258928571,0.0625,99997.875,0.999023061,6.41604E-05,1.06197E-06,0,0.031746032,16,7
D:0| T0: 0.17| T1: 44.00| R0: 0.0| R1: 0.0| WTP: 0,0,0.173076923,44,0,0,0,0,0,-1528169582,301400999,656.3266049,1495353251,149535325.1,1,5263,243,109,109,0,109,5263,0,109,16.64835165,0.467032967,0.467032967,96524.47802,120.7802198,1.054945055,99935.81319,0.965902233,0.001204021,1.19188E-05,0,0.020710621,26,17
D:0| T0: 0.17| T1: 44.00| R0: 0.0| R1: 0.0| WTP: 0,0,0.173076923,44,0,0,0,0,0,-2510059671,1868336855,8579.025629,2081108389,208110838.9,1,67252,2898,610,1425,815,610,67252,815,1425,171.0182648,2.689497717,6.365296804,52262.28311,1195.570776,9.155251142,99064.35616,0.526522568,0.011982025,9.31687E-05,0.571929825,0.021188961,32,23
D:0| T0: 0.17| T1: 44.00| R0: 0.0| R1: 0.0| WTP: 0,0,0.173076923,44,0,0,0,0,0,-2224097217,1868498144,8223.015062,1812946464,181294646.4,1,62583,2729,635,1366,731,635,62583,731,1366,168.8325123,3.019704433,6.581280788,57170.52709,1278.660099,9.684729064,99143.84236,0.575684899,0.012807541,9.877E-05,0.535139092,0.021827014,29,20
D:0| T0: 0.17| T1: 44.00| R0: 0.0| R1: 0.0| WTP: 0,0,0.173076923,44,0,0,0,0,0,-1851510385,2101566889,192.5684389,1841881963,184188196.3,1,1307,54,32,32,0,32,1307,0,32,3.470588235,0.078431373,0.078431373,99127.97059,35.24019608,0.230392157,99980.40686,0.991485172,0.000352835,3.12242E-06,0,0.02448355,30,21
D:0| T0: 0.17| T1: 44.00| R0: 0.0| R1: 0.0| WTP: 0,0,0.173076923,44,0,0,0,0,0,-1968416855,1665097450,13001.34028,1318349841,131834984.1,1,98303,4245,438,2160,1722,438,98303,1722,2160,335.0573248,2.732484076,13.63694268,28653.10191,2147.821656,16.41401274,98558.82803,0.28833457,0.021555904,0.000166186,0.797222222,0.02197288,23,14
D:0| T0: 0.17| T1: 44.00| R0: 0.0| R1: 0.0| WTP: 0,0,0.173076923,44,0,0,0,0,0,-1883626195,1716179948,11242.80387,1321486001,132148600.1,1,98040,4376,478,1867,1389,478,98040,1389,1867,349.6815287,2.98089172,11.75159236,31126.16561,2151.77707,14.78343949,98819.96815,0.312876334,0.021562003,0.000149784,0.74397429,0.019043248,23,14
D:0| T0: 0.17| T1: 44.00| R0: 0.0| R1: 0.0| WTP: 0,0,0.173076923,44,0,0,0,0,0,-1161076997,1560278715,391.0284409,1141525574,114152557.4,1,2287,99,65,65,0,65,2287,0,65,7.272151899,0.284810127,0.284810127,98698.41139,47.56962025,0.696202532,99967.28481,0.987315533,0.000475487,8.17863E-06,0,0.028421513,22,13
D:0| T0: 0.17| T1: 44.00| R0: 0.0| R1: 0.0| WTP: 0,0,0.173076923,44,0,0,0,0,0,-2330459506,991019385,10124.37815,1824240598,182424059.8,1,75581,3192,610,1682,1072,610,75581,1072,1682,207.2182741,3.015228426,8.401015228,47832.03046,2275.329949,11.49238579,98948.60914,0.48181966,0.02281456,0.000116747,0.637336504,0.02225427,29,20
D:0| T0: 0.17| T1: 44.00| R0: 0.0| R1: 0.0| WTP: 0,0,0.173076923,44,0,0,0,0,0,-4037186478,118052103,6171.18416,3728627270,372862727,1,49165,2143,914,1025,111,914,49165,111,1025,74.81512605,2.420168067,2.714285714,64806.01681,695.5378151,5.263305322,99303.16246,0.652145278,0.006972472,5.44395E-05,0.108292683,0.020848164,51,42
D:0| T0: 0.17| T1: 44.00| R0: 0.0| R1: 0.0| WTP: 0,0,0.173076923,44,0,0,0,0,0,-2018243144,1209758844,12487.00953,1393892667,139389266.7,1,88204,3609,528,2075,1547,528,88204,1547,2075,273.9515152,3.139393939,12.44848485,40211.76364,1568.357576,15.62424242,98708.38788,0.404832705,0.015744512,0.000158423,0.745542169,0.02352501,24,15
D:0| T0: 0.17| T1: 44.00| R0: 0.0| R1: 0.0| WTP: 0,0,0.173076923,44,0,0,0,0,0,-971295411.4,70671723,132.287538,964681034.5,96468103.45,1,879,37,22,22,0,22,879,0,22,2.096296296,0.096296296,0.096296296,99502.6,40.9037037,0.251851852,99989.91111,0.995132145,0.000408641,3.23562E-06,0,0.025028441,20,11
D:0| T0: 0.17| T1: 44.00| R0: 0.0| R1: 0.0| WTP: 0,0,0.173076923,44,0,0,0,0,0,-615724590.1,1722612191,42.05585974,613621797.1,61362179.71,1,154,7,7,7,0,7,154,0,7,0.339130435,0,0,99925.90435,6.269565217,0.069565217,99997.8,0.999282038,6.45706E-05,1.20693E-06,0,0.045454545,16,7
D:0| T0: 0.17| T1: 44.00| R0: 0.0| R1: 0.0| WTP: 0,0,0.173076923,44,0,0,0,0,0,-2019662922,1968291596,60.27458221,2016649193,201664919.3,1,480,31,10,10,0,10,480,0,10,1.887892377,0.004484305,0.004484305,99687.01794,8.713004484,0.049327354,99995.69507,0.99691812,8.91993E-05,8.92897E-07,0,0.020833333,32,23
D:0| T0: 0.17| T1: 44.00| R0: 0.0| R1: 0.0| WTP: 0,0,0.173076923,44,0,0,0,0,0,-2081251979,1877569084,13494.00386,1406551787,140655178.7,1,98396,4145,476,2242,1766,476,98396,1766,2242,326.0802469,2.895061728,13.75308642,28298.09259,1940.851852,16.66666667,98508.96296,0.284748422,0.019488655,0.000168597,0.787689563,0.022785479,24,15
D:0| T0: 0.17| T1: 44.00| R0: 0.0| R1: 0.0| WTP: 0,0,0.173076923,44,0,0,0,0,0,-2068572054,1726322189,13306.75095,1403234506,140323450.6,1,96304,4112,524,2211,1687,524,96304,1687,2211,307.5030303,3.109090909,13.26060606,31480.65455,1982.472727,16.44848485,98571.98788,0.316751669,0.019905308,0.000166567,0.763003166,0.022958548,24,15
D:0| T0: 0.17| T1: 44.00| R0: 0.0| R1: 0.0| WTP: 0,0,0.173076923,44,0,0,0,0,0,-1886903744,307848836,11497.9627,1312005608,131200560.8,1,90240,3972,507,1910,1403,507,90240,1403,1910,304.1552795,3.062111801,11.72049689,39548.54658,1977.285714,14.86956522,98843.35404,0.397740099,0.019823457,0.000150608,0.734554974,0.02116578,23,14
D:0| T0: 0.17| T1: 44.00| R0: 0.0| R1: 0.0| WTP: 0,0,0.173076923,44,0,0,0,0,0,-1835977801,1154000220,12035.59302,1234198150,123419815,1,98939,4480,439,1999,1560,439,98939,1560,1999,356.8766234,2.753246753,12.83766234,25431.02597,1673.532468,15.72077922,98620.52597,0.256197708,0.016774105,0.000158844,0.780390195,0.020204368,22,13
D:0| T0: 0.17| T1: 44.00| R0: 0.0| R1: 0.0| WTP: 0,0,0.173076923,44,0,0,0,0,0,-1848893629,2028661055,150.3633374,1841375462,184137546.2,1,905,37,25,25,0,25,905,0,25,2,0.048780488,0.048780488,99380.10732,23.08292683,0.165853659,99985.20976,0.993956921,0.000232011,2.42747E-06,0,0.027624309,30,21
D:0| T0: 0.17| T1: 44.00| R0: 0.0| R1: 0.0| WTP: 0,0,0.173076923,44,0,0,0,0,0,-4518933725,1629114640,11451.77196,3946345127,394634512.7,2,91348,4154,1315,1902,587,1315,91348,587,1902,79.53499222,1.925349922,2.816485226,61670.07465,879.2363919,4.864696734,99259.95956,0.619362954,0.008861733,5.04104E-05,0.308622503,0.020821474,92,44
D:0| T0: 0.17| T1: 44.00| R0: 0.0| R1: 0.0| WTP: 0,0,0.173076923,44,0,0,0,0,0,-1964457217,1439048174,12952.84406,1316815014,131681501.4,1,97218,4091,501,2152,1651,501,97218,1651,2152,320.6583851,3.049689441,13.26708075,31550.6646,2571.826087,16.38509317,98626.93789,0.317283489,0.025819004,0.000165513,0.767193309,0.022135818,23,14
D:0| T0: 0.17| T1: 44.00| R0: 0.0| R1: 0.0| WTP: 0,0,0.173076923,44,0,0,0,0,0,-2606194342,865227006,13487.76317,1931806183,193180618.3,1,99171,4141,440,2241,1801,440,99171,1801,2241,253.4975845,2.062801932,10.73429952,18111.4058,1287.507246,12.87439614,98252.28502,0.182903911,0.012941058,0.000130328,0.803659081,0.022597332,30,21
D:0| T0: 0.17| T1: 44.00| R0: 0.0| R1: 0.0| WTP: 0,0,0.173076923,44,0,0,0,0,0,-3541606123,890479738,8194.431474,3131884549,313188454.9,1,65502,2868,855,1361,506,855,65502,506,1361,119.7679739,2.669934641,4.284313725,51526.37582,1528.915033,7.071895425,99057.38889,0.519313149,0.015341459,7.26885E-05,0.372058824,0.020763042,44,35
D:0| T0: 0.17| T1: 44.00| R0: 0.0| R1: 0.0| WTP: 0,0,0.173076923,44,0,0,0,0,0,-1260009283,1017049163,571.924303,1231413068,123141306.8,1,4882,218,95,95,0,95,4882,0,95,15.35220126,0.471698113,0.471698113,97010.84906,111.0251572,1.088050314,99947.66667,0.970643074,0.001106399,1.18804E-05,0,0.019459238,23,14
D:0| T0: 0.17| T1: 44.00| R0: 0.0| R1: 0.0| WTP: 0,0,0.173076923,44,0,0,0,0,0,-1316046176,1707305064,18.14171148,1315139090,131513909,1,304,12,3,3,0,3,304,0,3,1.43902439,0.006097561,0.006097561,99809.40854,9.384146341,0.018292683,99998.14634,0.998116373,9.53351E-05,3.63639E-07,0,0.009868421,24,15
D:0| T0: 0.17| T1: 44.00| R0: 0.0| R1: 0.0| WTP: 0,0,0.173076923,44,0,0,0,0,0,-2256163780,400145663,13458.37785,1583244887,158324488.7,1,99063,4296,416,2236,1820,416,99063,1820,2236,305.3125,2.301136364,12.61363636,21244.23864,1511.471591,14.97727273,98336.77273,0.214354435,0.015179205,0.000151496,0.813953488,0.022571495,26,17
D:0| T0: 0.17| T1: 44.00| R0: 0.0| R1: 0.0| WTP: 0,0,0.173076923,44,0,0,0,0,0,-1146840749,1662654181,120.5449117,1140813503,114081350.3,1,1480,66,20,20,0,20,1480,0,20,5.25974026,0.051948052,0.051948052,99114.72078,38.96753247,0.168831169,99989.98701,0.991256664,0.000389447,2.58088E-06,0,0.013513514,22,13
D:0| T0: 0.17| T1: 44.00| R0: 0.0| R1: 0.0| WTP: 0,0,0.173076923,44,0,0,0,0,0,-2028784179,182136456,12413.50839,1408108760,140810876,1,98235,4374,473,2062,1589,473,98235,1589,2062,333.2037037,2.87037037,12.62345679,28120.00617,2101.364198,15.5308642,98623.17284,0.282984097,0.021080113,0.000157104,0.770611057,0.020990482,24,15
D:0| T0: 0.17| T1: 44.00| R0: 0.0| R1: 0.0| WTP: 0,0,0.173076923,44,0,0,0,0,0,-1403902093,979575387,24.11458233,1402696364,140269636.4,1,290,12,4,4,0,4,290,0,4,1.046783626,0,0,99823.53216,11.45614035,0.023391813,99998.20468,0.99825693,0.000116223,4.65123E-07,0,0.013793103,25,16
D:0| T0: 0.17| T1: 44.00| R0: 0.0| R1: 0.0| WTP: 0,0,0.173076923,44,0,0,0,0,0,-2114530231,2142525414,10984.42846,1565308808,156530880.8,1,81403,3435,588,1825,1237,588,81403,1237,1825,240.7653631,3.201117318,10.05027933,45963.01676,1782.201117,13.33519553,98902.11732,0.462652857,0.017876666,0.000135287,0.677808219,0.022419321,26,17
D:0| T0: 0.17| T1: 44.00| R0: 0.0| R1: 0.0| WTP: 0,0,0.173076923,44,0,0,0,0,0,-3750901039,1464057597,5726.414307,3464580324,346458032.4,1,46331,2043,855,951,96,855,46331,96,951,78.78078078,2.408408408,2.678678679,67203.39339,520.1921922,5.27027027,99360.99099,0.675967907,0.005212507,5.43294E-05,0.100946372,0.0205271,48,39
D:0| T0: 0.17| T1: 44.00| R0: 0.0| R1: 0.0| WTP: 0,0,0.173076923,44,0,0,0,0,0,-2062133212,364562610,11580.68812,1483098806,148309880.6,1,87956,3757,530,1924,1394,530,87956,1394,1924,266.3275862,2.965517241,10.93678161,39138.09195,1709.189655,14,98782.65517,0.394011626,0.017143152,0.000141569,0.724532225,0.021874574,25,16
D:0| T0: 0.17| T1: 44.00| R0: 0.0| R1: 0.0| WTP: 0,0,0.173076923,44,0,0,0,0,0,-2257783547,40350784,10400.98761,1737734166,173773416.6,1,77125,3268,605,1728,1123,605,77125,1123,1728,212.625641,3.01025641,8.717948718,47288.47692,1529.682051,11.81538462,98915.11282,0.476332949,0.015341981,0.000120075,0.649884259,0.022405186,28,19
D:0| T0: 0.17| T1: 44.00| R0: 0.0| R1: 0.0| WTP: 0,0,0.173076923,44,0,0,0,0,0,-2074109977,804064356,9890.023559,1579608799,157960879.9,1,89264,4116,438,1642,1204,438,89264,1204,1642,292.2011173,2.379888268,9.072625698,36867.4581,1444.03352,11.50837989,98925.40223,0.370984933,0.014467612,0.000116487,0.733252132,0.018394874,26,17
D:0| T0: 0.17| T1: 44.00| R0: 0.0| R1: 0.0| WTP: 0,0,0.173076923,44,0,0,0,0,0,-1628227273,2125493986,5507.451387,1352854703,135285470.3,1,39738,1695,465,915,450,465,39738,450,915,129.0059524,2.654761905,5.303571429,74078.57738,742.8690476,8.041666667,99455.19643,0.744512211,0.007417016,8.20256E-05,0.491803279,0.023025819,24,15
D:0| T0: 0.17| T1: 44.00| R0: 0.0| R1: 0.0| WTP: 0,0,0.173076923,44,0,0,0,0,0,-2022145136,23154253,7499.412326,1647174520,164717452,1,69083,3146,519,1245,726,519,69083,726,1245,219.8315217,2.695652174,6.60326087,53171.11413,1000.472826,9.461956522,99223.38043,0.53493693,0.010008325,9.59413E-05,0.58313253,0.0180218,27,18
D:0| T0: 0.17| T1: 44.00| R0: 0.0| R1: 0.0| WTP: 0,0,0.173076923,44,0,0,0,0,0,-2038013103,1391367689,385.2502514,2018750591,201875059.1,1,3102,138,64,64,0,64,3102,0,64,7.206278027,0.170403587,0.170403587,97810.30493,47.04932735,0.452914798,99958.0583,0.97853964,0.000470982,5.71604E-06,0,0.020638504,32,23
D:0| T0: 0.17| T1: 44.00| R0: 0.0| R1: 0.0| WTP: 0,0,0.173076923,44,0,0,0,0,0,-2403329841,574142276,2173.165102,2294671586,229467158.6,1,16719,710,356,361,5,356,16719,5,361,36.45679012,1.304526749,1.325102881,88596.55556,316.4115226,2.794238683,99771.09053,0.888025751,0.003158796,2.94371E-05,0.013850416,0.021593492,35,26
D:0| T0: 0.17| T1: 44.00| R0: 0.0| R1: 0.0| WTP: 0,0,0.173076923,44,0,0,0,0,0,-701611202.7,898736779,6.039854375,701309210,70130921,1,92,4,1,1,0,1,92,0,1,0.578947368,0,0,99953.01754,5.789473684,0.00877193,99999.17544,0.999539648,5.9218E-05,1.73913E-07,0,0.010869565,17,8
D:0| T0: 0.17| T1: 44.00| R0: 0.0| R1: 0.0| WTP: 0,0,0.173076923,44,0,0,0,0,0,-2997621159,346473503,4705.084077,2762366955,276236695.5,1,43699,2075,632,781,149,632,43699,149,781,93.00357143,2.139285714,2.65,68346.65714,891.5892857,4.892857143,99475.89643,0.686883565,0.008918335,5.04839E-05,0.19078105,0.017872263,40,31
D:0| T0: 0.17| T1: 44.00| R0: 0.0| R1: 0.0| WTP: 0,0,0.173076923,44,0,0,0,0,0,-2795541010,445552282,4436.49241,2573716390,257371639,1,33491,1483,592,737,145,592,33491,145,737,66.94776119,2.063432836,2.593283582,76622.03358,719.0186567,4.809701493,99519.27239,0.769761245,0.007190865,4.95886E-05,0.196743555,0.022005912,38,29
D:0| T0: 0.17| T1: 44.00| R0: 0.0| R1: 0.0| WTP: 0,0,0.173076923,44,0,0,0,0,0,-1746013496,911758476,11946.23269,1148701861,114870186.1,1,99146,4479,437,1984,1547,437,99146,1547,1984,396.7676056,2.985915493,13.83098592,27636.58451,1954.535211,16.9084507,98686.9507,0.278200211,0.019581078,0.000170959,0.779737903,0.020010893,21,12
D:0| T0: 0.17| T1: 44.00| R0: 0.0| R1: 0.0| WTP: 0,0,0.173076923,44,0,0,0,0,0,-2141479453,1464197940,11111.20923,1585918992,158591899.2,1,93996,4382,552,1845,1293,552,93996,1293,1845,311.6256983,3.005586592,10.18994413,33594.05028,3063.877095,13.24581006,98820.50279,0.337879763,0.03073005,0.000134389,0.700813008,0.019628495,26,17
D:0| T0: 0.17| T1: 44.00| R0: 0.0| R1: 0.0| WTP: 0,0,0.173076923,44,0,0,0,0,0,-1687163374,500405854,1908.361708,1591745289,159174528.9,1,13849,600,307,317,10,307,13849,10,317,42.3315508,1.465240642,1.524064171,91001.3262,304.6149733,3.160427807,99814.31551,0.911740735,0.003036852,3.32424E-05,0.031545741,0.022894699,27,18
D:0| T0: 0.17| T1: 44.00| R0: 0.0| R1: 0.0| WTP: 0,0,0.173076923,44,0,0,0,0,0,-2004424760,772037341,12110.26047,1398911737,139891173.7,1,92766,3897,464,2012,1548,464,92766,1548,2012,293.5333333,2.739393939,12.06666667,35320.81818,1842.612121,14.87272727,98710.27879,0.355418127,0.018482671,0.000150624,0.769383698,0.021688981,24,15
D:0| T0: 0.17| T1: 44.00| R0: 0.0| R1: 0.0| WTP: 0,0,0.173076923,44,0,0,0,0,0,-967790505.6,1543158763,66.16145856,964482432.7,96448243.27,1,464,23,11,11,0,11,464,0,11,1.379562044,0.02189781,0.02189781,99731.39416,15.99270073,0.102189781,99993.85401,0.997379249,0.000161025,1.59428E-06,0,0.023706897,20,11
D:0| T0: 0.17| T1: 44.00| R0: 0.0| R1: 0.0| WTP: 0,0,0.173076923,44,0,0,0,0,0,-1832721565,1604932531,13782.2358,1143609775,114360977.5,1,98721,4189,442,2290,1848,442,98721,1848,2290,361.6438356,2.938356164,15.55479452,28998.41781,1995.582192,18.5890411,98497.54795,0.291808024,0.020024328,0.000187945,0.8069869,0.023196686,21,12
D:0| T0: 0.17| T1: 44.00| R0: 0.0| R1: 0.0| WTP: 0,0,0.173076923,44,0,0,0,0,0,-2606397423,539051477,10270.38144,2092878350,209287835,1,77413,3439,689,1706,1017,689,77413,1017,1706,202.8027523,3.059633028,7.669724771,45165.97248,2037.399083,10.82568807,98900.74771,0.45512808,0.0204447,0.000110323,0.596131301,0.022037642,32,23
D:0| T0: 0.17| T1: 44.00| R0: 0.0| R1: 0.0| WTP: 0,0,0.173076923,44,0,0,0,0,0,-1235046152,1743124675,144.3604116,1227828131,122782813.1,1,733,30,24,24,0,24,733,0,24,2.662420382,0.057324841,0.057324841,99529.2293,15.29299363,0.21656051,99986.01911,0.99543861,0.000153751,3.03832E-06,0,0.032742156,23,14
D:0| T0: 0.17| T1: 44.00| R0: 0.0| R1: 0.0| WTP: 0,0,0.173076923,44,0,0,0,0,0,-4517381745,1965983789,11634.38412,3935662539,393566253.9,2,87579,3655,1148,1933,785,1148,87579,785,1933,71.53514377,1.672523962,2.910543131,71334.27476,815.2539936,4.739616613,99396.27796,0.714986298,0.008219051,4.96017E-05,0.4063147,0.022060083,90,44
D:0| T0: 0.17| T1: 44.00| R0: 0.0| R1: 0.0| WTP: 0,0,0.173076923,44,0,0,0,0,0,-2320546455,516774280,728.3701541,2284127947,228412794.7,1,5542,243,121,121,0,121,5542,0,121,11.99186992,0.394308943,0.394308943,96125.00407,145.6747967,0.886178862,99922.0935,0.962033873,0.001453907,9.80332E-06,0,0.021833273,35,26
D:0| T0: 0.17| T1: 44.00| R0: 0.0| R1: 0.0| WTP: 0,0,0.173076923,44,0,0,0,0,0,-2296715272,86603142,12497.83911,1671823317,167182331.7,1,98877,4264,422,2076,1654,422,98877,1654,2076,296.4565217,2.239130435,11.19565217,20627.42391,1394.456522,13.48913043,98429.9837,0.20817992,0.013998365,0.000136404,0.79672447,0.020995783,27,18
D:0| T0: 0.17| T1: 44.00| R0: 0.0| R1: 0.0| WTP: 0,0,0.173076923,44,0,0,0,0,0,-965989593.7,1431870609,30.13122792,964483032.3,96448303.23,1,447,16,5,5,0,5,447,0,5,1.467153285,0,0,99737.33577,22.10948905,0.03649635,99997.13139,0.997406558,0.000221746,7.24652E-07,0,0.011185682,20,11
D:0| T0: 0.17| T1: 44.00| R0: 0.0| R1: 0.0| WTP: 0,0,0.173076923,44,0,0,0,0,0,-2561069609,1592383984,4882.931227,2316923047,231692304.7,1,38645,1653,625,811,186,625,38645,186,811,89.30165289,2.462809917,3.20661157,73345.36777,466.8347107,5.785123967,99478.17769,0.73708206,0.00466913,5.9338E-05,0.229346486,0.020985897,35,26
D:0| T0: 0.17| T1: 44.00| R0: 0.0| R1: 0.0| WTP: 0,0,0.173076923,44,0,0,0,0,0,-3345917664,1440183867,1728.954876,3259469920,325946992,1,15407,738,287,287,0,287,15407,0,287,29.37383178,0.791277259,0.791277259,88320.2866,231.3956386,1.647975078,99792.72274,0.885098164,0.002312016,1.7851E-05,0,0.018627896,46,37
D:0| T0: 0.17| T1: 44.00| R0: 0.0| R1: 0.0| WTP: 0,0,0.173076923,44,0,0,0,0,0,-2216600266,1696510588,439.4901935,2194625756,219462575.6,1,4098,171,73,73,0,73,4098,0,73,8.274678112,0.214592275,0.214592275,97230.24893,83.35622318,0.527896996,99953.59657,0.972780595,0.000832626,6.24149E-06,0,0.017813568,34,25
D:0| T0: 0.17| T1: 44.00| R0: 0.0| R1: 0.0| WTP: 0,0,0.173076923,44,0,0,0,0,0,-2298715397,895039877,11046.3651,1746397142,174639714.2,1,84956,3665,584,1835,1251,584,84956,1251,1835,240.5206186,2.93814433,9.319587629,39528.04124,2295.494845,12.31443299,98817.30412,0.398154226,0.02302829,0.000125193,0.681743869,0.021599416,28,19
D:0| T0: 0.17| T1: 44.00| R0: 0.0| R1: 0.0| WTP: 0,0,0.173076923,44,0,0,0,0,0,-3185527409,129565953,2076.479023,3081703458,308170345.8,1,13873,615,345,345,0,345,13873,0,345,25.1516129,0.961290323,0.961290323,90059.8129,316.2645161,2.080645161,99770.82903,0.902692706,0.003159971,2.2224E-05,0,0.024796367,44,35
D:0| T0: 0.17| T1: 44.00| R0: 0.0| R1: 0.0| WTP: 0,0,0.173076923,44,0,0,0,0,0,-1865188265,1902565669,415.5966057,1844408435,184440843.5,1,4219,196,69,69,0,69,4219,0,69,10.41545894,0.256038647,0.256038647,97168.86473,75.99033816,0.574879227,99955.94203,0.972147651,0.000759016,6.63677E-06,0,0.016362343,30,21
D:0| T0: 0.17| T1: 44.00| R0: 0.0| R1: 0.0| WTP: 0,0,0.173076923,44,0,0,0,0,0,-1413891858,1984179288,198.6784526,1403957935,140395793.5,1,1788,69,33,33,0,33,1788,0,33,5.296511628,0.087209302,0.087209302,98850.1686,78.55813953,0.284883721,99982.40116,0.988690847,0.000783459,3.81563E-06,0,0.018456376,25,16
D:0| T0: 0.17| T1: 44.00| R0: 0.0| R1: 0.0| WTP: 0,0,0.173076923,44,0,0,0,0,0,-4140281121,677377223,6489.341867,3815814028,381581402.8,1,49956,2110,976,1078,102,976,49956,102,1078,71.83606557,2.510928962,2.784153005,64807.94536,1110.043716,5.464480874,99282.65301,0.652227704,0.011131759,5.62723E-05,0.094619666,0.02157899,52,43
D:0| T0: 0.17| T1: 44.00| R0: 0.0| R1: 0.0| WTP: 0,0,0.173076923,44,0,0,0,0,0,-4516362785,973583301,11421.48309,3945288630,394528863,2,90076,4043,1554,1897,343,1554,90076,343,1897,82.47868852,2.359016393,2.909836066,59330.24754,1203.608197,5.454098361,99183.98689,0.596180534,0.01213264,5.69991E-05,0.180811808,0.021059994,88,44
D:0| T0: 0.17| T1: 44.00| R0: 0.0| R1: 0.0| WTP: 0,0,0.173076923,44,0,0,0,0,0,-2037402907,781062938,1819.595345,1946423140,194642314,1,16669,807,300,302,2,300,16669,2,302,49.28301887,1.254716981,1.264150943,88793.16038,365.2264151,2.693396226,99814.68396,0.889631333,0.003642702,2.83044E-05,0.006622517,0.018117464,31,22
D:0| T0: 0.17| T1: 44.00| R0: 0.0| R1: 0.0| WTP: 0,0,0.173076923,44,0,0,0,0,0,-4517957441,338783425,11404.05429,3947754727,394775472.7,2,93886,4201,1031,1894,863,1031,93886,863,1894,84.66074313,1.515347334,2.882067851,68494.62359,1234.510501,4.537964459,99412.37803,0.685954167,0.012441016,4.76127E-05,0.455649419,0.020173402,89,44
D:0| T0: 0.17| T1: 44.00| R0: 0.0| R1: 0.0| WTP: 0,0,0.173076923,44,0,0,0,0,0,-1496594806,1027579040,114.3679034,1490876411,149087641.1,1,917,39,19,19,0,19,917,0,19,2.531914894,0.053191489,0.053191489,99416.66489,37.12234043,0.154255319,99988.96809,0.994283973,0.000371146,2.01075E-06,0,0.020765027,26,17
D:0| T0: 0.17| T1: 44.00| R0: 0.0| R1: 0.0| WTP: 0,0,0.173076923,44,0,0,0,0,0,-2935803379,764973813,2281.639231,2821721417,282172141.7,1,17440,762,378,379,1,378,17440,1,379,32.72852234,1.151202749,1.151202749,87800.37113,406.7869416,2.457044674,99752.73196,0.880195361,0.004063582,2.59727E-05,0.002638522,0.021731651,41,32
D:0| T0: 0.17| T1: 44.00| R0: 0.0| R1: 0.0| WTP: 0,0,0.173076923,44,0,0,0,0,0,-3436564257,1245753446,4894.419079,3191843304,319184330.4,1,37398,1650,633,813,180,633,37398,180,813,65.80511182,1.926517572,2.495207668,71759.77316,815.9392971,4.485623003,99420.11182,0.721640252,0.008167931,4.6243E-05,0.221402214,0.02173913,45,36
D:0| T0: 0.17| T1: 44.00| R0: 0.0| R1: 0.0| WTP: 0,0,0.173076923,44,0,0,0,0,0,-2115271545,1013177794,3310.063447,1949768372,194976837.2,1,24433,1013,457,550,93,457,24433,93,550,56.13615023,1.981220657,2.408450704,83444.0892,480.6244131,4.577464789,99656.82629,0.837286831,0.004798261,4.71851E-05,0.169090909,0.022510539,31,22
D:0| T0: 0.17| T1: 44.00| R0: 0.0| R1: 0.0| WTP: 0,0,0.173076923,44,0,0,0,0,0,-1668898538,1395089249,54.31437069,1666182819,166618281.9,1,867,37,9,9,0,9,867,0,9,2.642105263,0.010526316,0.010526316,99400.07895,24.06315789,0.052631579,99994.11053,0.994069425,0.000241844,9.42445E-07,0,0.010380623,28,19
D:0| T0: 0.17| T1: 44.00| R0: 0.0| R1: 0.0| WTP: 0,0,0.173076923,44,0,0,0,0,0,-438852878.3,1339545835,12.01008238,438252374.2,43825237.42,1,66,0,2,2,0,2,66,0,2,0,0,0,99962.31579,4.557894737,0.021052632,99998.72632,0.99963791,4.76049E-05,4.16669E-07,0,0.03030303,14,5
D:0| T0: 0.17| T1: 44.00| R0: 0.0| R1: 0.0| WTP: 0,0,0.173076923,44,0,0,0,0,0,-1803808453,219139554,11410.78146,1233269380,123326938,1,95408,4273,467,1895,1428,467,95408,1428,1895,366.147651,3.060402685,12.57718121,32898,1681.52349,15.7114094,98779.59732,0.331041421,0.016848896,0.000158928,0.753562005,0.019862066,22,13
D:0| T0: 0.17| T1: 44.00| R0: 0.0| R1: 0.0| WTP: 0,0,0.173076923,44,0,0,0,0,0,-1428864147,1336508942,451.6680232,1406280746,140628074.6,1,3698,167,75,75,0,75,3698,0,75,13.33727811,0.284023669,0.284023669,97760.78107,87.67455621,0.75739645,99962.23077,0.977996639,0.00087437,8.82671E-06,0,0.020281233,25,16
D:0| T0: 0.17| T1: 44.00| R0: 0.0| R1: 0.0| WTP: 0,0,0.173076923,44,0,0,0,0,0,-703999557.1,448559423,54.07595311,701295759.4,70129575.94,1,162,4,9,9,0,9,162,0,9,0.434782609,0.017391304,0.017391304,99910.31304,10.29565217,0.095652174,99997.29565,0.999132373,0.000104226,1.55178E-06,0,0.055555556,17,8
D:0| T0: 0.17| T1: 44.00| R0: 0.0| R1: 0.0| WTP: 0,0,0.173076923,44,0,0,0,0,0,-2341667252,2110028840,1089.701955,2287182154,228718215.4,1,8531,384,181,181,0,181,8531,0,181,19.525,0.629166667,0.629166667,94033.29583,172.9458333,1.3875,99883.17917,0.941479057,0.001726289,1.50339E-05,0,0.021216739,35,26
D:0| T0: 0.17| T1: 44.00| R0: 0.0| R1: 0.0| WTP: 0,0,0.173076923,44,0,0,0,0,0,-4593020836,1982030155,13035.44972,3941248350,394124835,2,90792,3806,1058,2166,1108,1058,90792,1108,2166,78.80623974,1.612479475,3.405582923,72919.48768,988.1642036,5.149425287,99395.99836,0.730686904,0.00997336,5.3407E-05,0.511542013,0.023856727,87,44
D:0| T0: 0.17| T1: 44.00| R0: 0.0| R1: 0.0| WTP: 0,0,0.173076923,44,0,0,0,0,0,-3350850333,696219407,3419.17834,3179891416,317989141.6,1,24467,1065,549,568,19,549,24467,19,568,43.66031746,1.571428571,1.628571429,82573.48254,257.3142857,3.393650794,99612.49206,0.828903879,0.002574202,3.54476E-05,0.033450704,0.023214943,45,36
D:0| T0: 0.17| T1: 44.00| R0: 0.0| R1: 0.0| WTP: 0,0,0.173076923,44,0,0,0,0,0,-1990826146,1402539442,10104.21028,1485615632,148561563.2,1,84628,3787,549,1678,1129,549,84628,1129,1678,283.7705882,3.147058824,9.741176471,44141.80588,2280.270588,12.94117647,99002.20588,0.443936197,0.022846769,0.000131338,0.672824791,0.019827953,25,16
D:0| T0: 0.17| T1: 44.00| R0: 0.0| R1: 0.0| WTP: 0,0,0.173076923,44,0,0,0,0,0,-2170138711,1319833493,10276.86929,1656295247,165629524.7,1,82058,3679,610,1707,1097,610,82058,1097,1707,240.6914894,3.159574468,8.95212766,43550.01596,2947.164894,12.18085106,98943.32447,0.438413347,0.029552063,0.000123649,0.64264792,0.020802359,27,18
D:0| T0: 0.17| T1: 44.00| R0: 0.0| R1: 0.0| WTP: 0,0,0.173076923,44,0,0,0,0,0,-1885052194,663608076,788.3451044,1845634939,184563493.9,1,5676,235,131,131,0,131,5676,0,131,13.57560976,0.502439024,0.502439024,96326.76585,165.702439,1.107317073,99923.73171,0.964032521,0.00165234,1.27265E-05,0,0.023079634,30,21
D:0| T0: 0.17| T1: 44.00| R0: 0.0| R1: 0.0| WTP: 0,0,0.173076923,44,0,0,0,0,0,-2020178004,414696500,72.25827997,2016565090,201656509,1,570,30,12,12,0,12,570,0,12,1.613333333,0.013333333,0.013333333,99633.01333,15.64444444,0.062222222,99993.08889,0.996404208,0.000158106,1.062E-06,0,0.021052632,32,23
D:0| T0: 0.17| T1: 44.00| R0: 0.0| R1: 0.0| WTP: 0,0,0.173076923,44,0,0,0,0,0,-1235681494,1249738535,150.4741011,1228157789,122815778.9,1,990,45,25,25,0,25,990,0,25,3.826086957,0.068322981,0.068322981,99391.55901,24.61490683,0.211180124,99987.7205,0.994045566,0.000246872,3.08678E-06,0,0.025252525,23,14
D:0| T0: 0.17| T1: 44.00| R0: 0.0| R1: 0.0| WTP: 0,0,0.173076923,44,0,0,0,0,0,-2025637172,614415382,168.55095,2017209625,201720962.5,1,1515,57,28,28,0,28,1515,0,28,3.399082569,0.041284404,0.041284404,99080.43119,44.09174312,0.174311927,99984.91284,0.990961812,0.000441702,2.55742E-06,0,0.018481848,32,23
D:0| T0: 0.17| T1: 44.00| R0: 0.0| R1: 0.0| WTP: 0,0,0.173076923,44,0,0,0,0,0,-1667325705,524899953,30.17289825,1665817060,166581706,1,480,28,5,5,0,5,480,0,5,1.458333333,0,0,99673.375,14.23958333,0.026041667,99996.66146,0.996772967,0.00014389,5.18145E-07,0,0.010438413,28,19
D:0| T0: 0.17| T1: 44.00| R0: 0.0| R1: 0.0| WTP: 0,0,0.173076923,44,0,0,0,0,0,-1868528488,1338977757,12660.58602,1235499187,123549918.7,1,98967,4419,403,2103,1700,403,98967,1700,2103,361.6623377,2.545454545,13.53896104,26152.23377,1689.824675,16.16233766,98549.27273,0.263361216,0.016945494,0.000163349,0.808368997,0.021249507,22,13
D:0| T0: 0.17| T1: 44.00| R0: 0.0| R1: 0.0| WTP: 0,0,0.173076923,44,0,0,0,0,0,-2171611986,341384587,10377.79317,1652722327,165272232.7,1,78975,3373,518,1724,1206,518,78975,1206,1724,230.9679144,2.695187166,9.096256684,43613.90909,1431.032086,11.86631016,98861.60428,0.439601863,0.01434678,0.000120265,0.699535963,0.021829693,27,18
D:0| T0: 0.17| T1: 44.00| R0: 0.0| R1: 0.0| WTP: 0,0,0.173076923,44,0,0,0,0,0,-4539905226,2032000160,11937.13841,3943048305,394304830.5,2,89355,3924,1305,1983,678,1305,89355,678,1983,80.30769231,1.990180033,3.080196399,66789.21277,985.8330606,5.206219313,99298.51064,0.670210045,0.009941717,5.42384E-05,0.341906203,0.022192379,88,44
D:0| T0: 0.17| T1: 44.00| R0: 0.0| R1: 0.0| WTP: 0,0,0.173076923,44,0,0,0,0,0,-2311998142,779488939,9722.511255,1825872580,182587258,1,76020,3316,566,1615,1049,566,76020,1049,1615,207.7821782,2.683168317,7.811881188,47341.05446,1430.034653,10.63861386,98974.18812,0.47678371,0.014336003,0.000108321,0.649535604,0.021244409,29,20
D:0| T0: 0.17| T1: 44.00| R0: 0.0| R1: 0.0| WTP: 0,0,0.173076923,44,0,0,0,0,0,-2403071716,1449019578,643.9927093,2370872080,237087208,1,4312,177,107,107,0,107,4312,0,107,9.519379845,0.290697674,0.290697674,97104.62791,105.1395349,0.724806202,99933.52326,0.971714509,0.001050298,8.26683E-06,0,0.024825986,36,27
D:0| T0: 0.17| T1: 44.00| R0: 0.0| R1: 0.0| WTP: 0,0,0.173076923,44,0,0,0,0,0,-1231066491,351952211,66.26538164,1227753222,122775322.2,1,521,28,11,11,0,11,521,0,11,2.541935484,0.006451613,0.006451613,99682.72903,14.9483871,0.096774194,99994.78065,0.996884685,0.000151096,1.41033E-06,0,0.021113244,23,14
D:0| T0: 0.17| T1: 44.00| R0: 0.0| R1: 0.0| WTP: 0,0,0.173076923,44,0,0,0,0,0,-1493321373,486595046,60.13217012,1490314765,149031476.5,1,385,16,10,10,0,10,385,0,10,0.798969072,0,0,99792.07732,15.70103093,0.051546392,99995.45876,0.997968414,0.000158418,1.02569E-06,0,0.026041667,26,17
D:0| T0: 0.17| T1: 44.00| R0: 0.0| R1: 0.0| WTP: 0,0,0.173076923,44,0,0,0,0,0,-2037782249,296745624,4954.595422,1790052477,179005247.7,1,39226,1736,481,823,342,481,39226,342,823,107.213198,2.294416244,4.005076142,73475.38579,975.6294416,6.446700508,99485.8731,0.738318974,0.00974749,6.6131E-05,0.415552855,0.020980982,29,20
D:0| T0: 0.17| T1: 44.00| R0: 0.0| R1: 0.0| WTP: 0,0,0.173076923,44,0,0,0,0,0,-1689278952,1671484194,409.4919052,1668804357,166880435.7,1,3384,161,68,68,0,68,3384,0,68,10.31606218,0.243523316,0.243523316,97859.04145,89.84974093,0.606217617,99960.7772,0.978995441,0.000896637,7.0126E-06,0,0.020106446,28,19
D:0| T0: 0.17| T1: 44.00| R0: 0.0| R1: 0.0| WTP: 0,0,0.173076923,44,0,0,0,0,0,-2177830809,422157396,11879.18551,1583871533,158387153.3,1,98334,4369,476,1973,1497,476,98334,1497,1973,303.9050279,2.592178771,10.92178771,26113.46927,2049.960894,13.58100559,98631.15642,0.262861855,0.020571472,0.000137384,0.758743031,0.020064271,26,17
D:0| T0: 0.17| T1: 44.00| R0: 0.0| R1: 0.0| WTP: 0,0,0.173076923,44,0,0,0,0,0,-1963423376,1916599091,12816.58979,1322593886,132259388.6,1,98431,4258,447,2129,1682,447,98431,1682,2129,350.1329114,2.753164557,13.34810127,27640.51899,2168.949367,16.1835443,98569.12025,0.278220405,0.021755487,0.000163717,0.790042273,0.021629365,23,14
D:0| T0: 0.17| T1: 44.00| R0: 0.0| R1: 0.0| WTP: 0,0,0.173076923,44,0,0,0,0,0,-1846254200,1005953941,12216.23243,1235442578,123544257.8,1,98342,4312,495,2029,1534,495,98342,1534,2029,368.8013245,3.225165563,13.32450331,30384.56954,2637.046358,16.58940397,98711.46358,0.305556772,0.026435801,0.000167715,0.756037457,0.02063208,22,13
D:0| T0: 0.17| T1: 44.00| R0: 0.0| R1: 0.0| WTP: 0,0,0.173076923,44,0,0,0,0,0,-1922051942,1422765615,12241.99292,1309952296,130995229.6,1,88872,3789,548,2034,1486,548,88872,1486,2034,297.05,3.31875,12.5375,40028.55,1926.55,16.00625,98767.19375,0.402835345,0.019329845,0.000161992,0.730580138,0.022886849,23,14
D:0| T0: 0.17| T1: 44.00| R0: 0.0| R1: 0.0| WTP: 0,0,0.173076923,44,0,0,0,0,0,-1141173493,699740192,30.09482132,1139668752,113966875.2,1,339,16,5,5,0,5,339,0,5,0.805194805,0.012987013,0.012987013,99795.20779,13.00649351,0.045454545,99997.74026,0.997978703,0.000131615,6.45172E-07,0,0.014749263,22,13
D:0| T0: 0.17| T1: 44.00| R0: 0.0| R1: 0.0| WTP: 0,0,0.173076923,44,0,0,0,0,0,-877077009.2,240885764,6.0931291,876772352.8,87677235.28,1,99,9,1,1,0,1,99,0,1,1.3046875,0,0,99939.54688,3.9609375,0.0078125,99999.63281,0.999401857,4.1628E-05,1.55039E-07,0,0.01010101,19,10
D:0| T0: 0.17| T1: 44.00| R0: 0.0| R1: 0.0| WTP: 0,0,0.173076923,44,0,0,0,0,0,-1751226524,2023806564,7473.239389,1377564554,137756455.4,1,64820,2923,579,1241,662,579,64820,662,1241,217.0898204,3.335329341,7.251497006,57969.91018,1628.628743,10.71856287,99283.88024,0.582960091,0.016284955,0.000109006,0.533440774,0.019145326,24,15
D:0| T0: 0.17| T1: 44.00| R0: 0.0| R1: 0.0| WTP: 0,0,0.173076923,44,0,0,0,0,0,-1409573787,1907493879,132.2933622,1402959119,140295911.9,1,938,34,22,22,0,22,938,0,22,1.761363636,0.051136364,0.051136364,99451.4375,32.5625,0.176136364,99987.76705,0.994641665,0.000326367,2.48613E-06,0,0.023454158,25,16
D:0| T0: 0.17| T1: 44.00| R0: 0.0| R1: 0.0| WTP: 0,0,0.173076923,44,0,0,0,0,0,-4526967654,1565815291,11702.53949,3941840679,394184067.9,2,89800,3811,1329,1944,615,1329,89800,615,1944,77.34664537,1.947284345,2.910543131,63372.78115,1156.407348,5.030351438,99249.98083,0.635997179,0.011657732,5.26882E-05,0.316358025,0.021648107,90,44
D:0| T0: 0.17| T1: 44.00| R0: 0.0| R1: 0.0| WTP: 0,0,0.173076923,44,0,0,0,0,0,-1772682733,784442364,343.1211169,1755526677,175552667.7,1,2611,121,57,57,0,57,2611,0,57,7.09223301,0.145631068,0.145631068,98276.67476,65.99029126,0.412621359,99967.82039,0.983102311,0.000659235,5.50875E-06,0,0.021830716,29,20
D:0| T0: 0.17| T1: 44.00| R0: 0.0| R1: 0.0| WTP: 0,0,0.173076923,44,0,0,0,0,0,-2026022510,206369745,9224.662745,1564789373,156478937.3,1,76953,3443,550,1532,982,550,76953,982,1532,238.8176796,2.928176796,8.303867403,48480.9116,1774.883978,11.3480663,99067.62431,0.487857087,0.017778876,0.00011528,0.640992167,0.019908256,26,17
D:0| T0: 0.17| T1: 44.00| R0: 0.0| R1: 0.0| WTP: 0,0,0.173076923,44,0,0,0,0,0,-2169931348,2087235992,11811.70151,1579346272,157934627.2,1,94449,4081,555,1962,1407,555,94449,1407,1962,284.9779006,2.983425414,10.68508287,32573.52486,2271.955801,13.75138122,98736.20994,0.327710743,0.022793562,0.00013965,0.717125382,0.020773116,26,17
D:0| T0: 0.17| T1: 44.00| R0: 0.0| R1: 0.0| WTP: 0,0,0.173076923,44,0,0,0,0,0,-2413545917,1019092536,795.0901621,2373791409,237379140.9,1,7491,319,132,132,0,132,7491,0,132,16.7983871,0.435483871,0.435483871,94738.0121,168.4798387,0.935483871,99912.95161,0.948251484,0.001681734,1.06092E-05,0,0.017621145,36,27
D:0| T0: 0.17| T1: 44.00| R0: 0.0| R1: 0.0| WTP: 0,0,0.173076923,44,0,0,0,0,0,-3156727701,1885906113,3088.117528,3002321825,300232182.5,1,24403,1024,458,513,55,458,24403,55,513,41.84228188,1.432885906,1.610738255,81610.28859,249.2718121,3.134228188,99629.61745,0.819159924,0.002492919,3.25573E-05,0.107212476,0.021022867,43,34
D:0| T0: 0.17| T1: 44.00| R0: 0.0| R1: 0.0| WTP: 0,0,0.173076923,44,0,0,0,0,0,-1475893206,2028637200,1264.513638,1412667524,141266752.4,1,11082,498,207,210,3,207,11082,3,210,33.42528736,1.051724138,1.063218391,92742.43678,248.8793103,2.229885057,99875.66667,0.928634903,0.002479365,2.38523E-05,0.014285714,0.018951358,25,16
D:0| T0: 0.17| T1: 44.00| R0: 0.0| R1: 0.0| WTP: 0,0,0.173076923,44,0,0,0,0,0,-2193661260,181476086,10709.8204,1658170240,165817024,1,86739,3824,537,1779,1242,537,86739,1242,1779,249.2956989,2.806451613,9.424731183,39414.52688,2185.919355,12.32258065,98865.46237,0.396737754,0.021924178,0.000124957,0.698145025,0.020509805,27,18
D:0| T0: 0.17| T1: 44.00| R0: 0.0| R1: 0.0| WTP: 0,0,0.173076923,44,0,0,0,0,0,-2203342319,2097578470,10842.9697,1661193834,166119383.4,1,85558,3814,584,1801,1217,584,85558,1217,1801,259.1290323,3.059139785,9.548387097,40090.06452,2490.709677,12.67204301,98856.64516,0.403672229,0.024981195,0.000128687,0.675735702,0.021050048,27,18
D:0| T0: 0.17| T1: 44.00| R0: 0.0| R1: 0.0| WTP: 0,0,0.173076923,44,0,0,0,0,0,-4536052429,119646392,11965.35235,3937784811,393778481.1,2,86846,3728,1097,1988,891,1097,86846,891,1988,75.41243863,1.63502455,3.072013093,74404.31915,899.4795417,4.882160393,99455.09656,0.745433533,0.009069227,5.08973E-05,0.448189135,0.022891095,88,44
D:0| T0: 0.17| T1: 44.00| R0: 0.0| R1: 0.0| WTP: 0,0,0.173076923,44,0,0,0,0,0,-1822268896,1298895859,11824.44223,1231046784,123104678.4,1,95331,4196,512,1964,1452,512,95331,1452,1964,353.56,3.333333333,12.93333333,35246.99333,2644.933333,16.35333333,98804.68,0.354356787,0.026513078,0.000165562,0.739307536,0.020601903,22,13
D:0| T0: 0.17| T1: 44.00| R0: 0.0| R1: 0.0| WTP: 0,0,0.173076923,44,0,0,0,0,0,-2537887848,1489316290,10625.0589,2006634903,200663490.3,1,82534,3668,529,1765,1236,529,82534,1236,1765,211.7887324,2.403755869,8.154929577,38400.00469,1348.258216,10.63849765,98764.79343,0.387276667,0.013528474,0.000108127,0.700283286,0.021385126,31,22
D:0| T0: 0.17| T1: 44.00| R0: 0.0| R1: 0.0| WTP: 0,0,0.173076923,44,0,0,0,0,0,-2717563507,855602142,14009.49354,2017088830,201708883,1,96194,3955,472,2328,1856,472,96194,1856,2328,236.6604651,2.153488372,10.74883721,26336.70233,1594.795349,12.94418605,98322.34419,0.265324005,0.016043383,0.000131127,0.797250859,0.024201094,31,22
D:0| T0: 0.17| T1: 44.00| R0: 0.0| R1: 0.0| WTP: 0,0,0.173076923,44,0,0,0,0,0,-2290824425,1438649896,3304.247164,2125612066,212561206.6,1,24979,1036,479,549,70,479,24979,70,549,52.61373391,1.922746781,2.210300429,83049.94421,545.1287554,4.244635193,99662.40773,0.833268084,0.005443653,4.40512E-05,0.127504554,0.021978462,33,24
D:0| T0: 0.17| T1: 44.00| R0: 0.0| R1: 0.0| WTP: 0,0,0.173076923,44,0,0,0,0,0,-1667490841,952489126,36.13731856,1665683975,166568397.5,1,393,13,6,6,0,6,393,0,6,1.036458333,0.005208333,0.005208333,99749.71354,16.3125,0.03125,99997.29688,0.997528192,0.000164252,6.21777E-07,0,0.015267176,28,19
D:0| T0: 0.17| T1: 44.00| R0: 0.0| R1: 0.0| WTP: 0,0,0.173076923,44,0,0,0,0,0,-1687488373,1550779155,12652.83926,1054846410,105484641,1,99140,4210,405,2102,1697,405,99140,1697,2102,388.0444444,2.925925926,15.45185185,25772.78519,2053.718519,18.45185185,98562.6,0.259796048,0.020577355,0.00018625,0.807326356,0.02120234,20,11
D:0| T0: 0.17| T1: 44.00| R0: 0.0| R1: 0.0| WTP: 0,0,0.173076923,44,0,0,0,0,0,-1584538183,607323321,120.3671534,1578519826,157851982.6,1,958,46,20,20,0,20,958,0,20,2.515957447,0.042553191,0.042553191,99350.77128,24.48404255,0.138297872,99988.26596,0.993634788,0.000245896,2.1166E-06,0,0.019832985,27,18
D:0| T0: 0.17| T1: 44.00| R0: 0.0| R1: 0.0| WTP: 0,0,0.173076923,44,0,0,0,0,0,-1763967924,2103646485,6320.595797,1447938134,144793813.4,1,48476,2088,518,1050,532,518,48476,532,1050,152.8176471,2.923529412,6.017647059,68788.1,861.6882353,9.047058824,99382.15294,0.691607142,0.008609496,9.21735E-05,0.506666667,0.021660203,25,16
D:0| T0: 0.17| T1: 44.00| R0: 0.0| R1: 0.0| WTP: 0,0,0.173076923,44,0,0,0,0,0,-1967351175,258120157,11146.97866,1410002242,141000224.2,1,97711,4438,441,1851,1410,441,97711,1410,1851,336.3151515,2.6,11.09090909,25085.55152,1505.909091,13.77575758,98682.07273,0.25287235,0.015096437,0.000139335,0.761750405,0.018943619,24,15
D:0| T0: 0.17| T1: 44.00| R0: 0.0| R1: 0.0| WTP: 0,0,0.173076923,44,0,0,0,0,0,-1881549754,1068951401,674.9467064,1847802418,184780241.8,1,6848,326,112,112,0,112,6848,0,112,19.8708134,0.435406699,0.435406699,95174.23445,127.6172249,0.976076555,99927.33971,0.952488261,0.001272629,1.06723E-05,0,0.01635514,30,21
D:0| T0: 0.17| T1: 44.00| R0: 0.0| R1: 0.0| WTP: 0,0,0.173076923,44,0,0,0,0,0,-4497382033,635956235,11214.31222,3936666422,393666642.2,2,86369,3694,999,1863,864,999,86369,864,1863,65.96960926,1.364688857,2.590448625,73931.52098,952.3256151,4.02894356,99478.48336,0.740169272,0.009597971,4.17412E-05,0.463768116,0.021570239,98,44
D:0| T0: 0.17| T1: 44.00| R0: 0.0| R1: 0.0| WTP: 0,0,0.173076923,44,0,0,0,0,0,-1056481164,1346693470,78.31500247,1052565414,105256541.4,1,830,35,13,13,0,13,830,0,13,3.167832168,0.034965035,0.034965035,99510.42657,29.68531469,0.104895105,99993.27972,0.995177696,0.00029731,1.80566E-06,0,0.015662651,21,12
D:0| T0: 0.17| T1: 44.00| R0: 0.0| R1: 0.0| WTP: 0,0,0.173076923,44,0,0,0,0,0,-2053644038,847102011,12959.21789,1405683144,140568314.4,1,98233,4205,472,2153,1681,472,98233,1681,2153,319.4573171,2.817073171,13,28185.04878,2044.310976,15.8597561,98563.80488,0.283633893,0.020520756,0.000160784,0.780771017,0.021917278,24,15
D:0| T0: 0.17| T1: 44.00| R0: 0.0| R1: 0.0| WTP: 0,0,0.173076923,44,0,0,0,0,0,-4552363551,812083272,12307.72145,3936977478,393697747.8,2,87218,3547,1873,2045,172,1873,87218,172,2045,69.18575851,2.696594427,2.948916409,53737.56502,828.4287926,5.877708978,98956.32043,0.541434423,0.008358347,6.11729E-05,0.084107579,0.023446995,93,44
D:0| T0: 0.17| T1: 44.00| R0: 0.0| R1: 0.0| WTP: 0,0,0.173076923,44,0,0,0,0,0,-2173799732,2146825809,11771.51154,1585224155,158522415.5,1,98874,4500,465,1955,1490,465,98874,1490,1955,310.3202247,2.556179775,10.8988764,22618.65169,1755.179775,13.51123596,98579.26404,0.228024452,0.017605376,0.000136496,0.762148338,0.01977264,26,17
D:0| T0: 0.17| T1: 44.00| R0: 0.0| R1: 0.0| WTP: 0,0,0.173076923,44,0,0,0,0,0,-2049126291,226186520,12851.40519,1406556032,140655603.2,1,97214,4231,468,2135,1667,468,97214,1667,2135,315.2619048,2.726190476,12.57738095,29346.85714,1687.755952,15.35714286,98566.32143,0.29534006,0.016944885,0.00015565,0.780796253,0.021961857,24,15
D:0| T0: 0.17| T1: 44.00| R0: 0.0| R1: 0.0| WTP: 0,0,0.173076923,44,0,0,0,0,0,-4534616958,1110225441,11811.52942,3944040487,394404048.7,2,88890,3895,1763,1962,199,1763,88890,199,1962,75.18473282,2.511450382,2.803053435,55405.63053,1047.338931,5.476335878,99058.36031,0.557173275,0.010562572,5.73317E-05,0.101427115,0.022072224,94,44
D:0| T0: 0.17| T1: 44.00| R0: 0.0| R1: 0.0| WTP: 0,0,0.173076923,44,0,0,0,0,0,-2799752948,1190767082,2908.788215,2654313537,265431353.7,1,26849,1155,465,483,18,465,26849,18,483,51.7032967,1.553113553,1.608058608,80675.79121,528.6410256,3.318681319,99676.7033,0.809389278,0.00528117,3.46811E-05,0.037267081,0.017989497,39,30
D:0| T0: 0.17| T1: 44.00| R0: 0.0| R1: 0.0| WTP: 0,0,0.173076923,44,0,0,0,0,0,-2049038391,2108234095,589.7016078,2019553310,201955331,1,3816,156,98,98,0,98,3816,0,98,9.366972477,0.28440367,0.28440367,97486.00917,107.4311927,0.747706422,99940.77523,0.975460291,0.001072089,8.95402E-06,0,0.025681342,32,23
D:0| T0: 0.17| T1: 44.00| R0: 0.0| R1: 0.0| WTP: 0,0,0.173076923,44,0,0,0,0,0,-2062506633,465621985,13044.7896,1410267153,141026715.3,1,98735,4381,480,2167,1687,480,98735,1687,2167,334.5272727,2.83030303,13.01212121,26112.41818,2058.369697,15.90909091,98516.55758,0.262930085,0.020662792,0.000161171,0.778495616,0.021947638,24,15
D:0| T0: 0.17| T1: 44.00| R0: 0.0| R1: 0.0| WTP: 0,0,0.173076923,44,0,0,0,0,0,-1470907198,1487072553,1168.372375,1412488579,141248857.9,1,11183,472,192,194,2,192,11183,2,194,33.1849711,1,1.011560694,93079.32948,235.1213873,2.115606936,99890.27746,0.931853345,0.00234256,2.22045E-05,0.010309278,0.017350863,25,16
D:0| T0: 0.17| T1: 44.00| R0: 0.0| R1: 0.0| WTP: 0,0,0.173076923,44,0,0,0,0,0,-2731172781,1213733847,4875.330653,2487406248,248740624.8,1,37564,1534,620,810,190,620,37564,190,810,73.66798419,2.304347826,3.015810277,73460.26087,625.9367589,5.466403162,99463.34783,0.738383356,0.006261691,5.65317E-05,0.234567901,0.021563199,37,28
D:0| T0: 0.17| T1: 44.00| R0: 0.0| R1: 0.0| WTP: 0,0,0.173076923,44,0,0,0,0,0,-2702535570,2003658337,5922.419548,2406414593,240641459.3,1,44748,1879,596,984,388,596,44748,388,984,90.98785425,2.311740891,3.862348178,67670.89474,734.1012146,6.271255061,99330.82591,0.680937101,0.007347291,6.40309E-05,0.394308943,0.02198981,36,27
D:0| T0: 0.17| T1: 44.00| R0: 0.0| R1: 0.0| WTP: 0,0,0.173076923,44,0,0,0,0,0,-1056628393,1170868072,84.26888432,1052414949,105241494.9,1,737,34,14,14,0,14,737,0,14,2.5,0.027777778,0.027777778,99553.38889,29.02777778,0.111111111,99993.40972,0.995606114,0.000290569,1.93116E-06,0,0.018995929,21,12
D:0| T0: 0.17| T1: 44.00| R0: 0.0| R1: 0.0| WTP: 0,0,0.173076923,44,0,0,0,0,0,-2356850640,569919592,11915.80294,1761060493,176106049.3,1,99253,4499,426,1979,1553,426,99253,1553,1979,291.0471204,2.178010471,10.28272251,19861.66492,1353.65445,12.51308901,98501.8377,0.200403918,0.013586368,0.000126488,0.784739768,0.019938944,28,19
D:0| T0: 0.17| T1: 44.00| R0: 0.0| R1: 0.0| WTP: 0,0,0.173076923,44,0,0,0,0,0,-2101805493,1833180623,4362.033463,1883703819,188370381.9,1,40935,1924,502,724,222,502,40935,222,724,121.7902439,2.292682927,3.336585366,71794.22927,925.3512195,5.795121951,99541.13171,0.721111564,0.009242055,5.97295E-05,0.306629834,0.017686576,30,21
D:0| T0: 0.17| T1: 44.00| R0: 0.0| R1: 0.0| WTP: 0,0,0.173076923,44,0,0,0,0,0,-2250428039,1123666637,13397.49232,1580553424,158055342.4,1,97045,4088,484,2226,1742,484,97045,1742,2226,292.4382022,2.646067416,12.37640449,26979.19101,1643.123596,15.08988764,98445.79213,0.271790086,0.016507599,0.000153066,0.782569632,0.022937812,26,17
D:0| T0: 0.17| T1: 44.00| R0: 0.0| R1: 0.0| WTP: 0,0,0.173076923,44,0,0,0,0,0,-2712613295,1682024981,9030.975062,2261064541,226106454.1,1,71675,3165,735,1500,765,735,71675,765,1500,166.8791667,2.966666667,6.091666667,50887.09167,2447.845833,9.158333333,99065.55417,0.512325812,0.024550112,9.34585E-05,0.51,0.020927799,34,25
D:0| T0: 0.17| T1: 44.00| R0: 0.0| R1: 0.0| WTP: 0,0,0.173076923,44,0,0,0,0,0,-3093503296,1687523543,1992.336254,2993886483,299388648.3,1,15603,650,331,331,0,331,15603,0,331,25.96632997,0.95959596,0.95959596,89222.13468,196.3131313,2.074074074,99784.98316,0.894166904,0.001961911,2.22508E-05,0,0.021215229,43,34
D:0| T0: 0.17| T1: 44.00| R0: 0.0| R1: 0.0| WTP: 0,0,0.173076923,44,0,0,0,0,0,-2098517827,178034412,12141.87123,1491424265,149142426.5,1,94595,4091,473,2017,1544,473,94595,1544,2017,302.4882353,2.705882353,11.71176471,32179.84706,1957.470588,14.5,98671.00588,0.323884412,0.01964123,0.000147066,0.765493307,0.02132248,25,16
D:0| T0: 0.17| T1: 44.00| R0: 0.0| R1: 0.0| WTP: 0,0,0.173076923,44,0,0,0,0,0,-1965558549,739490003,11252.80218,1402918440,140291844,1,93004,4063,472,1869,1397,472,93004,1397,1869,315.3580247,2.858024691,11.41358025,35432.75926,1602.95679,14.30864198,98812.0679,0.356447524,0.016067527,0.000144941,0.747458534,0.02009591,24,15
D:0| T0: 0.17| T1: 44.00| R0: 0.0| R1: 0.0| WTP: 0,0,0.173076923,44,0,0,0,0,0,-1973734689,178482706,8510.628926,1548203243,154820324.3,1,63172,2774,540,1414,874,540,63172,874,1414,187.3446328,2.95480226,7.836158192,57986.71186,1529.644068,10.87570621,99144.86441,0.58376196,0.01531079,0.000110547,0.618104668,0.022383334,26,17
D:0| T0: 0.17| T1: 44.00| R0: 0.0| R1: 0.0| WTP: 0,0,0.173076923,44,0,0,0,0,0,-2022576101,1919366370,3196.185014,1862766851,186276685.1,1,24018,1000,446,531,85,446,24018,85,531,59.85990338,2.033816425,2.429951691,84146.29469,401.7487923,4.599033816,99674.77295,0.844168403,0.004010565,4.70942E-05,0.16007533,0.022109339,30,21
D:0| T0: 0.17| T1: 44.00| R0: 0.0| R1: 0.0| WTP: 0,0,0.173076923,44,0,0,0,0,0,-1981487002,1819796913,11429.23864,1410025070,141002507,1,97451,4460,447,1898,1451,447,97451,1451,1898,331.8562874,2.622754491,11.25149701,29956.10778,2402.502994,13.91616766,98757.13174,0.301268217,0.024087167,0.000140892,0.764488936,0.019476455,24,15
D:0| T0: 0.17| T1: 44.00| R0: 0.0| R1: 0.0| WTP: 0,0,0.173076923,44,0,0,0,0,0,-4570965300,1866591913,12496.57262,3946136669,394613666.9,2,94449,4110,1215,2076,861,1215,94449,861,2076,92.17721519,2.003616637,3.529837251,70507.14105,1406.965642,5.748643761,99412.32007,0.706173181,0.014189256,5.99981E-05,0.414739884,0.021980116,79,44
D:0| T0: 0.17| T1: 44.00| R0: 0.0| R1: 0.0| WTP: 0,0,0.173076923,44,0,0,0,0,0,-1854053111,1219425989,12401.84865,1233960679,123396067.9,1,99237,4466,445,2060,1615,445,99237,1615,2060,367.2281879,2.899328859,13.69798658,25378.61074,1725.073826,16.67785235,98582.61074,0.255690659,0.017298075,0.000168699,0.783980583,0.020758386,22,13
D:0| T0: 0.17| T1: 44.00| R0: 0.0| R1: 0.0| WTP: 0,0,0.173076923,44,0,0,0,0,0,-2081001749,502409586,11734.42741,1494280379,149428037.9,1,97438,4267,475,1949,1474,475,97438,1474,1949,306.0287356,2.655172414,11.08045977,28094.3908,2257.413793,13.83333333,98682,0.282737,0.022643698,0.00013985,0.756285274,0.020002463,25,16
D:0| T0: 0.17| T1: 44.00| R0: 0.0| R1: 0.0| WTP: 0,0,0.173076923,44,0,0,0,0,0,-1956592972,1405887957,9608.669848,1476159480,147615948,1,76415,3438,512,1596,1084,512,76415,1084,1596,251.7869822,2.940828402,9.313609467,49101.85207,1371.710059,12.32544379,99030.04142,0.494238164,0.013737337,0.000124981,0.679197995,0.020885952,25,16
D:0| T0: 0.17| T1: 44.00| R0: 0.0| R1: 0.0| WTP: 0,0,0.173076923,44,0,0,0,0,0,-2094420002,283033753,12288.32318,1480003843,148000384.3,1,87277,3583,531,2042,1511,531,87277,1511,2042,255.9884393,2.994219653,11.67052023,38554.0578,1341.491329,14.74566474,98675.24855,0.388482073,0.013467474,0.000149366,0.739960823,0.023396771,25,16
D:0| T0: 0.17| T1: 44.00| R0: 0.0| R1: 0.0| WTP: 0,0,0.173076923,44,0,0,0,0,0,-2442906241,1083157068,5947.128611,2145549811,214554981.1,1,44084,1891,611,988,377,611,44084,377,988,104.8193833,2.528634361,4.158590308,68445.04405,986.5770925,6.889867841,99350.94714,0.688615203,0.009869687,7.0484E-05,0.381578947,0.022411759,33,24
D:0| T0: 0.17| T1: 44.00| R0: 0.0| R1: 0.0| WTP: 0,0,0.173076923,44,0,0,0,0,0,-2195326163,1988704626,3189.468904,2035852718,203585271.8,1,21682,887,470,530,60,470,21682,60,530,49.40358744,1.97309417,2.228699552,85041.75785,249.4080717,4.340807175,99658.37668,0.853324847,0.002491796,4.47597E-05,0.113207547,0.02444875,32,23
D:0| T0: 0.17| T1: 44.00| R0: 0.0| R1: 0.0| WTP: 0,0,0.173076923,44,0,0,0,0,0,-1782919123,884761309,12743.97338,1145720455,114572045.5,1,99069,4387,436,2117,1681,436,99069,1681,2117,369.3673469,2.911564626,14.29251701,24302.81633,1752.081633,17.2585034,98511.2381,0.245066138,0.017571463,0.00017431,0.794048181,0.021368945,21,12
D:0| T0: 0.17| T1: 44.00| R0: 0.0| R1: 0.0| WTP: 0,0,0.173076923,44,0,0,0,0,0,-1357033682,533485933,716.7577695,1321195794,132119579.4,1,6560,306,119,119,0,119,6560,0,119,22.79012346,0.617283951,0.617283951,95949.82099,110.5246914,1.351851852,99933.99383,0.960166,0.001101319,1.46094E-05,0,0.018140244,24,15
D:0| T0: 0.17| T1: 44.00| R0: 0.0| R1: 0.0| WTP: 0,0,0.173076923,44,0,0,0,0,0,-1541710028,632196071,897.0507331,1496857491,149685749.1,1,7021,309,148,149,1,148,7021,1,149,21.58988764,0.724719101,0.730337079,95478.35393,102.4719101,1.584269663,99911.10674,0.955671149,0.001022034,1.66039E-05,0.006711409,0.021222048,26,17
D:0| T0: 0.17| T1: 44.00| R0: 0.0| R1: 0.0| WTP: 0,0,0.173076923,44,0,0,0,0,0,-2132995666,393400457,12797.00807,1493145262,149314526.2,1,96342,4175,447,2126,1679,447,96342,1679,2126,304.3430233,2.540697674,12.26162791,30650.72093,1753.767442,14.8372093,98579.56395,0.30840584,0.017605094,0.000150281,0.789746002,0.022067219,25,16
D:0| T0: 0.17| T1: 44.00| R0: 0.0| R1: 0.0| WTP: 0,0,0.173076923,44,0,0,0,0,0,-1929437168,398973227,10756.71502,1391601417,139160141.7,1,82399,3546,541,1787,1246,541,82399,1246,1787,262.9107143,3.136904762,10.48809524,44001.22024,1467.214286,13.69642857,98895.46429,0.443037157,0.014703408,0.000138964,0.697257974,0.021687156,24,15
D:0| T0: 0.17| T1: 44.00| R0: 0.0| R1: 0.0| WTP: 0,0,0.173076923,44,0,0,0,0,0,-4470730863,1402256491,10668.27675,3937317025,393731702.5,2,85181,3709,1668,1772,104,1668,85181,104,1772,62.90027701,2.162049861,2.299168975,51400.2036,747.7867036,4.620498615,99009.01108,0.517940726,0.007536534,4.8001E-05,0.058690745,0.020802761,104,44
D:0| T0: 0.17| T1: 44.00| R0: 0.0| R1: 0.0| WTP: 0,0,0.173076923,44,0,0,0,0,0,-2499058230,2102527413,9944.961666,2001810146,200181014.6,1,75044,3333,654,1652,998,654,75044,998,1652,199.9952607,3,7.696682464,47394.36019,2057.260664,10.81042654,98944.08531,0.4775157,0.020634822,0.00010969,0.604116223,0.022013752,31,22
D:0| T0: 0.17| T1: 44.00| R0: 0.0| R1: 0.0| WTP: 0,0,0.173076923,44,0,0,0,0,0,-2223863970,1748031099,11322.31507,1657748216,165774821.6,1,84820,3584,627,1881,1254,627,84820,1254,1881,249.6793478,3.331521739,10.09782609,42318.53804,2486.804348,13.48369565,98840.16304,0.42603791,0.024958767,0.000136848,0.666666667,0.022176373,27,18
D:0| T0: 0.17| T1: 44.00| R0: 0.0| R1: 0.0| WTP: 0,0,0.173076923,44,0,0,0,0,0,-2430745683,1946754629,1125.618252,2374464770,237446477,1,8598,349,187,187,0,187,8598,0,187,18.12195122,0.62601626,0.62601626,93951.59756,134.6626016,1.398373984,99876.96341,0.940719103,0.001344662,1.51554E-05,0,0.021749244,36,27
D:0| T0: 0.17| T1: 44.00| R0: 0.0| R1: 0.0| WTP: 0,0,0.173076923,44,0,0,0,0,0,-2053296278,2097712204,2149.705652,1945810995,194581099.5,1,17589,805,348,357,9,348,17589,9,357,45.97222222,1.444444444,1.49537037,88200.31481,251.962963,3.111111111,99778.14815,0.883997055,0.002514567,3.25451E-05,0.025210084,0.020296776,31,22
D:0| T0: 0.17| T1: 44.00| R0: 0.0| R1: 0.0| WTP: 0,0,0.173076923,44,0,0,0,0,0,-3602113300,1198827119,150.4245572,3594592072,359459207.2,1,1250,56,25,25,0,25,1250,0,25,1.571428571,0.011428571,0.011428571,99124.28571,22.62285714,0.085714286,99983.49429,0.991415094,0.000228089,1.42467E-06,0,0.02,50,41
D:0| T0: 0.17| T1: 44.00| R0: 0.0| R1: 0.0| WTP: 0,0,0.173076923,44,0,0,0,0,0,-1404184043,109253198,30.1143433,1402678326,140267832.6,1,294,12,5,5,0,5,294,0,5,0.91160221,0.005524862,0.005524862,99818.67956,11.40331492,0.027624309,99997,0.998220311,0.000115882,5.49461E-07,0,0.017064846,25,16
D:0| T0: 0.17| T1: 44.00| R0: 0.0| R1: 0.0| WTP: 0,0,0.173076923,44,0,0,0,0,0,-1438170899,314481292,614.2164209,1407460078,140746007.8,1,4927,215,102,102,0,102,4927,0,102,17.11242604,0.49704142,0.49704142,96855.05917,87.1183432,1.100591716,99941.61538,0.969148319,0.000868848,1.20058E-05,0,0.020702253,25,16
D:0| T0: 0.17| T1: 48.00| R0: 0.0| R1: 0.0| WTP: 0,0,0.173076923,48,0,0,0,0,0,-1491858231,1178568022,30.12067847,1490352197,149035219.7,1,312,15,5,5,0,5,312,0,5,0.978378378,0,0,99803.43784,8.740540541,0.027027027,99996.95676,0.998068409,8.91422E-05,5.37645E-07,0,0.01607717,26,17
D:0| T0: 0.17| T1: 48.00| R0: 0.0| R1: 0.0| WTP: 0,0,0.173076923,48,0,0,0,0,0,-1906711473,2029998696,11746.56513,1319383216,131938321.6,1,95757,4310,471,1951,1480,471,95757,1480,1951,338.5,2.917721519,12.23417722,34133.97468,2047.259494,15.20253165,98787.36076,0.343134047,0.020521127,0.000153792,0.758585341,0.02037449,23,14
D:0| T0: 0.17| T1: 48.00| R0: 0.0| R1: 0.0| WTP: 0,0,0.173076923,48,0,0,0,0,0,-2792176117,776062361,10592.82938,2262534648,226253464.8,1,78227,3339,743,1760,1017,743,78227,1017,1760,168.219917,2.987551867,7.157676349,45972.9751,2014.377593,10.2406639,98885.53527,0.463070186,0.020230734,0.00010437,0.577840909,0.022498626,34,25
D:0| T0: 0.17| T1: 48.00| R0: 0.0| R1: 0.0| WTP: 0,0,0.173076923,48,0,0,0,0,0,-1494647557,1813046880,78.28705192,1490733204,149073320.4,1,566,31,13,13,0,13,566,0,13,2.232044199,0.022099448,0.022099448,99628.38674,18.9558011,0.093922652,99992.45856,0.996365391,0.000191001,1.42865E-06,0,0.022968198,26,17
D:0| T0: 0.17| T1: 48.00| R0: 0.0| R1: 0.0| WTP: 0,0,0.173076923,48,0,0,0,0,0,-1432585441,2032407216,2029.219858,1331124449,133112444.9,1,17270,787,311,337,26,311,17270,26,337,56.13333333,1.757575758,1.903030303,89330.33939,364.8,3.793939394,99814.11515,0.894983692,0.003633692,3.90999E-05,0.077151335,0.019513607,24,15
D:0| T0: 0.17| T1: 48.00| R0: 0.0| R1: 0.0| WTP: 0,0,0.173076923,48,0,0,0,0,0,-789830023.7,1507873352,18.03885983,788928080.7,78892808.07,1,53,5,3,3,0,3,53,0,3,0.346153846,0,0,99969.92308,3.353846154,0.023076923,99999.23846,0.999708164,3.52674E-05,4.5802E-07,0,0.056603774,18,9
D:0| T0: 0.17| T1: 48.00| R0: 0.0| R1: 0.0| WTP: 0,0,0.173076923,48,0,0,0,0,0,-968754026.9,1855899401,78.28915632,964839569,96483956.9,1,825,38,13,13,0,13,825,0,13,2.927536232,0.036231884,0.036231884,99516.06522,21.85507246,0.115942029,99992.72464,0.995239322,0.000219585,1.87061E-06,0,0.015757576,20,11
D:0| T0: 0.17| T1: 48.00| R0: 0.0| R1: 0.0| WTP: 0,0,0.173076923,48,0,0,0,0,0,-2279444171,1819459251,7663.077644,1896290289,189629028.9,1,60030,2612,568,1273,705,568,60030,705,1273,154.3495146,2.669902913,6.04368932,58086.92233,1047.548544,8.82038835,99174.00971,0.584913616,0.010488404,8.9509E-05,0.553809898,0.021206064,30,21
D:0| T0: 0.17| T1: 48.00| R0: 0.0| R1: 0.0| WTP: 0,0,0.173076923,48,0,0,0,0,0,-879717430.9,909791748,48.30141192,877302360.3,87730236.03,1,712,35,8,8,0,8,712,0,8,3.715384615,0.023076923,0.023076923,99597.11538,18.2,0.092307692,99996.43846,0.996011817,0.000183516,1.22141E-06,0,0.011235955,19,10
D:0| T0: 0.17| T1: 48.00| R0: 0.0| R1: 0.0| WTP: 0,0,0.173076923,48,0,0,0,0,0,-2768908769,1339092841,5566.990827,2490559227,249055922.7,1,38479,1611,616,925,309,616,38479,309,925,79.49027237,2.284046693,3.455252918,72084.45136,538.9610895,5.859922179,99363.0856,0.725226854,0.005394489,6.00101E-05,0.334054054,0.024039711,37,28
D:0| T0: 0.17| T1: 48.00| R0: 0.0| R1: 0.0| WTP: 0,0,0.173076923,48,0,0,0,0,0,-2030729947,1365866345,12461.40314,1407659790,140765979,1,97538,4342,473,2070,1597,473,97538,1597,2070,323.5361446,2.777108434,12.3313253,30129.07229,1838.403614,15.18674699,98646.18072,0.303029949,0.018449069,0.000153835,0.771497585,0.021222498,24,15
D:0| T0: 0.17| T1: 48.00| R0: 0.0| R1: 0.0| WTP: 0,0,0.173076923,48,0,0,0,0,0,-3654810209,825453433,4040.957975,3452762310,345276231,1,34920,1594,605,671,66,605,34920,66,671,58.54626866,1.650746269,1.83880597,73727.01791,531.0716418,3.662686567,99523.34925,0.740728272,0.005313382,3.81037E-05,0.098360656,0.019215349,48,39
D:0| T0: 0.17| T1: 48.00| R0: 0.0| R1: 0.0| WTP: 0,0,0.173076923,48,0,0,0,0,0,-1951386180,939711378,12599.97694,1321387333,132138733.3,1,97565,4337,449,2093,1644,449,97565,1644,2093,352.1225806,2.806451613,13.36129032,32566.96774,2472.883871,16.23870968,98693.54839,0.327314107,0.024802877,0.000164638,0.785475394,0.021452365,23,14
D:0| T0: 0.17| T1: 48.00| R0: 0.0| R1: 0.0| WTP: 0,0,0.173076923,48,0,0,0,0,0,-3260378681,638950699,1835.991689,3168579096,316857909.6,1,13634,617,305,305,0,305,13634,0,305,23.7275641,0.836538462,0.836538462,90128.5,273.8685897,1.814102564,99790.58333,0.903214974,0.00273645,1.95179E-05,0,0.022370544,45,36
D:0| T0: 0.17| T1: 48.00| R0: 0.0| R1: 0.0| WTP: 0,0,0.173076923,48,0,0,0,0,0,-1898766432,938699148,1005.479527,1848492455,184849245.5,1,7893,374,167,167,0,167,7893,0,167,21.25358852,0.669856459,0.669856459,94570.48804,126.861244,1.473684211,99894.5311,0.946752186,0.001265693,1.59175E-05,0,0.021157988,30,21
D:0| T0: 0.17| T1: 48.00| R0: 0.0| R1: 0.0| WTP: 0,0,0.173076923,48,0,0,0,0,0,-1841682443,121790188,18.05415653,1840779735,184077973.5,1,194,10,3,3,0,3,194,0,3,0.349056604,0,0,99886.26415,7.735849057,0.014150943,99998.73585,0.998877489,7.92026E-05,2.81693E-07,0,0.015463918,30,21
D:0| T0: 0.17| T1: 48.00| R0: 0.0| R1: 0.0| WTP: 0,0,0.173076923,48,0,0,0,0,0,-2726625721,1331335240,9325.005643,2260375439,226037543.9,1,73333,3203,757,1549,792,757,73333,792,1549,168.8675214,3.115384615,6.444444444,48747.92735,2061.089744,9.670940171,99013.54274,0.491023269,0.020674628,9.89128E-05,0.511297611,0.021122823,34,25
D:0| T0: 0.17| T1: 48.00| R0: 0.0| R1: 0.0| WTP: 0,0,0.173076923,48,0,0,0,0,0,-2163737738,470935411,13362.35035,1495620221,149562022.1,1,98775,4173,475,2220,1745,475,98775,1745,2220,312.5,2.697674419,12.81395349,24473.4186,1485.94186,15.54651163,98426.86628,0.246574405,0.014924275,0.000157498,0.786036036,0.022475323,25,16
D:0| T0: 0.17| T1: 48.00| R0: 0.0| R1: 0.0| WTP: 0,0,0.173076923,48,0,0,0,0,0,-3662653760,823434397,1215.788759,3601864323,360186432.3,1,9041,400,202,202,0,202,9041,0,202,13.21264368,0.471264368,0.471264368,93169.73851,131.9195402,1.054597701,99854.81609,0.933094389,0.001319084,1.15873E-05,0,0.022342661,50,41
D:0| T0: 0.17| T1: 48.00| R0: 0.0| R1: 0.0| WTP: 0,0,0.173076923,48,0,0,0,0,0,-1147243496,493045351,132.4932633,1140618833,114061883.3,1,1358,62,22,22,0,22,1358,0,22,4.570469799,0.073825503,0.073825503,99178.87919,23.2147651,0.228187919,99988.9396,0.991908714,0.000233087,2.93363E-06,0,0.016212233,22,13
D:0| T0: 0.17| T1: 48.00| R0: 0.0| R1: 0.0| WTP: 0,0,0.173076923,48,0,0,0,0,0,-4791103154,1700216563,9960.999647,4293053172,429305317.2,2,86919,4045,921,1654,733,921,86919,733,1654,77.403125,1.3171875,2.4421875,76454.84531,732.3484375,3.88125,99577.28438,0.765504967,0.007373822,4.0495E-05,0.443168077,0.019029211,92,48
D:0| T0: 0.17| T1: 48.00| R0: 0.0| R1: 0.0| WTP: 0,0,0.173076923,48,0,0,0,0,0,-1699750614,1744119059,3565.528496,1521474189,152147418.9,1,31573,1438,445,592,147,445,31573,147,592,99.06043956,2.307692308,3.093406593,79206.44505,480.7417582,5.543956044,99645.01648,0.794821436,0.004795986,5.68324E-05,0.248310811,0.018750198,26,17
D:0| T0: 0.17| T1: 48.00| R0: 0.0| R1: 0.0| WTP: 0,0,0.173076923,48,0,0,0,0,0,-2637402637,2036906360,138.4339748,2630480938,263048093.8,1,937,44,23,23,0,23,937,0,23,2.098540146,0.025547445,0.025547445,99364.10219,24.20437956,0.105839416,99985.16788,0.993795662,0.000243338,1.67291E-06,0,0.024546425,39,30
D:0| T0: 0.17| T1: 48.00| R0: 0.0| R1: 0.0| WTP: 0,0,0.173076923,48,0,0,0,0,0,-2984409255,809704121,1583.620931,2905228209,290522820.9,1,12835,557,263,263,0,263,12835,0,263,24.24252492,0.704318937,0.704318937,91370.31894,221.2724252,1.604651163,99831.9402,0.915263963,0.002210643,1.74397E-05,0,0.020490845,42,33
D:0| T0: 0.17| T1: 48.00| R0: 0.0| R1: 0.0| WTP: 0,0,0.173076923,48,0,0,0,0,0,-2784244625,1219866412,8689.013898,2349793930,234979393,1,72235,3207,716,1443,727,716,72235,727,1443,168.6735537,2.851239669,5.82231405,47027.10744,2452.42562,8.79338843,99033.02066,0.473864652,0.024589884,8.9506E-05,0.503811504,0.019976466,35,26
D:0| T0: 0.17| T1: 48.00| R0: 0.0| R1: 0.0| WTP: 0,0,0.173076923,48,0,0,0,0,0,-880548875.2,843498920,72.19973601,876938888.4,87693888.84,1,647,29,12,12,0,12,647,0,12,1.92481203,0.015037594,0.015037594,99623.25564,22.4887218,0.127819549,99993.54887,0.996302547,0.000225537,1.79114E-06,0,0.018547141,19,10
D:0| T0: 0.17| T1: 48.00| R0: 0.0| R1: 0.0| WTP: 0,0,0.173076923,48,0,0,0,0,0,-2524679514,107351963,1245.829185,2462388055,246238805.5,1,8161,347,207,207,0,207,8161,0,207,17.71705426,0.689922481,0.689922481,94185.12791,220.0503876,1.457364341,99867.32171,0.94314445,0.002196296,1.60006E-05,0,0.025364539,37,28
D:0| T0: 0.17| T1: 48.00| R0: 0.0| R1: 0.0| WTP: 0,0,0.173076923,48,0,0,0,0,0,-3041632502,773789021,1077.470422,2987758981,298775898.1,1,8544,375,179,179,0,179,8544,0,179,14.62837838,0.456081081,0.456081081,94020.33108,198.3277027,1.087837838,99885.50338,0.941317545,0.001980593,1.20644E-05,0,0.020950375,43,34
D:0| T0: 0.17| T1: 48.00| R0: 0.0| R1: 0.0| WTP: 0,0,0.173076923,48,0,0,0,0,0,-3189235663,850936611,2166.299289,3080920698,308092069.8,1,15098,619,353,360,7,353,15098,7,360,23.84590164,1,1.019672131,88922.51475,261.6196721,2.213114754,99749.76393,0.891492083,0.002614122,2.33417E-05,0.019444444,0.023844218,44,35
D:0| T0: 0.17| T1: 48.00| R0: 0.0| R1: 0.0| WTP: 0,0,0.173076923,48,0,0,0,0,0,-2208661717,1701318364,6440.879931,1886617720,188661772,1,48546,2066,593,1070,477,593,48546,477,1070,128.1617647,2.799019608,5.098039216,66123.78431,1013.656863,8.014705882,99316.60294,0.665356634,0.010138231,8.15597E-05,0.445794393,0.022040951,30,21
D:0| T0: 0.17| T1: 48.00| R0: 0.0| R1: 0.0| WTP: 0,0,0.173076923,48,0,0,0,0,0,-1140198407,778708269,12.05544501,1139595635,113959563.5,1,160,9,2,2,0,2,160,0,2,0.577181208,0,0,99907.56376,7.577181208,0.013422819,99999.52349,0.999082926,7.74669E-05,2.66668E-07,0,0.012578616,22,13
D:0| T0: 0.17| T1: 48.00| R0: 0.0| R1: 0.0| WTP: 0,0,0.173076923,48,0,0,0,0,0,-1581914065,1391938506,1619.063448,1500960893,150096089.3,1,12213,490,265,269,4,265,12213,4,269,34.41242938,1.322033898,1.333333333,91991.17514,246.559322,2.870056497,99838.23164,0.921450195,0.002457106,3.00386E-05,0.014869888,0.02202571,26,17
D:0| T0: 0.17| T1: 48.00| R0: 0.0| R1: 0.0| WTP: 0,0,0.173076923,48,0,0,0,0,0,-966359998.7,43418681,36.15789548,964552103.9,96455210.39,1,448,22,6,6,0,6,448,0,6,1.766423358,0,0,99738.22628,18.38686131,0.04379562,99996.93431,0.997417343,0.000185078,8.69587E-07,0,0.013392857,20,11
D:0| T0: 0.17| T1: 48.00| R0: 0.0| R1: 0.0| WTP: 0,0,0.173076923,48,0,0,0,0,0,-2757534997,817384966,13042.80165,2105394915,210539491.5,1,97822,4117,441,2167,1726,441,97822,1726,2167,235.1506849,1.96803653,9.808219178,20561.99087,1216.515982,11.82648402,98330.76712,0.207488953,0.012227703,0.000119801,0.796492847,0.022152481,32,23
D:0| T0: 0.17| T1: 48.00| R0: 0.0| R1: 0.0| WTP: 0,0,0.173076923,48,0,0,0,0,0,-1933910598,762053968,12269.39796,1320440700,132044070,1,95458,4290,497,2038,1541,497,95458,1541,2038,339.6918239,3.062893082,12.68553459,32651.35849,1878.163522,15.80503145,98698.81761,0.328496954,0.018836603,0.000160036,0.756133464,0.021349704,23,14
D:0| T0: 0.17| T1: 48.00| R0: 0.0| R1: 0.0| WTP: 0,0,0.173076923,48,0,0,0,0,0,-2580493242,1692506311,638.7625143,2548555116,254855511.6,1,6143,287,106,106,0,106,6143,0,106,14.67041199,0.288389513,0.288389513,95765.45318,154.3146067,0.685393258,99933.11236,0.958329567,0.001540373,7.9145E-06,0,0.017255413,38,29
D:0| T0: 0.17| T1: 48.00| R0: 0.0| R1: 0.0| WTP: 0,0,0.173076923,48,0,0,0,0,0,-615459852.2,1037620300,36.0634779,613656678.3,61365667.83,1,189,3,6,6,0,6,189,0,6,0.5625,0,0,99899.99107,6.258928571,0.0625,99997.875,0.999023061,6.41604E-05,1.06197E-06,0,0.031746032,16,7
D:0| T0: 0.17| T1: 48.00| R0: 0.0| R1: 0.0| WTP: 0,0,0.173076923,48,0,0,0,0,0,-1528169582,301400999,656.3266049,1495353251,149535325.1,1,5263,243,109,109,0,109,5263,0,109,16.64835165,0.467032967,0.467032967,96524.47802,120.7802198,1.054945055,99935.81319,0.965902233,0.001204021,1.19188E-05,0,0.020710621,26,17
D:0| T0: 0.17| T1: 48.00| R0: 0.0| R1: 0.0| WTP: 0,0,0.173076923,48,0,0,0,0,0,-2510059671,1868336855,8579.025629,2081108389,208110838.9,1,67252,2898,610,1425,815,610,67252,815,1425,171.0182648,2.689497717,6.365296804,52262.28311,1195.570776,9.155251142,99064.35616,0.526522568,0.011982025,9.31687E-05,0.571929825,0.021188961,32,23
D:0| T0: 0.17| T1: 48.00| R0: 0.0| R1: 0.0| WTP: 0,0,0.173076923,48,0,0,0,0,0,-2224097217,1868498144,8223.015062,1812946464,181294646.4,1,62583,2729,635,1366,731,635,62583,731,1366,168.8325123,3.019704433,6.581280788,57170.52709,1278.660099,9.684729064,99143.84236,0.575684899,0.012807541,9.877E-05,0.535139092,0.021827014,29,20
D:0| T0: 0.17| T1: 48.00| R0: 0.0| R1: 0.0| WTP: 0,0,0.173076923,48,0,0,0,0,0,-1851510385,2101566889,192.5684389,1841881963,184188196.3,1,1307,54,32,32,0,32,1307,0,32,3.470588235,0.078431373,0.078431373,99127.97059,35.24019608,0.230392157,99980.40686,0.991485172,0.000352835,3.12242E-06,0,0.02448355,30,21
D:0| T0: 0.17| T1: 48.00| R0: 0.0| R1: 0.0| WTP: 0,0,0.173076923,48,0,0,0,0,0,-1968416855,1665097450,13001.34028,1318349841,131834984.1,1,98303,4245,438,2160,1722,438,98303,1722,2160,335.0573248,2.732484076,13.63694268,28653.10191,2147.821656,16.41401274,98558.82803,0.28833457,0.021555904,0.000166186,0.797222222,0.02197288,23,14
D:0| T0: 0.17| T1: 48.00| R0: 0.0| R1: 0.0| WTP: 0,0,0.173076923,48,0,0,0,0,0,-1883626195,1716179948,11242.80387,1321486001,132148600.1,1,98040,4376,478,1867,1389,478,98040,1389,1867,349.6815287,2.98089172,11.75159236,31126.16561,2151.77707,14.78343949,98819.96815,0.312876334,0.021562003,0.000149784,0.74397429,0.019043248,23,14
D:0| T0: 0.17| T1: 48.00| R0: 0.0| R1: 0.0| WTP: 0,0,0.173076923,48,0,0,0,0,0,-1161076997,1560278715,391.0284409,1141525574,114152557.4,1,2287,99,65,65,0,65,2287,0,65,7.272151899,0.284810127,0.284810127,98698.41139,47.56962025,0.696202532,99967.28481,0.987315533,0.000475487,8.17863E-06,0,0.028421513,22,13
D:0| T0: 0.17| T1: 48.00| R0: 0.0| R1: 0.0| WTP: 0,0,0.173076923,48,0,0,0,0,0,-2330459506,991019385,10124.37815,1824240598,182424059.8,1,75581,3192,610,1682,1072,610,75581,1072,1682,207.2182741,3.015228426,8.401015228,47832.03046,2275.329949,11.49238579,98948.60914,0.48181966,0.02281456,0.000116747,0.637336504,0.02225427,29,20
D:0| T0: 0.17| T1: 48.00| R0: 0.0| R1: 0.0| WTP: 0,0,0.173076923,48,0,0,0,0,0,-4037186478,118052103,6171.18416,3728627270,372862727,1,49165,2143,914,1025,111,914,49165,111,1025,74.81512605,2.420168067,2.714285714,64806.01681,695.5378151,5.263305322,99303.16246,0.652145278,0.006972472,5.44395E-05,0.108292683,0.020848164,51,42
D:0| T0: 0.17| T1: 48.00| R0: 0.0| R1: 0.0| WTP: 0,0,0.173076923,48,0,0,0,0,0,-2018243144,1209758844,12487.00953,1393892667,139389266.7,1,88204,3609,528,2075,1547,528,88204,1547,2075,273.9515152,3.139393939,12.44848485,40211.76364,1568.357576,15.62424242,98708.38788,0.404832705,0.015744512,0.000158423,0.745542169,0.02352501,24,15
D:0| T0: 0.17| T1: 48.00| R0: 0.0| R1: 0.0| WTP: 0,0,0.173076923,48,0,0,0,0,0,-971295411.4,70671723,132.287538,964681034.5,96468103.45,1,879,37,22,22,0,22,879,0,22,2.096296296,0.096296296,0.096296296,99502.6,40.9037037,0.251851852,99989.91111,0.995132145,0.000408641,3.23562E-06,0,0.025028441,20,11
D:0| T0: 0.17| T1: 48.00| R0: 0.0| R1: 0.0| WTP: 0,0,0.173076923,48,0,0,0,0,0,-615724590.1,1722612191,42.05585974,613621797.1,61362179.71,1,154,7,7,7,0,7,154,0,7,0.339130435,0,0,99925.90435,6.269565217,0.069565217,99997.8,0.999282038,6.45706E-05,1.20693E-06,0,0.045454545,16,7
D:0| T0: 0.17| T1: 48.00| R0: 0.0| R1: 0.0| WTP: 0,0,0.173076923,48,0,0,0,0,0,-2019662922,1968291596,60.27458221,2016649193,201664919.3,1,480,31,10,10,0,10,480,0,10,1.887892377,0.004484305,0.004484305,99687.01794,8.713004484,0.049327354,99995.69507,0.99691812,8.91993E-05,8.92897E-07,0,0.020833333,32,23
D:0| T0: 0.17| T1: 48.00| R0: 0.0| R1: 0.0| WTP: 0,0,0.173076923,48,0,0,0,0,0,-2081251979,1877569084,13494.00386,1406551787,140655178.7,1,98396,4145,476,2242,1766,476,98396,1766,2242,326.0802469,2.895061728,13.75308642,28298.09259,1940.851852,16.66666667,98508.96296,0.284748422,0.019488655,0.000168597,0.787689563,0.022785479,24,15
D:0| T0: 0.17| T1: 48.00| R0: 0.0| R1: 0.0| WTP: 0,0,0.173076923,48,0,0,0,0,0,-2068572054,1726322189,13306.75095,1403234506,140323450.6,1,96304,4112,524,2211,1687,524,96304,1687,2211,307.5030303,3.109090909,13.26060606,31480.65455,1982.472727,16.44848485,98571.98788,0.316751669,0.019905308,0.000166567,0.763003166,0.022958548,24,15
D:0| T0: 0.17| T1: 48.00| R0: 0.0| R1: 0.0| WTP: 0,0,0.173076923,48,0,0,0,0,0,-1886903744,307848836,11497.9627,1312005608,131200560.8,1,90240,3972,507,1910,1403,507,90240,1403,1910,304.1552795,3.062111801,11.72049689,39548.54658,1977.285714,14.86956522,98843.35404,0.397740099,0.019823457,0.000150608,0.734554974,0.02116578,23,14
D:0| T0: 0.17| T1: 48.00| R0: 0.0| R1: 0.0| WTP: 0,0,0.173076923,48,0,0,0,0,0,-1835977801,1154000220,12035.59302,1234198150,123419815,1,98939,4480,439,1999,1560,439,98939,1560,1999,356.8766234,2.753246753,12.83766234,25431.02597,1673.532468,15.72077922,98620.52597,0.256197708,0.016774105,0.000158844,0.780390195,0.020204368,22,13
D:0| T0: 0.17| T1: 48.00| R0: 0.0| R1: 0.0| WTP: 0,0,0.173076923,48,0,0,0,0,0,-1848893629,2028661055,150.3633374,1841375462,184137546.2,1,905,37,25,25,0,25,905,0,25,2,0.048780488,0.048780488,99380.10732,23.08292683,0.165853659,99985.20976,0.993956921,0.000232011,2.42747E-06,0,0.027624309,30,21
D:0| T0: 0.17| T1: 48.00| R0: 0.0| R1: 0.0| WTP: 0,0,0.173076923,48,0,0,0,0,0,-4210966607,1629114640,3041.61747,4058885734,405888573.4,1,25435,1217,490,505,15,490,25435,15,505,40.27937337,1.140992167,1.177545692,80126.60836,410.694517,2.462140992,99623.90339,0.804312523,0.004108593,2.59761E-05,0.02970297,0.019854531,55,46
D:0| T0: 0.17| T1: 48.00| R0: 0.0| R1: 0.0| WTP: 0,0,0.173076923,48,0,0,0,0,0,-1964457217,1439048174,12952.84406,1316815014,131681501.4,1,97218,4091,501,2152,1651,501,97218,1651,2152,320.6583851,3.049689441,13.26708075,31550.6646,2571.826087,16.38509317,98626.93789,0.317283489,0.025819004,0.000165513,0.767193309,0.022135818,23,14
D:0| T0: 0.17| T1: 48.00| R0: 0.0| R1: 0.0| WTP: 0,0,0.173076923,48,0,0,0,0,0,-2606194342,865227006,13487.76317,1931806183,193180618.3,1,99171,4141,440,2241,1801,440,99171,1801,2241,253.4975845,2.062801932,10.73429952,18111.4058,1287.507246,12.87439614,98252.28502,0.182903911,0.012941058,0.000130328,0.803659081,0.022597332,30,21
D:0| T0: 0.17| T1: 48.00| R0: 0.0| R1: 0.0| WTP: 0,0,0.173076923,48,0,0,0,0,0,-3541606123,890479738,8194.431474,3131884549,313188454.9,1,65502,2868,855,1361,506,855,65502,506,1361,119.7679739,2.669934641,4.284313725,51526.37582,1528.915033,7.071895425,99057.38889,0.519313149,0.015341459,7.26885E-05,0.372058824,0.020763042,44,35
D:0| T0: 0.17| T1: 48.00| R0: 0.0| R1: 0.0| WTP: 0,0,0.173076923,48,0,0,0,0,0,-1260009283,1017049163,571.924303,1231413068,123141306.8,1,4882,218,95,95,0,95,4882,0,95,15.35220126,0.471698113,0.471698113,97010.84906,111.0251572,1.088050314,99947.66667,0.970643074,0.001106399,1.18804E-05,0,0.019459238,23,14
D:0| T0: 0.17| T1: 48.00| R0: 0.0| R1: 0.0| WTP: 0,0,0.173076923,48,0,0,0,0,0,-1316046176,1707305064,18.14171148,1315139090,131513909,1,304,12,3,3,0,3,304,0,3,1.43902439,0.006097561,0.006097561,99809.40854,9.384146341,0.018292683,99998.14634,0.998116373,9.53351E-05,3.63639E-07,0,0.009868421,24,15
D:0| T0: 0.17| T1: 48.00| R0: 0.0| R1: 0.0| WTP: 0,0,0.173076923,48,0,0,0,0,0,-2256163780,400145663,13458.37785,1583244887,158324488.7,1,99063,4296,416,2236,1820,416,99063,1820,2236,305.3125,2.301136364,12.61363636,21244.23864,1511.471591,14.97727273,98336.77273,0.214354435,0.015179205,0.000151496,0.813953488,0.022571495,26,17
D:0| T0: 0.17| T1: 48.00| R0: 0.0| R1: 0.0| WTP: 0,0,0.173076923,48,0,0,0,0,0,-1146840749,1662654181,120.5449117,1140813503,114081350.3,1,1480,66,20,20,0,20,1480,0,20,5.25974026,0.051948052,0.051948052,99114.72078,38.96753247,0.168831169,99989.98701,0.991256664,0.000389447,2.58088E-06,0,0.013513514,22,13
D:0| T0: 0.17| T1: 48.00| R0: 0.0| R1: 0.0| WTP: 0,0,0.173076923,48,0,0,0,0,0,-2028784179,182136456,12413.50839,1408108760,140810876,1,98235,4374,473,2062,1589,473,98235,1589,2062,333.2037037,2.87037037,12.62345679,28120.00617,2101.364198,15.5308642,98623.17284,0.282984097,0.021080113,0.000157104,0.770611057,0.020990482,24,15
D:0| T0: 0.17| T1: 48.00| R0: 0.0| R1: 0.0| WTP: 0,0,0.173076923,48,0,0,0,0,0,-1403902093,979575387,24.11458233,1402696364,140269636.4,1,290,12,4,4,0,4,290,0,4,1.046783626,0,0,99823.53216,11.45614035,0.023391813,99998.20468,0.99825693,0.000116223,4.65123E-07,0,0.013793103,25,16
D:0| T0: 0.17| T1: 48.00| R0: 0.0| R1: 0.0| WTP: 0,0,0.173076923,48,0,0,0,0,0,-2114530231,2142525414,10984.42846,1565308808,156530880.8,1,81403,3435,588,1825,1237,588,81403,1237,1825,240.7653631,3.201117318,10.05027933,45963.01676,1782.201117,13.33519553,98902.11732,0.462652857,0.017876666,0.000135287,0.677808219,0.022419321,26,17
D:0| T0: 0.17| T1: 48.00| R0: 0.0| R1: 0.0| WTP: 0,0,0.173076923,48,0,0,0,0,0,-3750901039,1464057597,5726.414307,3464580324,346458032.4,1,46331,2043,855,951,96,855,46331,96,951,78.78078078,2.408408408,2.678678679,67203.39339,520.1921922,5.27027027,99360.99099,0.675967907,0.005212507,5.43294E-05,0.100946372,0.0205271,48,39
D:0| T0: 0.17| T1: 48.00| R0: 0.0| R1: 0.0| WTP: 0,0,0.173076923,48,0,0,0,0,0,-2062133212,364562610,11580.68812,1483098806,148309880.6,1,87956,3757,530,1924,1394,530,87956,1394,1924,266.3275862,2.965517241,10.93678161,39138.09195,1709.189655,14,98782.65517,0.394011626,0.017143152,0.000141569,0.724532225,0.021874574,25,16
D:0| T0: 0.17| T1: 48.00| R0: 0.0| R1: 0.0| WTP: 0,0,0.173076923,48,0,0,0,0,0,-2257783547,40350784,10400.98761,1737734166,173773416.6,1,77125,3268,605,1728,1123,605,77125,1123,1728,212.625641,3.01025641,8.717948718,47288.47692,1529.682051,11.81538462,98915.11282,0.476332949,0.015341981,0.000120075,0.649884259,0.022405186,28,19
D:0| T0: 0.17| T1: 48.00| R0: 0.0| R1: 0.0| WTP: 0,0,0.173076923,48,0,0,0,0,0,-2074109977,804064356,9890.023559,1579608799,157960879.9,1,89264,4116,438,1642,1204,438,89264,1204,1642,292.2011173,2.379888268,9.072625698,36867.4581,1444.03352,11.50837989,98925.40223,0.370984933,0.014467612,0.000116487,0.733252132,0.018394874,26,17
D:0| T0: 0.17| T1: 48.00| R0: 0.0| R1: 0.0| WTP: 0,0,0.173076923,48,0,0,0,0,0,-1628227273,2125493986,5507.451387,1352854703,135285470.3,1,39738,1695,465,915,450,465,39738,450,915,129.0059524,2.654761905,5.303571429,74078.57738,742.8690476,8.041666667,99455.19643,0.744512211,0.007417016,8.20256E-05,0.491803279,0.023025819,24,15
D:0| T0: 0.17| T1: 48.00| R0: 0.0| R1: 0.0| WTP: 0,0,0.173076923,48,0,0,0,0,0,-2022145136,23154253,7499.412326,1647174520,164717452,1,69083,3146,519,1245,726,519,69083,726,1245,219.8315217,2.695652174,6.60326087,53171.11413,1000.472826,9.461956522,99223.38043,0.53493693,0.010008325,9.59413E-05,0.58313253,0.0180218,27,18
D:0| T0: 0.17| T1: 48.00| R0: 0.0| R1: 0.0| WTP: 0,0,0.173076923,48,0,0,0,0,0,-2038013103,1391367689,385.2502514,2018750591,201875059.1,1,3102,138,64,64,0,64,3102,0,64,7.206278027,0.170403587,0.170403587,97810.30493,47.04932735,0.452914798,99958.0583,0.97853964,0.000470982,5.71604E-06,0,0.020638504,32,23
D:0| T0: 0.17| T1: 48.00| R0: 0.0| R1: 0.0| WTP: 0,0,0.173076923,48,0,0,0,0,0,-2403329841,574142276,2173.165102,2294671586,229467158.6,1,16719,710,356,361,5,356,16719,5,361,36.45679012,1.304526749,1.325102881,88596.55556,316.4115226,2.794238683,99771.09053,0.888025751,0.003158796,2.94371E-05,0.013850416,0.021593492,35,26
D:0| T0: 0.17| T1: 48.00| R0: 0.0| R1: 0.0| WTP: 0,0,0.173076923,48,0,0,0,0,0,-701611202.7,898736779,6.039854375,701309210,70130921,1,92,4,1,1,0,1,92,0,1,0.578947368,0,0,99953.01754,5.789473684,0.00877193,99999.17544,0.999539648,5.9218E-05,1.73913E-07,0,0.010869565,17,8
D:0| T0: 0.17| T1: 48.00| R0: 0.0| R1: 0.0| WTP: 0,0,0.173076923,48,0,0,0,0,0,-2997621159,346473503,4705.084077,2762366955,276236695.5,1,43699,2075,632,781,149,632,43699,149,781,93.00357143,2.139285714,2.65,68346.65714,891.5892857,4.892857143,99475.89643,0.686883565,0.008918335,5.04839E-05,0.19078105,0.017872263,40,31
D:0| T0: 0.17| T1: 48.00| R0: 0.0| R1: 0.0| WTP: 0,0,0.173076923,48,0,0,0,0,0,-2795541010,445552282,4436.49241,2573716390,257371639,1,33491,1483,592,737,145,592,33491,145,737,66.94776119,2.063432836,2.593283582,76622.03358,719.0186567,4.809701493,99519.27239,0.769761245,0.007190865,4.95886E-05,0.196743555,0.022005912,38,29
D:0| T0: 0.17| T1: 48.00| R0: 0.0| R1: 0.0| WTP: 0,0,0.173076923,48,0,0,0,0,0,-1746013496,911758476,11946.23269,1148701861,114870186.1,1,99146,4479,437,1984,1547,437,99146,1547,1984,396.7676056,2.985915493,13.83098592,27636.58451,1954.535211,16.9084507,98686.9507,0.278200211,0.019581078,0.000170959,0.779737903,0.020010893,21,12
D:0| T0: 0.17| T1: 48.00| R0: 0.0| R1: 0.0| WTP: 0,0,0.173076923,48,0,0,0,0,0,-2141479453,1464197940,11111.20923,1585918992,158591899.2,1,93996,4382,552,1845,1293,552,93996,1293,1845,311.6256983,3.005586592,10.18994413,33594.05028,3063.877095,13.24581006,98820.50279,0.337879763,0.03073005,0.000134389,0.700813008,0.019628495,26,17
D:0| T0: 0.17| T1: 48.00| R0: 0.0| R1: 0.0| WTP: 0,0,0.173076923,48,0,0,0,0,0,-1687163374,500405854,1908.361708,1591745289,159174528.9,1,13849,600,307,317,10,307,13849,10,317,42.3315508,1.465240642,1.524064171,91001.3262,304.6149733,3.160427807,99814.31551,0.911740735,0.003036852,3.32424E-05,0.031545741,0.022894699,27,18
D:0| T0: 0.17| T1: 48.00| R0: 0.0| R1: 0.0| WTP: 0,0,0.173076923,48,0,0,0,0,0,-2004424760,772037341,12110.26047,1398911737,139891173.7,1,92766,3897,464,2012,1548,464,92766,1548,2012,293.5333333,2.739393939,12.06666667,35320.81818,1842.612121,14.87272727,98710.27879,0.355418127,0.018482671,0.000150624,0.769383698,0.021688981,24,15
D:0| T0: 0.17| T1: 48.00| R0: 0.0| R1: 0.0| WTP: 0,0,0.173076923,48,0,0,0,0,0,-967790505.6,1543158763,66.16145856,964482432.7,96448243.27,1,464,23,11,11,0,11,464,0,11,1.379562044,0.02189781,0.02189781,99731.39416,15.99270073,0.102189781,99993.85401,0.997379249,0.000161025,1.59428E-06,0,0.023706897,20,11
D:0| T0: 0.17| T1: 48.00| R0: 0.0| R1: 0.0| WTP: 0,0,0.173076923,48,0,0,0,0,0,-1832721565,1604932531,13782.2358,1143609775,114360977.5,1,98721,4189,442,2290,1848,442,98721,1848,2290,361.6438356,2.938356164,15.55479452,28998.41781,1995.582192,18.5890411,98497.54795,0.291808024,0.020024328,0.000187945,0.8069869,0.023196686,21,12
D:0| T0: 0.17| T1: 48.00| R0: 0.0| R1: 0.0| WTP: 0,0,0.173076923,48,0,0,0,0,0,-2606397423,539051477,10270.38144,2092878350,209287835,1,77413,3439,689,1706,1017,689,77413,1017,1706,202.8027523,3.059633028,7.669724771,45165.97248,2037.399083,10.82568807,98900.74771,0.45512808,0.0204447,0.000110323,0.596131301,0.022037642,32,23
D:0| T0: 0.17| T1: 48.00| R0: 0.0| R1: 0.0| WTP: 0,0,0.173076923,48,0,0,0,0,0,-1235046152,1743124675,144.3604116,1227828131,122782813.1,1,733,30,24,24,0,24,733,0,24,2.662420382,0.057324841,0.057324841,99529.2293,15.29299363,0.21656051,99986.01911,0.99543861,0.000153751,3.03832E-06,0,0.032742156,23,14
D:0| T0: 0.17| T1: 48.00| R0: 0.0| R1: 0.0| WTP: 0,0,0.173076923,48,0,0,0,0,0,-4849921060,1965983789,11214.95934,4289173093,428917309.3,2,87547,3684,1125,1863,738,1125,87547,738,1863,70.50678733,1.539969834,2.631975867,72864.7632,768.5113122,4.331825038,99442.78733,0.730272998,0.007745764,4.54075E-05,0.396135266,0.021279998,95,48
D:0| T0: 0.17| T1: 48.00| R0: 0.0| R1: 0.0| WTP: 0,0,0.173076923,48,0,0,0,0,0,-2320546455,516774280,728.3701541,2284127947,228412794.7,1,5542,243,121,121,0,121,5542,0,121,11.99186992,0.394308943,0.394308943,96125.00407,145.6747967,0.886178862,99922.0935,0.962033873,0.001453907,9.80332E-06,0,0.021833273,35,26
D:0| T0: 0.17| T1: 48.00| R0: 0.0| R1: 0.0| WTP: 0,0,0.173076923,48,0,0,0,0,0,-2296715272,86603142,12497.83911,1671823317,167182331.7,1,98877,4264,422,2076,1654,422,98877,1654,2076,296.4565217,2.239130435,11.19565217,20627.42391,1394.456522,13.48913043,98429.9837,0.20817992,0.013998365,0.000136404,0.79672447,0.020995783,27,18
D:0| T0: 0.17| T1: 48.00| R0: 0.0| R1: 0.0| WTP: 0,0,0.173076923,48,0,0,0,0,0,-965989593.7,1431870609,30.13122792,964483032.3,96448303.23,1,447,16,5,5,0,5,447,0,5,1.467153285,0,0,99737.33577,22.10948905,0.03649635,99997.13139,0.997406558,0.000221746,7.24652E-07,0,0.011185682,20,11
D:0| T0: 0.17| T1: 48.00| R0: 0.0| R1: 0.0| WTP: 0,0,0.173076923,48,0,0,0,0,0,-2561069609,1592383984,4882.931227,2316923047,231692304.7,1,38645,1653,625,811,186,625,38645,186,811,89.30165289,2.462809917,3.20661157,73345.36777,466.8347107,5.785123967,99478.17769,0.73708206,0.00466913,5.9338E-05,0.229346486,0.020985897,35,26
D:0| T0: 0.17| T1: 48.00| R0: 0.0| R1: 0.0| WTP: 0,0,0.173076923,48,0,0,0,0,0,-3345917664,1440183867,1728.954876,3259469920,325946992,1,15407,738,287,287,0,287,15407,0,287,29.37383178,0.791277259,0.791277259,88320.2866,231.3956386,1.647975078,99792.72274,0.885098164,0.002312016,1.7851E-05,0,0.018627896,46,37
D:0| T0: 0.17| T1: 48.00| R0: 0.0| R1: 0.0| WTP: 0,0,0.173076923,48,0,0,0,0,0,-2216600266,1696510588,439.4901935,2194625756,219462575.6,1,4098,171,73,73,0,73,4098,0,73,8.274678112,0.214592275,0.214592275,97230.24893,83.35622318,0.527896996,99953.59657,0.972780595,0.000832626,6.24149E-06,0,0.017813568,34,25
D:0| T0: 0.17| T1: 48.00| R0: 0.0| R1: 0.0| WTP: 0,0,0.173076923,48,0,0,0,0,0,-2298715397,895039877,11046.3651,1746397142,174639714.2,1,84956,3665,584,1835,1251,584,84956,1251,1835,240.5206186,2.93814433,9.319587629,39528.04124,2295.494845,12.31443299,98817.30412,0.398154226,0.02302829,0.000125193,0.681743869,0.021599416,28,19
D:0| T0: 0.17| T1: 48.00| R0: 0.0| R1: 0.0| WTP: 0,0,0.173076923,48,0,0,0,0,0,-3185527409,129565953,2076.479023,3081703458,308170345.8,1,13873,615,345,345,0,345,13873,0,345,25.1516129,0.961290323,0.961290323,90059.8129,316.2645161,2.080645161,99770.82903,0.902692706,0.003159971,2.2224E-05,0,0.024796367,44,35
D:0| T0: 0.17| T1: 48.00| R0: 0.0| R1: 0.0| WTP: 0,0,0.173076923,48,0,0,0,0,0,-1865188265,1902565669,415.5966057,1844408435,184440843.5,1,4219,196,69,69,0,69,4219,0,69,10.41545894,0.256038647,0.256038647,97168.86473,75.99033816,0.574879227,99955.94203,0.972147651,0.000759016,6.63677E-06,0,0.016362343,30,21
D:0| T0: 0.17| T1: 48.00| R0: 0.0| R1: 0.0| WTP: 0,0,0.173076923,48,0,0,0,0,0,-1413891858,1984179288,198.6784526,1403957935,140395793.5,1,1788,69,33,33,0,33,1788,0,33,5.296511628,0.087209302,0.087209302,98850.1686,78.55813953,0.284883721,99982.40116,0.988690847,0.000783459,3.81563E-06,0,0.018456376,25,16
D:0| T0: 0.17| T1: 48.00| R0: 0.0| R1: 0.0| WTP: 0,0,0.173076923,48,0,0,0,0,0,-4140281121,677377223,6489.341867,3815814028,381581402.8,1,49956,2110,976,1078,102,976,49956,102,1078,71.83606557,2.510928962,2.784153005,64807.94536,1110.043716,5.464480874,99282.65301,0.652227704,0.011131759,5.62723E-05,0.094619666,0.02157899,52,43
D:0| T0: 0.17| T1: 48.00| R0: 0.0| R1: 0.0| WTP: 0,0,0.173076923,48,0,0,0,0,0,-4839580977,973583301,10898.58698,4294651628,429465162.8,2,89482,4061,1547,1810,263,1547,89482,263,1810,73.70029674,2.108308605,2.489614243,57586.33531,1075.163205,4.78189911,99163.3724,0.578829761,0.010836167,5.01723E-05,0.145303867,0.020227532,97,48
D:0| T0: 0.17| T1: 48.00| R0: 0.0| R1: 0.0| WTP: 0,0,0.173076923,48,0,0,0,0,0,-2037402907,781062938,1819.595345,1946423140,194642314,1,16669,807,300,302,2,300,16669,2,302,49.28301887,1.254716981,1.264150943,88793.16038,365.2264151,2.693396226,99814.68396,0.889631333,0.003642702,2.83044E-05,0.006622517,0.018117464,31,22
D:0| T0: 0.17| T1: 48.00| R0: 0.0| R1: 0.0| WTP: 0,0,0.173076923,48,0,0,0,0,0,-4878102345,338783425,11602.11453,4297996618,429799661.8,2,93910,4194,1033,1927,894,1033,93910,894,1927,80.20307692,1.441538462,2.801538462,69393.74615,1180.616923,4.386153846,99419.64923,0.694975095,0.011900563,4.58955E-05,0.463933576,0.020519646,93,48
D:0| T0: 0.17| T1: 48.00| R0: 0.0| R1: 0.0| WTP: 0,0,0.173076923,48,0,0,0,0,0,-1496594806,1027579040,114.3679034,1490876411,149087641.1,1,917,39,19,19,0,19,917,0,19,2.531914894,0.053191489,0.053191489,99416.66489,37.12234043,0.154255319,99988.96809,0.994283973,0.000371146,2.01075E-06,0,0.020765027,26,17
D:0| T0: 0.17| T1: 48.00| R0: 0.0| R1: 0.0| WTP: 0,0,0.173076923,48,0,0,0,0,0,-2935803379,764973813,2281.639231,2821721417,282172141.7,1,17440,762,378,379,1,378,17440,1,379,32.72852234,1.151202749,1.151202749,87800.37113,406.7869416,2.457044674,99752.73196,0.880195361,0.004063582,2.59727E-05,0.002638522,0.021731651,41,32
D:0| T0: 0.17| T1: 48.00| R0: 0.0| R1: 0.0| WTP: 0,0,0.173076923,48,0,0,0,0,0,-3436564257,1245753446,4894.419079,3191843304,319184330.4,1,37398,1650,633,813,180,633,37398,180,813,65.80511182,1.926517572,2.495207668,71759.77316,815.9392971,4.485623003,99420.11182,0.721640252,0.008167931,4.6243E-05,0.221402214,0.02173913,45,36
D:0| T0: 0.17| T1: 48.00| R0: 0.0| R1: 0.0| WTP: 0,0,0.173076923,48,0,0,0,0,0,-2115271545,1013177794,3310.063447,1949768372,194976837.2,1,24433,1013,457,550,93,457,24433,93,550,56.13615023,1.981220657,2.408450704,83444.0892,480.6244131,4.577464789,99656.82629,0.837286831,0.004798261,4.71851E-05,0.169090909,0.022510539,31,22
D:0| T0: 0.17| T1: 48.00| R0: 0.0| R1: 0.0| WTP: 0,0,0.173076923,48,0,0,0,0,0,-1668898538,1395089249,54.31437069,1666182819,166618281.9,1,867,37,9,9,0,9,867,0,9,2.642105263,0.010526316,0.010526316,99400.07895,24.06315789,0.052631579,99994.11053,0.994069425,0.000241844,9.42445E-07,0,0.010380623,28,19
D:0| T0: 0.17| T1: 48.00| R0: 0.0| R1: 0.0| WTP: 0,0,0.173076923,48,0,0,0,0,0,-438852878.3,1339545835,12.01008238,438252374.2,43825237.42,1,66,0,2,2,0,2,66,0,2,0,0,0,99962.31579,4.557894737,0.021052632,99998.72632,0.99963791,4.76049E-05,4.16669E-07,0,0.03030303,14,5
D:0| T0: 0.17| T1: 48.00| R0: 0.0| R1: 0.0| WTP: 0,0,0.173076923,48,0,0,0,0,0,-1803808453,219139554,11410.78146,1233269380,123326938,1,95408,4273,467,1895,1428,467,95408,1428,1895,366.147651,3.060402685,12.57718121,32898,1681.52349,15.7114094,98779.59732,0.331041421,0.016848896,0.000158928,0.753562005,0.019862066,22,13
D:0| T0: 0.17| T1: 48.00| R0: 0.0| R1: 0.0| WTP: 0,0,0.173076923,48,0,0,0,0,0,-1428864147,1336508942,451.6680232,1406280746,140628074.6,1,3698,167,75,75,0,75,3698,0,75,13.33727811,0.284023669,0.284023669,97760.78107,87.67455621,0.75739645,99962.23077,0.977996639,0.00087437,8.82671E-06,0,0.020281233,25,16
D:0| T0: 0.17| T1: 48.00| R0: 0.0| R1: 0.0| WTP: 0,0,0.173076923,48,0,0,0,0,0,-703999557.1,448559423,54.07595311,701295759.4,70129575.94,1,162,4,9,9,0,9,162,0,9,0.434782609,0.017391304,0.017391304,99910.31304,10.29565217,0.095652174,99997.29565,0.999132373,0.000104226,1.55178E-06,0,0.055555556,17,8
D:0| T0: 0.17| T1: 48.00| R0: 0.0| R1: 0.0| WTP: 0,0,0.173076923,48,0,0,0,0,0,-2341667252,2110028840,1089.701955,2287182154,228718215.4,1,8531,384,181,181,0,181,8531,0,181,19.525,0.629166667,0.629166667,94033.29583,172.9458333,1.3875,99883.17917,0.941479057,0.001726289,1.50339E-05,0,0.021216739,35,26
D:0| T0: 0.17| T1: 48.00| R0: 0.0| R1: 0.0| WTP: 0,0,0.173076923,48,0,0,0,0,0,-4934967369,1982030155,12879.03962,4291015388,429101538.8,2,90799,3819,1071,2140,1069,1071,90799,1069,2140,73.82581649,1.553654743,3.194401244,72951.13997,937.9502333,4.858475894,99400.7916,0.731025582,0.009465219,5.03741E-05,0.49953271,0.023568542,92,48
D:0| T0: 0.17| T1: 48.00| R0: 0.0| R1: 0.0| WTP: 0,0,0.173076923,48,0,0,0,0,0,-3350850333,696219407,3419.17834,3179891416,317989141.6,1,24467,1065,549,568,19,549,24467,19,568,43.66031746,1.571428571,1.628571429,82573.48254,257.3142857,3.393650794,99612.49206,0.828903879,0.002574202,3.54476E-05,0.033450704,0.023214943,45,36
D:0| T0: 0.17| T1: 48.00| R0: 0.0| R1: 0.0| WTP: 0,0,0.173076923,48,0,0,0,0,0,-1990826146,1402539442,10104.21028,1485615632,148561563.2,1,84628,3787,549,1678,1129,549,84628,1129,1678,283.7705882,3.147058824,9.741176471,44141.80588,2280.270588,12.94117647,99002.20588,0.443936197,0.022846769,0.000131338,0.672824791,0.019827953,25,16
D:0| T0: 0.17| T1: 48.00| R0: 0.0| R1: 0.0| WTP: 0,0,0.173076923,48,0,0,0,0,0,-2170138711,1319833493,10276.86929,1656295247,165629524.7,1,82058,3679,610,1707,1097,610,82058,1097,1707,240.6914894,3.159574468,8.95212766,43550.01596,2947.164894,12.18085106,98943.32447,0.438413347,0.029552063,0.000123649,0.64264792,0.020802359,27,18
D:0| T0: 0.17| T1: 48.00| R0: 0.0| R1: 0.0| WTP: 0,0,0.173076923,48,0,0,0,0,0,-1885052194,663608076,788.3451044,1845634939,184563493.9,1,5676,235,131,131,0,131,5676,0,131,13.57560976,0.502439024,0.502439024,96326.76585,165.702439,1.107317073,99923.73171,0.964032521,0.00165234,1.27265E-05,0,0.023079634,30,21
D:0| T0: 0.17| T1: 48.00| R0: 0.0| R1: 0.0| WTP: 0,0,0.173076923,48,0,0,0,0,0,-2020178004,414696500,72.25827997,2016565090,201656509,1,570,30,12,12,0,12,570,0,12,1.613333333,0.013333333,0.013333333,99633.01333,15.64444444,0.062222222,99993.08889,0.996404208,0.000158106,1.062E-06,0,0.021052632,32,23
D:0| T0: 0.17| T1: 48.00| R0: 0.0| R1: 0.0| WTP: 0,0,0.173076923,48,0,0,0,0,0,-1235681494,1249738535,150.4741011,1228157789,122815778.9,1,990,45,25,25,0,25,990,0,25,3.826086957,0.068322981,0.068322981,99391.55901,24.61490683,0.211180124,99987.7205,0.994045566,0.000246872,3.08678E-06,0,0.025252525,23,14
D:0| T0: 0.17| T1: 48.00| R0: 0.0| R1: 0.0| WTP: 0,0,0.173076923,48,0,0,0,0,0,-2025637172,614415382,168.55095,2017209625,201720962.5,1,1515,57,28,28,0,28,1515,0,28,3.399082569,0.041284404,0.041284404,99080.43119,44.09174312,0.174311927,99984.91284,0.990961812,0.000441702,2.55742E-06,0,0.018481848,32,23
D:0| T0: 0.17| T1: 48.00| R0: 0.0| R1: 0.0| WTP: 0,0,0.173076923,48,0,0,0,0,0,-1667325705,524899953,30.17289825,1665817060,166581706,1,480,28,5,5,0,5,480,0,5,1.458333333,0,0,99673.375,14.23958333,0.026041667,99996.66146,0.996772967,0.00014389,5.18145E-07,0,0.010438413,28,19
D:0| T0: 0.17| T1: 48.00| R0: 0.0| R1: 0.0| WTP: 0,0,0.173076923,48,0,0,0,0,0,-1868528488,1338977757,12660.58602,1235499187,123549918.7,1,98967,4419,403,2103,1700,403,98967,1700,2103,361.6623377,2.545454545,13.53896104,26152.23377,1689.824675,16.16233766,98549.27273,0.263361216,0.016945494,0.000163349,0.808368997,0.021249507,22,13
D:0| T0: 0.17| T1: 48.00| R0: 0.0| R1: 0.0| WTP: 0,0,0.173076923,48,0,0,0,0,0,-2171611986,341384587,10377.79317,1652722327,165272232.7,1,78975,3373,518,1724,1206,518,78975,1206,1724,230.9679144,2.695187166,9.096256684,43613.90909,1431.032086,11.86631016,98861.60428,0.439601863,0.01434678,0.000120265,0.699535963,0.021829693,27,18
D:0| T0: 0.17| T1: 48.00| R0: 0.0| R1: 0.0| WTP: 0,0,0.173076923,48,0,0,0,0,0,-4885857572,2032000160,11888.3456,4291440292,429144029.2,2,88964,3830,1243,1975,732,1243,88964,732,1975,73.32055215,1.763803681,2.86196319,66089.82975,919.4846626,4.762269939,99280.20399,0.663275805,0.009272035,4.97446E-05,0.370632911,0.022199991,94,48
D:0| T0: 0.17| T1: 48.00| R0: 0.0| R1: 0.0| WTP: 0,0,0.173076923,48,0,0,0,0,0,-2311998142,779488939,9722.511255,1825872580,182587258,1,76020,3316,566,1615,1049,566,76020,1049,1615,207.7821782,2.683168317,7.811881188,47341.05446,1430.034653,10.63861386,98974.18812,0.47678371,0.014336003,0.000108321,0.649535604,0.021244409,29,20
D:0| T0: 0.17| T1: 48.00| R0: 0.0| R1: 0.0| WTP: 0,0,0.173076923,48,0,0,0,0,0,-2403071716,1449019578,643.9927093,2370872080,237087208,1,4312,177,107,107,0,107,4312,0,107,9.519379845,0.290697674,0.290697674,97104.62791,105.1395349,0.724806202,99933.52326,0.971714509,0.001050298,8.26683E-06,0,0.024825986,36,27
D:0| T0: 0.17| T1: 48.00| R0: 0.0| R1: 0.0| WTP: 0,0,0.173076923,48,0,0,0,0,0,-1231066491,351952211,66.26538164,1227753222,122775322.2,1,521,28,11,11,0,11,521,0,11,2.541935484,0.006451613,0.006451613,99682.72903,14.9483871,0.096774194,99994.78065,0.996884685,0.000151096,1.41033E-06,0,0.021113244,23,14
D:0| T0: 0.17| T1: 48.00| R0: 0.0| R1: 0.0| WTP: 0,0,0.173076923,48,0,0,0,0,0,-1493321373,486595046,60.13217012,1490314765,149031476.5,1,385,16,10,10,0,10,385,0,10,0.798969072,0,0,99792.07732,15.70103093,0.051546392,99995.45876,0.997968414,0.000158418,1.02569E-06,0,0.026041667,26,17
D:0| T0: 0.17| T1: 48.00| R0: 0.0| R1: 0.0| WTP: 0,0,0.173076923,48,0,0,0,0,0,-2037782249,296745624,4954.595422,1790052477,179005247.7,1,39226,1736,481,823,342,481,39226,342,823,107.213198,2.294416244,4.005076142,73475.38579,975.6294416,6.446700508,99485.8731,0.738318974,0.00974749,6.6131E-05,0.415552855,0.020980982,29,20
D:0| T0: 0.17| T1: 48.00| R0: 0.0| R1: 0.0| WTP: 0,0,0.173076923,48,0,0,0,0,0,-1689278952,1671484194,409.4919052,1668804357,166880435.7,1,3384,161,68,68,0,68,3384,0,68,10.31606218,0.243523316,0.243523316,97859.04145,89.84974093,0.606217617,99960.7772,0.978995441,0.000896637,7.0126E-06,0,0.020106446,28,19
D:0| T0: 0.17| T1: 48.00| R0: 0.0| R1: 0.0| WTP: 0,0,0.173076923,48,0,0,0,0,0,-2177830809,422157396,11879.18551,1583871533,158387153.3,1,98334,4369,476,1973,1497,476,98334,1497,1973,303.9050279,2.592178771,10.92178771,26113.46927,2049.960894,13.58100559,98631.15642,0.262861855,0.020571472,0.000137384,0.758743031,0.020064271,26,17
D:0| T0: 0.17| T1: 48.00| R0: 0.0| R1: 0.0| WTP: 0,0,0.173076923,48,0,0,0,0,0,-1963423376,1916599091,12816.58979,1322593886,132259388.6,1,98431,4258,447,2129,1682,447,98431,1682,2129,350.1329114,2.753164557,13.34810127,27640.51899,2168.949367,16.1835443,98569.12025,0.278220405,0.021755487,0.000163717,0.790042273,0.021629365,23,14
D:0| T0: 0.17| T1: 48.00| R0: 0.0| R1: 0.0| WTP: 0,0,0.173076923,48,0,0,0,0,0,-1846254200,1005953941,12216.23243,1235442578,123544257.8,1,98342,4312,495,2029,1534,495,98342,1534,2029,368.8013245,3.225165563,13.32450331,30384.56954,2637.046358,16.58940397,98711.46358,0.305556772,0.026435801,0.000167715,0.756037457,0.02063208,22,13
D:0| T0: 0.17| T1: 48.00| R0: 0.0| R1: 0.0| WTP: 0,0,0.173076923,48,0,0,0,0,0,-1922051942,1422765615,12241.99292,1309952296,130995229.6,1,88872,3789,548,2034,1486,548,88872,1486,2034,297.05,3.31875,12.5375,40028.55,1926.55,16.00625,98767.19375,0.402835345,0.019329845,0.000161992,0.730580138,0.022886849,23,14
D:0| T0: 0.17| T1: 48.00| R0: 0.0| R1: 0.0| WTP: 0,0,0.173076923,48,0,0,0,0,0,-1141173493,699740192,30.09482132,1139668752,113966875.2,1,339,16,5,5,0,5,339,0,5,0.805194805,0.012987013,0.012987013,99795.20779,13.00649351,0.045454545,99997.74026,0.997978703,0.000131615,6.45172E-07,0,0.014749263,22,13
D:0| T0: 0.17| T1: 48.00| R0: 0.0| R1: 0.0| WTP: 0,0,0.173076923,48,0,0,0,0,0,-877077009.2,240885764,6.0931291,876772352.8,87677235.28,1,99,9,1,1,0,1,99,0,1,1.3046875,0,0,99939.54688,3.9609375,0.0078125,99999.63281,0.999401857,4.1628E-05,1.55039E-07,0,0.01010101,19,10
D:0| T0: 0.17| T1: 48.00| R0: 0.0| R1: 0.0| WTP: 0,0,0.173076923,48,0,0,0,0,0,-1751226524,2023806564,7473.239389,1377564554,137756455.4,1,64820,2923,579,1241,662,579,64820,662,1241,217.0898204,3.335329341,7.251497006,57969.91018,1628.628743,10.71856287,99283.88024,0.582960091,0.016284955,0.000109006,0.533440774,0.019145326,24,15
D:0| T0: 0.17| T1: 48.00| R0: 0.0| R1: 0.0| WTP: 0,0,0.173076923,48,0,0,0,0,0,-1409573787,1907493879,132.2933622,1402959119,140295911.9,1,938,34,22,22,0,22,938,0,22,1.761363636,0.051136364,0.051136364,99451.4375,32.5625,0.176136364,99987.76705,0.994641665,0.000326367,2.48613E-06,0,0.023454158,25,16
D:0| T0: 0.17| T1: 48.00| R0: 0.0| R1: 0.0| WTP: 0,0,0.173076923,48,0,0,0,0,0,-4882201472,1565815291,11834.01734,4290500605,429050060.5,2,89792,3796,1339,1966,627,1339,89792,627,1966,70.8003003,1.846846847,2.768768769,64012.55856,1081.831832,4.768768769,99253.52252,0.642482913,0.010909606,5.00175E-05,0.318921668,0.021895046,96,48
D:0| T0: 0.17| T1: 48.00| R0: 0.0| R1: 0.0| WTP: 0,0,0.173076923,48,0,0,0,0,0,-1772682733,784442364,343.1211169,1755526677,175552667.7,1,2611,121,57,57,0,57,2611,0,57,7.09223301,0.145631068,0.145631068,98276.67476,65.99029126,0.412621359,99967.82039,0.983102311,0.000659235,5.50875E-06,0,0.021830716,29,20
D:0| T0: 0.17| T1: 48.00| R0: 0.0| R1: 0.0| WTP: 0,0,0.173076923,48,0,0,0,0,0,-2026022510,206369745,9224.662745,1564789373,156478937.3,1,76953,3443,550,1532,982,550,76953,982,1532,238.8176796,2.928176796,8.303867403,48480.9116,1774.883978,11.3480663,99067.62431,0.487857087,0.017778876,0.00011528,0.640992167,0.019908256,26,17
D:0| T0: 0.17| T1: 48.00| R0: 0.0| R1: 0.0| WTP: 0,0,0.173076923,48,0,0,0,0,0,-2169931348,2087235992,11811.70151,1579346272,157934627.2,1,94449,4081,555,1962,1407,555,94449,1407,1962,284.9779006,2.983425414,10.68508287,32573.52486,2271.955801,13.75138122,98736.20994,0.327710743,0.022793562,0.00013965,0.717125382,0.020773116,26,17
D:0| T0: 0.17| T1: 48.00| R0: 0.0| R1: 0.0| WTP: 0,0,0.173076923,48,0,0,0,0,0,-2413545917,1019092536,795.0901621,2373791409,237379140.9,1,7491,319,132,132,0,132,7491,0,132,16.7983871,0.435483871,0.435483871,94738.0121,168.4798387,0.935483871,99912.95161,0.948251484,0.001681734,1.06092E-05,0,0.017621145,36,27
D:0| T0: 0.17| T1: 48.00| R0: 0.0| R1: 0.0| WTP: 0,0,0.173076923,48,0,0,0,0,0,-3156727701,1885906113,3088.117528,3002321825,300232182.5,1,24403,1024,458,513,55,458,24403,55,513,41.84228188,1.432885906,1.610738255,81610.28859,249.2718121,3.134228188,99629.61745,0.819159924,0.002492919,3.25573E-05,0.107212476,0.021022867,43,34
D:0| T0: 0.17| T1: 48.00| R0: 0.0| R1: 0.0| WTP: 0,0,0.173076923,48,0,0,0,0,0,-1475893206,2028637200,1264.513638,1412667524,141266752.4,1,11082,498,207,210,3,207,11082,3,210,33.42528736,1.051724138,1.063218391,92742.43678,248.8793103,2.229885057,99875.66667,0.928634903,0.002479365,2.38523E-05,0.014285714,0.018951358,25,16
D:0| T0: 0.17| T1: 48.00| R0: 0.0| R1: 0.0| WTP: 0,0,0.173076923,48,0,0,0,0,0,-2193661260,181476086,10709.8204,1658170240,165817024,1,86739,3824,537,1779,1242,537,86739,1242,1779,249.2956989,2.806451613,9.424731183,39414.52688,2185.919355,12.32258065,98865.46237,0.396737754,0.021924178,0.000124957,0.698145025,0.020509805,27,18
D:0| T0: 0.17| T1: 48.00| R0: 0.0| R1: 0.0| WTP: 0,0,0.173076923,48,0,0,0,0,0,-2203342319,2097578470,10842.9697,1661193834,166119383.4,1,85558,3814,584,1801,1217,584,85558,1217,1801,259.1290323,3.059139785,9.548387097,40090.06452,2490.709677,12.67204301,98856.64516,0.403672229,0.024981195,0.000128687,0.675735702,0.021050048,27,18
D:0| T0: 0.17| T1: 48.00| R0: 0.0| R1: 0.0| WTP: 0,0,0.173076923,48,0,0,0,0,0,-4868435767,119646392,11658.14488,4285528523,428552852.3,2,85918,3635,1100,1937,837,1100,85918,837,1937,70.65764331,1.597133758,2.904458599,75898.46019,857.1464968,4.665605096,99491.2293,0.760391183,0.00864189,4.87389E-05,0.432111513,0.022544752,90,48
D:0| T0: 0.17| T1: 48.00| R0: 0.0| R1: 0.0| WTP: 0,0,0.173076923,48,0,0,0,0,0,-1822268896,1298895859,11824.44223,1231046784,123104678.4,1,95331,4196,512,1964,1452,512,95331,1452,1964,353.56,3.333333333,12.93333333,35246.99333,2644.933333,16.35333333,98804.68,0.354356787,0.026513078,0.000165562,0.739307536,0.020601903,22,13
D:0| T0: 0.17| T1: 48.00| R0: 0.0| R1: 0.0| WTP: 0,0,0.173076923,48,0,0,0,0,0,-2537887848,1489316290,10625.0589,2006634903,200663490.3,1,82534,3668,529,1765,1236,529,82534,1236,1765,211.7887324,2.403755869,8.154929577,38400.00469,1348.258216,10.63849765,98764.79343,0.387276667,0.013528474,0.000108127,0.700283286,0.021385126,31,22
D:0| T0: 0.17| T1: 48.00| R0: 0.0| R1: 0.0| WTP: 0,0,0.173076923,48,0,0,0,0,0,-2717563507,855602142,14009.49354,2017088830,201708883,1,96194,3955,472,2328,1856,472,96194,1856,2328,236.6604651,2.153488372,10.74883721,26336.70233,1594.795349,12.94418605,98322.34419,0.265324005,0.016043383,0.000131127,0.797250859,0.024201094,31,22
D:0| T0: 0.17| T1: 48.00| R0: 0.0| R1: 0.0| WTP: 0,0,0.173076923,48,0,0,0,0,0,-2290824425,1438649896,3304.247164,2125612066,212561206.6,1,24979,1036,479,549,70,479,24979,70,549,52.61373391,1.922746781,2.210300429,83049.94421,545.1287554,4.244635193,99662.40773,0.833268084,0.005443653,4.40512E-05,0.127504554,0.021978462,33,24
D:0| T0: 0.17| T1: 48.00| R0: 0.0| R1: 0.0| WTP: 0,0,0.173076923,48,0,0,0,0,0,-1667490841,952489126,36.13731856,1665683975,166568397.5,1,393,13,6,6,0,6,393,0,6,1.036458333,0.005208333,0.005208333,99749.71354,16.3125,0.03125,99997.29688,0.997528192,0.000164252,6.21777E-07,0,0.015267176,28,19
D:0| T0: 0.17| T1: 48.00| R0: 0.0| R1: 0.0| WTP: 0,0,0.173076923,48,0,0,0,0,0,-1687488373,1550779155,12652.83926,1054846410,105484641,1,99140,4210,405,2102,1697,405,99140,1697,2102,388.0444444,2.925925926,15.45185185,25772.78519,2053.718519,18.45185185,98562.6,0.259796048,0.020577355,0.00018625,0.807326356,0.02120234,20,11
D:0| T0: 0.17| T1: 48.00| R0: 0.0| R1: 0.0| WTP: 0,0,0.173076923,48,0,0,0,0,0,-1584538183,607323321,120.3671534,1578519826,157851982.6,1,958,46,20,20,0,20,958,0,20,2.515957447,0.042553191,0.042553191,99350.77128,24.48404255,0.138297872,99988.26596,0.993634788,0.000245896,2.1166E-06,0,0.019832985,27,18
D:0| T0: 0.17| T1: 48.00| R0: 0.0| R1: 0.0| WTP: 0,0,0.173076923,48,0,0,0,0,0,-1763967924,2103646485,6320.595797,1447938134,144793813.4,1,48476,2088,518,1050,532,518,48476,532,1050,152.8176471,2.923529412,6.017647059,68788.1,861.6882353,9.047058824,99382.15294,0.691607142,0.008609496,9.21735E-05,0.506666667,0.021660203,25,16
D:0| T0: 0.17| T1: 48.00| R0: 0.0| R1: 0.0| WTP: 0,0,0.173076923,48,0,0,0,0,0,-1967351175,258120157,11146.97866,1410002242,141000224.2,1,97711,4438,441,1851,1410,441,97711,1410,1851,336.3151515,2.6,11.09090909,25085.55152,1505.909091,13.77575758,98682.07273,0.25287235,0.015096437,0.000139335,0.761750405,0.018943619,24,15
D:0| T0: 0.17| T1: 48.00| R0: 0.0| R1: 0.0| WTP: 0,0,0.173076923,48,0,0,0,0,0,-1881549754,1068951401,674.9467064,1847802418,184780241.8,1,6848,326,112,112,0,112,6848,0,112,19.8708134,0.435406699,0.435406699,95174.23445,127.6172249,0.976076555,99927.33971,0.952488261,0.001272629,1.06723E-05,0,0.01635514,30,21
D:0| T0: 0.17| T1: 48.00| R0: 0.0| R1: 0.0| WTP: 0,0,0.173076923,48,0,0,0,0,0,-4866443322,635956235,11574.78434,4287704105,428770410.5,2,86358,3696,1012,1923,911,1012,86358,911,1923,66.03607504,1.378066378,2.66955267,75715.03175,947.5613276,4.131313131,99499.62626,0.757975036,0.009553762,4.26935E-05,0.47373895,0.022267769,98,48
D:0| T0: 0.17| T1: 48.00| R0: 0.0| R1: 0.0| WTP: 0,0,0.173076923,48,0,0,0,0,0,-1056481164,1346693470,78.31500247,1052565414,105256541.4,1,830,35,13,13,0,13,830,0,13,3.167832168,0.034965035,0.034965035,99510.42657,29.68531469,0.104895105,99993.27972,0.995177696,0.00029731,1.80566E-06,0,0.015662651,21,12
D:0| T0: 0.17| T1: 48.00| R0: 0.0| R1: 0.0| WTP: 0,0,0.173076923,48,0,0,0,0,0,-2053644038,847102011,12959.21789,1405683144,140568314.4,1,98233,4205,472,2153,1681,472,98233,1681,2153,319.4573171,2.817073171,13,28185.04878,2044.310976,15.8597561,98563.80488,0.283633893,0.020520756,0.000160784,0.780771017,0.021917278,24,15
D:0| T0: 0.17| T1: 48.00| R0: 0.0| R1: 0.0| WTP: 0,0,0.173076923,48,0,0,0,0,0,-4895802736,812083272,12139.97501,4288803986,428880398.6,2,86753,3513,1827,2017,190,1827,86753,190,2017,61.07238606,2.284182306,2.525469169,52225.37936,709.7144772,4.991957105,98919.05496,0.526448334,0.007161531,5.19742E-05,0.094199306,0.023250184,107,48
D:0| T0: 0.17| T1: 48.00| R0: 0.0| R1: 0.0| WTP: 0,0,0.173076923,48,0,0,0,0,0,-2173799732,2146825809,11771.51154,1585224155,158522415.5,1,98874,4500,465,1955,1490,465,98874,1490,1955,310.3202247,2.556179775,10.8988764,22618.65169,1755.179775,13.51123596,98579.26404,0.228024452,0.017605376,0.000136496,0.762148338,0.01977264,26,17
D:0| T0: 0.17| T1: 48.00| R0: 0.0| R1: 0.0| WTP: 0,0,0.173076923,48,0,0,0,0,0,-2049126291,226186520,12851.40519,1406556032,140655603.2,1,97214,4231,468,2135,1667,468,97214,1667,2135,315.2619048,2.726190476,12.57738095,29346.85714,1687.755952,15.35714286,98566.32143,0.29534006,0.016944885,0.00015565,0.780796253,0.021961857,24,15
D:0| T0: 0.17| T1: 48.00| R0: 0.0| R1: 0.0| WTP: 0,0,0.173076923,48,0,0,0,0,0,-4885160487,1110225441,11835.14134,4293403419,429340341.9,2,88563,3854,1760,1966,206,1760,88563,206,1966,72.04457652,2.429420505,2.732540862,56768.01337,1011.637444,5.334323923,99083.28529,0.570933564,0.010202791,5.58154E-05,0.104781282,0.022198887,97,48
D:0| T0: 0.17| T1: 48.00| R0: 0.0| R1: 0.0| WTP: 0,0,0.173076923,48,0,0,0,0,0,-2799752948,1190767082,2908.788215,2654313537,265431353.7,1,26849,1155,465,483,18,465,26849,18,483,51.7032967,1.553113553,1.608058608,80675.79121,528.6410256,3.318681319,99676.7033,0.809389278,0.00528117,3.46811E-05,0.037267081,0.017989497,39,30
D:0| T0: 0.17| T1: 48.00| R0: 0.0| R1: 0.0| WTP: 0,0,0.173076923,48,0,0,0,0,0,-2049038391,2108234095,589.7016078,2019553310,201955331,1,3816,156,98,98,0,98,3816,0,98,9.366972477,0.28440367,0.28440367,97486.00917,107.4311927,0.747706422,99940.77523,0.975460291,0.001072089,8.95402E-06,0,0.025681342,32,23
D:0| T0: 0.17| T1: 48.00| R0: 0.0| R1: 0.0| WTP: 0,0,0.173076923,48,0,0,0,0,0,-2062506633,465621985,13044.7896,1410267153,141026715.3,1,98735,4381,480,2167,1687,480,98735,1687,2167,334.5272727,2.83030303,13.01212121,26112.41818,2058.369697,15.90909091,98516.55758,0.262930085,0.020662792,0.000161171,0.778495616,0.021947638,24,15
D:0| T0: 0.17| T1: 48.00| R0: 0.0| R1: 0.0| WTP: 0,0,0.173076923,48,0,0,0,0,0,-1470907198,1487072553,1168.372375,1412488579,141248857.9,1,11183,472,192,194,2,192,11183,2,194,33.1849711,1,1.011560694,93079.32948,235.1213873,2.115606936,99890.27746,0.931853345,0.00234256,2.22045E-05,0.010309278,0.017350863,25,16
D:0| T0: 0.17| T1: 48.00| R0: 0.0| R1: 0.0| WTP: 0,0,0.173076923,48,0,0,0,0,0,-2731172781,1213733847,4875.330653,2487406248,248740624.8,1,37564,1534,620,810,190,620,37564,190,810,73.66798419,2.304347826,3.015810277,73460.26087,625.9367589,5.466403162,99463.34783,0.738383356,0.006261691,5.65317E-05,0.234567901,0.021563199,37,28
D:0| T0: 0.17| T1: 48.00| R0: 0.0| R1: 0.0| WTP: 0,0,0.173076923,48,0,0,0,0,0,-2702535570,2003658337,5922.419548,2406414593,240641459.3,1,44748,1879,596,984,388,596,44748,388,984,90.98785425,2.311740891,3.862348178,67670.89474,734.1012146,6.271255061,99330.82591,0.680937101,0.007347291,6.40309E-05,0.394308943,0.02198981,36,27
D:0| T0: 0.17| T1: 48.00| R0: 0.0| R1: 0.0| WTP: 0,0,0.173076923,48,0,0,0,0,0,-1056628393,1170868072,84.26888432,1052414949,105241494.9,1,737,34,14,14,0,14,737,0,14,2.5,0.027777778,0.027777778,99553.38889,29.02777778,0.111111111,99993.40972,0.995606114,0.000290569,1.93116E-06,0,0.018995929,21,12
D:0| T0: 0.17| T1: 48.00| R0: 0.0| R1: 0.0| WTP: 0,0,0.173076923,48,0,0,0,0,0,-2356850640,569919592,11915.80294,1761060493,176106049.3,1,99253,4499,426,1979,1553,426,99253,1553,1979,291.0471204,2.178010471,10.28272251,19861.66492,1353.65445,12.51308901,98501.8377,0.200403918,0.013586368,0.000126488,0.784739768,0.019938944,28,19
D:0| T0: 0.17| T1: 48.00| R0: 0.0| R1: 0.0| WTP: 0,0,0.173076923,48,0,0,0,0,0,-2101805493,1833180623,4362.033463,1883703819,188370381.9,1,40935,1924,502,724,222,502,40935,222,724,121.7902439,2.292682927,3.336585366,71794.22927,925.3512195,5.795121951,99541.13171,0.721111564,0.009242055,5.97295E-05,0.306629834,0.017686576,30,21
D:0| T0: 0.17| T1: 48.00| R0: 0.0| R1: 0.0| WTP: 0,0,0.173076923,48,0,0,0,0,0,-2250428039,1123666637,13397.49232,1580553424,158055342.4,1,97045,4088,484,2226,1742,484,97045,1742,2226,292.4382022,2.646067416,12.37640449,26979.19101,1643.123596,15.08988764,98445.79213,0.271790086,0.016507599,0.000153066,0.782569632,0.022937812,26,17
D:0| T0: 0.17| T1: 48.00| R0: 0.0| R1: 0.0| WTP: 0,0,0.173076923,48,0,0,0,0,0,-2712613295,1682024981,9030.975062,2261064541,226106454.1,1,71675,3165,735,1500,765,735,71675,765,1500,166.8791667,2.966666667,6.091666667,50887.09167,2447.845833,9.158333333,99065.55417,0.512325812,0.024550112,9.34585E-05,0.51,0.020927799,34,25
D:0| T0: 0.17| T1: 48.00| R0: 0.0| R1: 0.0| WTP: 0,0,0.173076923,48,0,0,0,0,0,-3093503296,1687523543,1992.336254,2993886483,299388648.3,1,15603,650,331,331,0,331,15603,0,331,25.96632997,0.95959596,0.95959596,89222.13468,196.3131313,2.074074074,99784.98316,0.894166904,0.001961911,2.22508E-05,0,0.021215229,43,34
D:0| T0: 0.17| T1: 48.00| R0: 0.0| R1: 0.0| WTP: 0,0,0.173076923,48,0,0,0,0,0,-2098517827,178034412,12141.87123,1491424265,149142426.5,1,94595,4091,473,2017,1544,473,94595,1544,2017,302.4882353,2.705882353,11.71176471,32179.84706,1957.470588,14.5,98671.00588,0.323884412,0.01964123,0.000147066,0.765493307,0.02132248,25,16
D:0| T0: 0.17| T1: 48.00| R0: 0.0| R1: 0.0| WTP: 0,0,0.173076923,48,0,0,0,0,0,-1965558549,739490003,11252.80218,1402918440,140291844,1,93004,4063,472,1869,1397,472,93004,1397,1869,315.3580247,2.858024691,11.41358025,35432.75926,1602.95679,14.30864198,98812.0679,0.356447524,0.016067527,0.000144941,0.747458534,0.02009591,24,15
D:0| T0: 0.17| T1: 48.00| R0: 0.0| R1: 0.0| WTP: 0,0,0.173076923,48,0,0,0,0,0,-1973734689,178482706,8510.628926,1548203243,154820324.3,1,63172,2774,540,1414,874,540,63172,874,1414,187.3446328,2.95480226,7.836158192,57986.71186,1529.644068,10.87570621,99144.86441,0.58376196,0.01531079,0.000110547,0.618104668,0.022383334,26,17
D:0| T0: 0.17| T1: 48.00| R0: 0.0| R1: 0.0| WTP: 0,0,0.173076923,48,0,0,0,0,0,-2022576101,1919366370,3196.185014,1862766851,186276685.1,1,24018,1000,446,531,85,446,24018,85,531,59.85990338,2.033816425,2.429951691,84146.29469,401.7487923,4.599033816,99674.77295,0.844168403,0.004010565,4.70942E-05,0.16007533,0.022109339,30,21
D:0| T0: 0.17| T1: 48.00| R0: 0.0| R1: 0.0| WTP: 0,0,0.173076923,48,0,0,0,0,0,-1981487002,1819796913,11429.23864,1410025070,141002507,1,97451,4460,447,1898,1451,447,97451,1451,1898,331.8562874,2.622754491,11.25149701,29956.10778,2402.502994,13.91616766,98757.13174,0.301268217,0.024087167,0.000140892,0.764488936,0.019476455,24,15
D:0| T0: 0.17| T1: 48.00| R0: 0.0| R1: 0.0| WTP: 0,0,0.173076923,48,0,0,0,0,0,-4936734524,1866591913,12796.89728,4296889660,429688966,2,94194,4117,1233,2126,893,1233,94194,893,2126,82.89105691,1.827642276,3.256910569,67744.97236,1260.892683,5.284552846,99328.72195,0.678750174,0.012722815,5.50833E-05,0.420037629,0.02257044,88,48
D:0| T0: 0.17| T1: 48.00| R0: 0.0| R1: 0.0| WTP: 0,0,0.173076923,48,0,0,0,0,0,-1854053111,1219425989,12401.84865,1233960679,123396067.9,1,99237,4466,445,2060,1615,445,99237,1615,2060,367.2281879,2.899328859,13.69798658,25378.61074,1725.073826,16.67785235,98582.61074,0.255690659,0.017298075,0.000168699,0.783980583,0.020758386,22,13
D:0| T0: 0.17| T1: 48.00| R0: 0.0| R1: 0.0| WTP: 0,0,0.173076923,48,0,0,0,0,0,-2081001749,502409586,11734.42741,1494280379,149428037.9,1,97438,4267,475,1949,1474,475,97438,1474,1949,306.0287356,2.655172414,11.08045977,28094.3908,2257.413793,13.83333333,98682,0.282737,0.022643698,0.00013985,0.756285274,0.020002463,25,16
D:0| T0: 0.17| T1: 48.00| R0: 0.0| R1: 0.0| WTP: 0,0,0.173076923,48,0,0,0,0,0,-1956592972,1405887957,9608.669848,1476159480,147615948,1,76415,3438,512,1596,1084,512,76415,1084,1596,251.7869822,2.940828402,9.313609467,49101.85207,1371.710059,12.32544379,99030.04142,0.494238164,0.013737337,0.000124981,0.679197995,0.020885952,25,16
D:0| T0: 0.17| T1: 48.00| R0: 0.0| R1: 0.0| WTP: 0,0,0.173076923,48,0,0,0,0,0,-2094420002,283033753,12288.32318,1480003843,148000384.3,1,87277,3583,531,2042,1511,531,87277,1511,2042,255.9884393,2.994219653,11.67052023,38554.0578,1341.491329,14.74566474,98675.24855,0.388482073,0.013467474,0.000149366,0.739960823,0.023396771,25,16
D:0| T0: 0.17| T1: 48.00| R0: 0.0| R1: 0.0| WTP: 0,0,0.173076923,48,0,0,0,0,0,-2442906241,1083157068,5947.128611,2145549811,214554981.1,1,44084,1891,611,988,377,611,44084,377,988,104.8193833,2.528634361,4.158590308,68445.04405,986.5770925,6.889867841,99350.94714,0.688615203,0.009869687,7.0484E-05,0.381578947,0.022411759,33,24
D:0| T0: 0.17| T1: 48.00| R0: 0.0| R1: 0.0| WTP: 0,0,0.173076923,48,0,0,0,0,0,-2195326163,1988704626,3189.468904,2035852718,203585271.8,1,21682,887,470,530,60,470,21682,60,530,49.40358744,1.97309417,2.228699552,85041.75785,249.4080717,4.340807175,99658.37668,0.853324847,0.002491796,4.47597E-05,0.113207547,0.02444875,32,23
D:0| T0: 0.17| T1: 48.00| R0: 0.0| R1: 0.0| WTP: 0,0,0.173076923,48,0,0,0,0,0,-1782919123,884761309,12743.97338,1145720455,114572045.5,1,99069,4387,436,2117,1681,436,99069,1681,2117,369.3673469,2.911564626,14.29251701,24302.81633,1752.081633,17.2585034,98511.2381,0.245066138,0.017571463,0.00017431,0.794048181,0.021368945,21,12
D:0| T0: 0.17| T1: 48.00| R0: 0.0| R1: 0.0| WTP: 0,0,0.173076923,48,0,0,0,0,0,-1357033682,533485933,716.7577695,1321195794,132119579.4,1,6560,306,119,119,0,119,6560,0,119,22.79012346,0.617283951,0.617283951,95949.82099,110.5246914,1.351851852,99933.99383,0.960166,0.001101319,1.46094E-05,0,0.018140244,24,15
D:0| T0: 0.17| T1: 48.00| R0: 0.0| R1: 0.0| WTP: 0,0,0.173076923,48,0,0,0,0,0,-1541710028,632196071,897.0507331,1496857491,149685749.1,1,7021,309,148,149,1,148,7021,1,149,21.58988764,0.724719101,0.730337079,95478.35393,102.4719101,1.584269663,99911.10674,0.955671149,0.001022034,1.66039E-05,0.006711409,0.021222048,26,17
D:0| T0: 0.17| T1: 48.00| R0: 0.0| R1: 0.0| WTP: 0,0,0.173076923,48,0,0,0,0,0,-2132995666,393400457,12797.00807,1493145262,149314526.2,1,96342,4175,447,2126,1679,447,96342,1679,2126,304.3430233,2.540697674,12.26162791,30650.72093,1753.767442,14.8372093,98579.56395,0.30840584,0.017605094,0.000150281,0.789746002,0.022067219,25,16
D:0| T0: 0.17| T1: 48.00| R0: 0.0| R1: 0.0| WTP: 0,0,0.173076923,48,0,0,0,0,0,-1929437168,398973227,10756.71502,1391601417,139160141.7,1,82399,3546,541,1787,1246,541,82399,1246,1787,262.9107143,3.136904762,10.48809524,44001.22024,1467.214286,13.69642857,98895.46429,0.443037157,0.014703408,0.000138964,0.697257974,0.021687156,24,15
D:0| T0: 0.17| T1: 48.00| R0: 0.0| R1: 0.0| WTP: 0,0,0.173076923,48,0,0,0,0,0,-4270928589,1402256491,5694.999057,3986178636,398617863.6,1,44265,1936,911,946,35,911,44265,35,946,62.29973475,2.281167109,2.360742706,68195.21485,743.1193634,4.774535809,99358.61538,0.685995722,0.007447488,4.93591E-05,0.036997886,0.021371287,54,45
D:0| T0: 0.17| T1: 48.00| R0: 0.0| R1: 0.0| WTP: 0,0,0.173076923,48,0,0,0,0,0,-2499058230,2102527413,9944.961666,2001810146,200181014.6,1,75044,3333,654,1652,998,654,75044,998,1652,199.9952607,3,7.696682464,47394.36019,2057.260664,10.81042654,98944.08531,0.4775157,0.020634822,0.00010969,0.604116223,0.022013752,31,22
D:0| T0: 0.17| T1: 48.00| R0: 0.0| R1: 0.0| WTP: 0,0,0.173076923,48,0,0,0,0,0,-2223863970,1748031099,11322.31507,1657748216,165774821.6,1,84820,3584,627,1881,1254,627,84820,1254,1881,249.6793478,3.331521739,10.09782609,42318.53804,2486.804348,13.48369565,98840.16304,0.42603791,0.024958767,0.000136848,0.666666667,0.022176373,27,18
D:0| T0: 0.17| T1: 48.00| R0: 0.0| R1: 0.0| WTP: 0,0,0.173076923,48,0,0,0,0,0,-2430745683,1946754629,1125.618252,2374464770,237446477,1,8598,349,187,187,0,187,8598,0,187,18.12195122,0.62601626,0.62601626,93951.59756,134.6626016,1.398373984,99876.96341,0.940719103,0.001344662,1.51554E-05,0,0.021749244,36,27
D:0| T0: 0.17| T1: 48.00| R0: 0.0| R1: 0.0| WTP: 0,0,0.173076923,48,0,0,0,0,0,-2053296278,2097712204,2149.705652,1945810995,194581099.5,1,17589,805,348,357,9,348,17589,9,357,45.97222222,1.444444444,1.49537037,88200.31481,251.962963,3.111111111,99778.14815,0.883997055,0.002514567,3.25451E-05,0.025210084,0.020296776,31,22
D:0| T0: 0.17| T1: 48.00| R0: 0.0| R1: 0.0| WTP: 0,0,0.173076923,48,0,0,0,0,0,-3602113300,1198827119,150.4245572,3594592072,359459207.2,1,1250,56,25,25,0,25,1250,0,25,1.571428571,0.011428571,0.011428571,99124.28571,22.62285714,0.085714286,99983.49429,0.991415094,0.000228089,1.42467E-06,0,0.02,50,41
D:0| T0: 0.17| T1: 48.00| R0: 0.0| R1: 0.0| WTP: 0,0,0.173076923,48,0,0,0,0,0,-1404184043,109253198,30.1143433,1402678326,140267832.6,1,294,12,5,5,0,5,294,0,5,0.91160221,0.005524862,0.005524862,99818.67956,11.40331492,0.027624309,99997,0.998220311,0.000115882,5.49461E-07,0,0.017064846,25,16
D:0| T0: 0.17| T1: 48.00| R0: 0.0| R1: 0.0| WTP: 0,0,0.173076923,48,0,0,0,0,0,-1438170899,314481292,614.2164209,1407460078,140746007.8,1,4927,215,102,102,0,102,4927,0,102,17.11242604,0.49704142,0.49704142,96855.05917,87.1183432,1.100591716,99941.61538,0.969148319,0.000868848,1.20058E-05,0,0.020702253,25,16
D:1| T0: 0.10| T1: 515.00| I0: 300.0| I1: 75.0| WTP: 250000,1,0.096153846,515,250000,1,0.2,300,75,-4547210460,1178568022,7499.958353,4172212542,417221254.2,24,57041,2371,1246,1246,0,1246,57041,0,1246,15.28265306,0.455102041,0.455102041,59900.37296,150.3571429,1.098469388,99123.07194,0.603767805,0.00151493,1.27873E-05,0,0.021843937,279,47
D:1| T0: 0.10| T1: 515.00| I0: 300.0| I1: 75.0| WTP: 250000,1,0.096153846,515,250000,1,0.2,300,75,-1383520751,2029998696,11830.2407,792008715.4,79200871.54,4,94945,4164,648,1965,1317,648,94945,1317,1965,230.8502203,2.753303965,8.524229075,35657.04846,1414.511013,11.37444934,98757.2467,0.358235323,0.014213002,0.00011567,0.670229008,0.020696193,33,8
D:1| T0: 0.10| T1: 515.00| I0: 300.0| I1: 75.0| WTP: 250000,1,0.096153846,515,250000,1,0.2,300,75,-1413972414,776062361,12590.52504,784446162.6,78444616.26,4,92374,3822,796,2092,1296,796,92374,1296,2092,176.2304833,2.862453532,7.643122677,39223.80669,2136.762082,10.60594796,98727.87361,0.394065151,0.021505698,0.000108069,0.619502868,0.022647065,38,8
D:1| T0: 0.10| T1: 515.00| I0: 300.0| I1: 75.0| WTP: 250000,1,0.096153846,515,250000,1,0.2,300,75,-3953099030,1813046880,7789.863047,3563605878,356360587.8,20,59333,2604,1288,1294,6,1288,59333,6,1294,16.47238956,0.483433735,0.485943775,55791.62098,187.9814257,1.141566265,99029.96837,0.562838689,0.00189387,1.30396E-05,0.004636785,0.021809111,285,40
D:1| T0: 0.10| T1: 515.00| I0: 300.0| I1: 75.0| WTP: 250000,1,0.096153846,515,250000,1,0.2,300,75,-2108223383,2032407216,7599.508347,1728247966,172824796.6,10,64682,2894,1157,1262,105,1157,64682,105,1262,47.70345745,1.339095745,1.472074468,54337.54521,300.4454787,3.010638298,99128.30053,0.547450775,0.003021265,3.23296E-05,0.083201268,0.019510838,108,19
D:1| T0: 0.10| T1: 515.00| I0: 300.0| I1: 75.0| WTP: 250000,1,0.096153846,515,250000,1,0.2,300,75,-6688742551,1507873352,6686.078122,6354438645,635443864.5,36,48509,2104,1111,1111,0,1111,48509,0,1111,7.522850271,0.182802165,0.182802165,68580.85268,106.2188815,0.517739026,99292.39206,0.690154154,0.001070143,6.71599E-06,0,0.022902966,475,72
D:1| T0: 0.10| T1: 515.00| I0: 300.0| I1: 75.0| WTP: 250000,1,0.096153846,515,250000,1,0.2,300,75,-3353111441,1855899401,6460.201436,3030101369,303010136.9,18,51352,2273,1073,1073,0,1073,51352,0,1073,23.59271523,0.69205298,0.69205298,69434.09685,159.0256623,1.583609272,99362.46358,0.698308845,0.001600105,1.78458E-05,0,0.020895813,173,34
D:1| T0: 0.10| T1: 515.00| I0: 300.0| I1: 75.0| WTP: 250000,1,0.096153846,515,250000,1,0.2,300,75,-1447033641,1819459251,9986.269449,947720168.5,94772016.85,6,74903,3238,711,1659,948,711,74903,948,1659,166.9344262,2.795081967,6.635245902,52835.87705,1101.565574,9.532786885,99029.59836,0.53152131,0.011056307,9.75295E-05,0.571428571,0.022148646,35,10
D:1| T0: 0.10| T1: 515.00| I0: 300.0| I1: 75.0| WTP: 250000,1,0.096153846,515,250000,1,0.2,300,75,-3564594188,909791748,7127.688074,3208209784,320820978.4,22,54469,2406,1184,1184,0,1184,54469,0,1184,20.04663558,0.584943371,0.584943371,68157.39507,117.2884744,1.372418388,99321.62358,0.685651428,0.001181533,1.58594E-05,0,0.021737135,215,36
D:1| T0: 0.10| T1: 515.00| I0: 300.0| I1: 75.0| WTP: 250000,1,0.096153846,515,250000,1,0.2,300,75,-1476838419,1339092841,9063.685199,1023654159,102365415.9,6,65749,2721,812,1506,694,812,65749,694,1506,89.15915119,2.068965517,3.888594164,51412.98674,627.1883289,6.031830239,98925.66048,0.518515701,0.006302596,6.17803E-05,0.460823373,0.02290564,54,11
D:1| T0: 0.10| T1: 515.00| I0: 300.0| I1: 75.0| WTP: 250000,1,0.096153846,515,250000,1,0.2,300,75,-1403507233,1365866345,12208.93929,793060268.4,79306026.84,4,95855,4267,715,2028,1313,715,95855,1313,2028,219.3112033,2.887966805,8.298755187,32980.77593,1247.344398,11.24481328,98667.9917,0.331489792,0.0125414,0.000114431,0.647435897,0.021156956,35,8
D:1| T0: 0.10| T1: 515.00| I0: 300.0| I1: 75.0| WTP: 250000,1,0.096153846,515,250000,1,0.2,300,75,-1572425539,825453433,8912.60515,1126795282,112679528.2,6,75128,3348,899,1480,581,899,75128,581,1480,106.8044554,2.094059406,3.514851485,45192.02475,946.3836634,5.747524752,98971.0198,0.455215944,0.009507945,5.91903E-05,0.392567568,0.019699712,58,12
D:1| T0: 0.10| T1: 515.00| I0: 300.0| I1: 75.0| WTP: 250000,1,0.096153846,515,250000,1,0.2,300,75,-1392680308,939711378,11974.9893,793930842.6,79393084.26,4,96951,4287,640,1989,1349,640,96951,1349,1989,232.7434783,2.726086957,8.539130435,32911.42174,1656.417391,11.30434783,98717.07391,0.330585224,0.016642516,0.000114881,0.678230266,0.020515518,33,8
D:1| T0: 0.10| T1: 515.00| I0: 300.0| I1: 75.0| WTP: 250000,1,0.096153846,515,250000,1,0.2,300,75,-1894952660,638950699,8430.951515,1473405084,147340508.4,8,70609,3151,1087,1400,313,1087,70609,313,1400,69.30204778,1.747440273,2.262798635,45785.31399,760.7542662,4.126279863,98958.57167,0.461567767,0.007648648,4.26643E-05,0.223571429,0.019827501,84,16
D:1| T0: 0.10| T1: 515.00| I0: 300.0| I1: 75.0| WTP: 250000,1,0.096153846,515,250000,1,0.2,300,75,-2385850595,938699148,7917.393415,1989980924,198998092.4,12,64514,2906,1233,1315,82,1233,64514,82,1315,41.94844125,1.269784173,1.363309353,55185.63909,261.1139089,2.824940048,99103.05755,0.556123215,0.002627511,3.07178E-05,0.062357414,0.020383173,120,22
D:1| T0: 0.10| T1: 515.00| I0: 300.0| I1: 75.0| WTP: 250000,1,0.096153846,515,250000,1,0.2,300,75,-4598197045,121790188,6696.356191,4263379235,426337923.5,24,56568,2594,1112,1112,0,1112,56568,0,1112,18.88785047,0.47021028,0.47021028,62876.8785,238.1810748,1.117990654,99281.12967,0.632815422,0.002396076,1.30555E-05,0,0.019657757,244,48
D:1| T0: 0.10| T1: 515.00| I0: 300.0| I1: 75.0| WTP: 250000,1,0.096153846,515,250000,1,0.2,300,75,-1618858892,1331335240,11336.8885,1052014467,105201446.7,6,90734,3926,720,1883,1163,720,90734,1163,1883,202.708,2.764,7.368,40985.628,2391.792,10.244,98879.656,0.41171151,0.024033941,0.000104673,0.617631439,0.02075297,36,11
D:1| T0: 0.10| T1: 515.00| I0: 300.0| I1: 75.0| WTP: 250000,1,0.096153846,515,250000,1,0.2,300,75,-1344883793,470935411,12850.55476,702356055.6,70235605.56,4,93723,3995,728,2135,1407,728,93723,1407,2135,299.1823529,4.194117647,12.37647059,34795.56471,1426.711765,16.67058824,98640.10588,0.350554058,0.014330058,0.000169245,0.659016393,0.022779894,25,7
D:1| T0: 0.10| T1: 515.00| I0: 300.0| I1: 75.0| WTP: 250000,1,0.096153846,515,250000,1,0.2,300,75,-1924983161,823434397,9185.118921,1465727214,146572721.4,8,65891,2828,1042,1526,484,1042,65891,484,1526,82.72916667,2.291666667,3.372685185,55363.47685,781.5231481,5.784722222,99004.28009,0.557731897,0.00785894,5.97582E-05,0.317169069,0.023160515,62,16
D:1| T0: 0.10| T1: 515.00| I0: 300.0| I1: 75.0| WTP: 250000,1,0.096153846,515,250000,1,0.2,300,75,-3451063293,493045351,6587.576362,3121684475,312168447.5,20,55760,2498,1094,1094,0,1094,55760,0,1094,22.92353378,0.625835189,0.625835189,65079.40757,104.7594655,1.416481069,99336.79955,0.65453251,0.001054926,1.63206E-05,0,0.019620151,193,35
D:1| T0: 0.10| T1: 515.00| I0: 300.0| I1: 75.0| WTP: 250000,1,0.096153846,515,250000,1,0.2,300,75,-1838661655,1700216563,7361.064812,1470608414,147060841.4,8,65144,3001,975,1222,247,975,65144,247,1222,88.37837838,2.094594595,2.628378378,56137.5518,787.8243243,4.81981982,99214.01126,0.564670987,0.007908486,4.96717E-05,0.20212766,0.018758731,64,16
D:1| T0: 0.10| T1: 515.00| I0: 300.0| I1: 75.0| WTP: 250000,1,0.096153846,515,250000,1,0.2,300,75,-1762581707,1744119059,7689.729462,1378095233,137809523.3,8,64075,2981,1133,1277,144,1133,64075,144,1277,58.29886914,1.620355412,1.844911147,53829.28595,286.3812601,3.675282714,99103.937,0.542536813,0.002879593,3.91244E-05,0.112764291,0.019930081,89,15
D:1| T0: 0.10| T1: 515.00| I0: 300.0| I1: 75.0| WTP: 250000,1,0.096153846,515,250000,1,0.2,300,75,-2900529551,2036906360,7866.503321,2507204385,250720438.5,14,59275,2528,1285,1307,22,1285,59275,22,1307,22.8156682,0.811059908,0.827956989,55100.05453,315.9347158,1.817204301,99029.76267,0.555693732,0.003179924,2.0023E-05,0.016832441,0.022049768,185,28
D:1| T0: 0.10| T1: 515.00| I0: 300.0| I1: 75.0| WTP: 250000,1,0.096153846,515,250000,1,0.2,300,75,-1877769364,809704121,8171.308232,1469203953,146920395.3,8,67694,3069,1009,1357,348,1009,67694,348,1357,91.42925659,2.278177458,3.09352518,55503.19664,838.7889688,5.51558753,99149.98561,0.558406623,0.008424791,5.69833E-05,0.256448047,0.02004609,59,16
D:1| T0: 0.10| T1: 515.00| I0: 300.0| I1: 75.0| WTP: 250000,1,0.096153846,515,250000,1,0.2,300,75,-1684505053,1219866412,10945.81042,1137214532,113721453.2,6,87994,3874,920,1818,898,920,87994,898,1818,155.5904762,2.80952381,5.619047619,38110.63492,2295.539683,8.53015873,98804.75238,0.383511001,0.02308472,8.74619E-05,0.493949395,0.0206605,45,12
D:1| T0: 0.10| T1: 515.00| I0: 300.0| I1: 75.0| WTP: 250000,1,0.096153846,515,250000,1,0.2,300,75,-5404637484,843498920,7198.303772,5044722296,504472229.6,32,52823,2297,1196,1196,0,1196,52823,0,1196,10.87048666,0.31043956,0.31043956,63791.64757,99.95172684,0.779434851,99189.56947,0.642542714,0.001007509,9.4405E-06,0,0.022641652,364,57
D:1| T0: 0.10| T1: 515.00| I0: 300.0| I1: 75.0| WTP: 250000,1,0.096153846,515,250000,1,0.2,300,75,-1981660987,107351963,10326.07949,1465357012,146535701.2,8,71840,2807,1295,1716,421,1295,71840,421,1716,48.4813278,1.64868603,2.215767635,44824.26694,690.9377593,3.987551867,98718.40387,0.452727074,0.006959652,4.19493E-05,0.245337995,0.023886414,104,16
D:1| T0: 0.10| T1: 515.00| I0: 300.0| I1: 75.0| WTP: 250000,1,0.096153846,515,250000,1,0.2,300,75,-1938570457,773789021,9313.572893,1472891812,147289181.2,8,69960,3174,1120,1547,427,1120,69960,427,1547,80.8989899,2.125252525,2.965656566,51247.27879,958.0060606,5.22020202,98966.28485,0.516321658,0.009635197,5.41865E-05,0.2760181,0.022112636,71,16
D:1| T0: 0.10| T1: 515.00| I0: 300.0| I1: 75.0| WTP: 250000,1,0.096153846,515,250000,1,0.2,300,75,-1618199969,850936611,10020.55179,1117172380,111717238,6,69867,2894,1127,1665,538,1127,69867,538,1665,57.07142857,1.641304348,2.448757764,44639.63509,575.613354,4.187888199,98709.67081,0.451028243,0.005796502,4.36564E-05,0.323123123,0.023830993,92,12
D:1| T0: 0.10| T1: 515.00| I0: 300.0| I1: 75.0| WTP: 250000,1,0.096153846,515,250000,1,0.2,300,75,-1568445633,1701318364,8982.293752,1119330945,111933094.5,6,70496,3025,1075,1492,417,1075,70496,417,1492,60.82250396,1.580031696,2.228209192,42821.13154,470.340729,3.93977813,98808.25674,0.43253079,0.004732987,4.09292E-05,0.279490617,0.021164321,91,12
D:1| T0: 0.10| T1: 515.00| I0: 300.0| I1: 75.0| WTP: 250000,1,0.096153846,515,250000,1,0.2,300,75,-3924769173,778708269,7337.556977,3557891324,355789132.4,20,55725,2393,1219,1219,0,1219,55725,0,1219,14.01663498,0.419201521,0.419201521,59624.90589,202.956749,0.986692015,99135.5789,0.600889963,0.002043241,1.16529E-05,0,0.02187528,301,40
D:1| T0: 0.10| T1: 515.00| I0: 300.0| I1: 75.0| WTP: 250000,1,0.096153846,515,250000,1,0.2,300,75,-3082712070,1391938506,8010.522593,2682185940,268218594,18,56924,2415,1285,1331,46,1285,56924,46,1331,19.65116279,0.68372093,0.713621262,55586.5887,134.9933555,1.576079734,98963.4206,0.561186298,0.001360672,1.74873E-05,0.034560481,0.023382053,215,30
D:1| T0: 0.10| T1: 515.00| I0: 300.0| I1: 75.0| WTP: 250000,1,0.096153846,515,250000,1,0.2,300,75,-4795076391,43418681,5723.740653,4508889358,450888935.8,26,43247,1890,951,951,0,951,43247,0,951,10.83554899,0.313146233,0.313146233,71302.31413,119.7597243,0.779911374,99369.93058,0.717143314,0.001205239,9.4049E-06,0,0.021989965,291,51
D:1| T0: 0.10| T1: 515.00| I0: 300.0| I1: 75.0| WTP: 250000,1,0.096153846,515,250000,1,0.2,300,75,-1417547193,817384966,12692.12962,782940711.9,78294071.19,4,90602,3756,789,2109,1320,789,90602,1320,2109,252.4456522,4.195652174,11.2826087,40878.88587,1341.407609,15.5923913,98743.14674,0.411496812,0.013472938,0.000158227,0.625889047,0.023277632,27,8
D:1| T0: 0.10| T1: 515.00| I0: 300.0| I1: 75.0| WTP: 250000,1,0.096153846,515,250000,1,0.2,300,75,-1329680087,762053968,10908.90403,784234885.7,78423488.57,4,89409,3903,706,1812,1106,706,89409,1106,1812,233.9460784,3.362745098,8.730392157,42878.75,1366.02451,12.18627451,98936.04902,0.430944848,0.013709946,0.000123882,0.610375276,0.020266416,30,8
D:1| T0: 0.10| T1: 515.00| I0: 300.0| I1: 75.0| WTP: 250000,1,0.096153846,515,250000,1,0.2,300,75,-2203774780,1692506311,7726.122047,1817468677,181746867.7,10,67031,3056,1176,1283,107,1176,67031,107,1283,37.49795918,1.047959184,1.154081633,47771.57347,453.5826531,2.357142857,99020.71122,0.481665051,0.004562278,2.5228E-05,0.083398285,0.019140398,139,20
D:1| T0: 0.10| T1: 515.00| I0: 300.0| I1: 75.0| WTP: 250000,1,0.096153846,515,250000,1,0.2,300,75,-3670449483,1037620300,5941.277345,3373385615,337338561.5,20,46293,2005,987,987,0,987,46293,0,987,17.52453102,0.510822511,0.510822511,70796.54113,139.7539683,1.222943723,99385.12698,0.711937904,0.00140585,1.43026E-05,0,0.021320718,198,38
D:1| T0: 0.10| T1: 515.00| I0: 300.0| I1: 75.0| WTP: 250000,1,0.096153846,515,250000,1,0.2,300,75,-3415159966,301400999,7543.76446,3037971743,303797174.3,18,60672,2581,1234,1253,19,1234,60672,19,1253,22.85041551,0.666204986,0.67867036,56318.6759,174.7867036,1.537396122,99114.48546,0.567659574,0.001760014,1.73197E-05,0.015163607,0.020652031,207,34
D:1| T0: 0.10| T1: 515.00| I0: 300.0| I1: 75.0| WTP: 250000,1,0.096153846,515,250000,1,0.2,300,75,-1333353780,1868336855,11034.19698,781643931.1,78164393.11,4,85024,3691,738,1833,1095,738,85024,1095,1833,181.6062992,2.767716535,7.05511811,45113.5,1305.53937,9.94488189,98904.12598,0.453593972,0.013117366,0.000101749,0.597381342,0.021558619,37,8
D:1| T0: 0.10| T1: 515.00| I0: 300.0| I1: 75.0| WTP: 250000,1,0.096153846,515,250000,1,0.2,300,75,-1583781188,1868498144,10876.52848,1039954764,103995476.4,6,82213,3536,714,1807,1093,714,82213,1093,1807,159.2683824,2.496323529,6.477941176,44796.06985,1261.735294,9.125,98860.97794,0.450818701,0.012681625,9.31629E-05,0.60486995,0.021979492,39,11
D:1| T0: 0.10| T1: 515.00| I0: 300.0| I1: 75.0| WTP: 250000,1,0.096153846,515,250000,1,0.2,300,75,-2870671358,2101566889,7236.436728,2508849521,250884952.1,14,55714,2492,1196,1202,6,1196,55714,6,1202,21.55863983,0.654406662,0.658570437,58325.41846,218.9285219,1.491325468,99093.94032,0.588117583,0.002203532,1.67299E-05,0.004991681,0.02157447,206,28
D:1| T0: 0.10| T1: 515.00| I0: 300.0| I1: 75.0| WTP: 250000,1,0.096153846,515,250000,1,0.2,300,75,-1413178542,1665097450,12448.42765,790757159.4,79075715.94,4,95364,4084,709,2068,1359,709,95364,1359,2068,231.5315315,3.157657658,9.216216216,29969.05405,1471.099099,12.40540541,98565.62162,0.301893621,0.01479362,0.000125802,0.657156673,0.021685332,32,8
D:1| T0: 0.10| T1: 515.00| I0: 300.0| I1: 75.0| WTP: 250000,1,0.096153846,515,250000,1,0.2,300,75,-1337506518,1716179948,10775.50476,798731279.7,79873127.97,4,97436,4498,713,1789,1076,713,97436,1076,1789,304.7365591,3.747311828,9.478494624,36982.23118,1808.892473,13.31182796,98946.6129,0.371245615,0.018147954,0.000134933,0.601453326,0.01836077,27,8
D:1| T0: 0.10| T1: 515.00| I0: 300.0| I1: 75.0| WTP: 250000,1,0.096153846,515,250000,1,0.2,300,75,-3161682514,1560278715,7948.66764,2764249132,276424913.2,16,53478,2167,1321,1321,0,1321,53478,0,1321,21.52679308,0.875515251,0.875515251,64657.77329,150.4682605,1.982687552,99145.02885,0.65153756,0.001515768,2.19072E-05,0,0.024701747,173,31
D:1| T0: 0.10| T1: 515.00| I0: 300.0| I1: 75.0| WTP: 250000,1,0.096153846,515,250000,1,0.2,300,75,-1400544680,991019385,12343.8999,783349685.4,78334968.54,4,90105,3827,713,2051,1338,713,90105,1338,2051,176.2255639,2.560150376,7.567669173,38985.35338,2004.496241,10.26691729,98708.37218,0.392013411,0.020164468,0.000104562,0.6523647,0.022762333,38,8
D:1| T0: 0.10| T1: 515.00| I0: 300.0| I1: 75.0| WTP: 250000,1,0.096153846,515,250000,1,0.2,300,75,-1350120201,118052103,11293.66053,785437174.6,78543717.46,4,87357,3891,765,1876,1111,765,87357,1111,1876,180.4701493,2.720149254,6.824626866,45449.93657,1649.537313,9.701492537,98919.63433,0.456590564,0.016581293,9.90906E-05,0.592217484,0.021475096,39,8
D:1| T0: 0.10| T1: 515.00| I0: 300.0| I1: 75.0| WTP: 250000,1,0.096153846,515,250000,1,0.2,300,75,-1405055439,1209758844,12434.00238,783355320.1,78335532.01,4,89402,3728,691,2066,1375,691,89402,1375,2066,240.5179487,3.441025641,10.44102564,45146.83077,1345.369231,13.96410256,98835.05128,0.45362038,0.013515966,0.000142049,0.66553727,0.023109103,28,8
D:1| T0: 0.10| T1: 515.00| I0: 300.0| I1: 75.0| WTP: 250000,1,0.096153846,515,250000,1,0.2,300,75,-6296816216,70671723,7427.881941,5925422119,592542211.9,34,56310,2431,1234,1234,0,1234,56310,0,1234,11.8723989,0.319199058,0.319199058,62948.93443,136.2320377,0.806438948,99190.36749,0.634037075,0.001372841,9.74615E-06,0,0.021914792,364,67
D:1| T0: 0.10| T1: 515.00| I0: 300.0| I1: 75.0| WTP: 250000,1,0.096153846,515,250000,1,0.2,300,75,-3531427787,1722612191,6443.380791,3209258748,320925874.8,18,52529,2495,1070,1070,0,1070,52529,0,1070,21.13856655,0.535836177,0.535836177,65810.96792,198.0163823,1.264846416,99324.05666,0.662074325,0.001991785,1.46759E-05,0,0.020369701,209,36
D:1| T0: 0.10| T1: 515.00| I0: 300.0| I1: 75.0| WTP: 250000,1,0.096153846,515,250000,1,0.2,300,75,-3159790273,1968291596,6046.631627,2857458691,285745869.1,16,53084,2423,1004,1004,0,1004,53084,0,1004,22.39380531,0.544247788,0.544247788,65276.7146,156.6076696,1.296460177,99353.76401,0.656505589,0.001575249,1.48719E-05,0,0.018895294,194,32
D:1| T0: 0.10| T1: 515.00| I0: 300.0| I1: 75.0| WTP: 250000,1,0.096153846,515,250000,1,0.2,300,75,-1449474365,1877569084,13169.17406,791015662.1,79101566.21,4,96488,4069,745,2188,1443,745,96488,1443,2188,266.1295337,3.813471503,11.21243523,35133.56995,1600.093264,15.05181347,98644.61658,0.353250926,0.016087307,0.00015278,0.659506399,0.022676395,28,8
D:1| T0: 0.10| T1: 515.00| I0: 300.0| I1: 75.0| WTP: 250000,1,0.096153846,515,250000,1,0.2,300,75,-1400909269,1726322189,12190.40189,791389174.1,79138917.41,4,95421,4151,742,2025,1283,742,95421,1283,2025,268.4352332,3.777202073,10.33678756,36894.84456,1673.772021,14.19170984,98778.33161,0.370759373,0.0168105,0.000144015,0.633580247,0.021221744,28,8
D:1| T0: 0.10| T1: 515.00| I0: 300.0| I1: 75.0| WTP: 250000,1,0.096153846,515,250000,1,0.2,300,75,-1390977632,307848836,12063.07059,787824102.3,78782410.23,4,91431,4027,613,2004,1391,613,91431,1391,2004,231.5627907,2.772093023,9.195348837,41100.16744,1495.390698,12.03255814,98811.69767,0.412902006,0.015021828,0.000122332,0.694111776,0.021918168,31,8
D:1| T0: 0.10| T1: 515.00| I0: 300.0| I1: 75.0| WTP: 250000,1,0.096153846,515,250000,1,0.2,300,75,-1341668484,1154000220,11019.14034,790711467.3,79071146.73,4,90887,4116,741,1830,1089,741,90887,1089,1830,279.227027,3.940540541,9.762162162,33141.29189,1277.481081,13.76756757,98752.11351,0.33430677,0.012817088,0.000139538,0.595081967,0.020134893,27,8
D:1| T0: 0.10| T1: 515.00| I0: 300.0| I1: 75.0| WTP: 250000,1,0.096153846,515,250000,1,0.2,300,75,-5207055733,2028661055,6718.458125,4871132827,487113282.7,28,53408,2350,1116,1116,0,1116,53408,0,1116,15.7568306,0.421311475,0.421311475,68369.25301,152.0202186,1.033879781,99341.75683,0.687693437,0.001530539,1.22584E-05,0,0.020896137,262,55
D:1| T0: 0.10| T1: 515.00| I0: 300.0| I1: 75.0| WTP: 250000,1,0.096153846,515,250000,1,0.2,300,75,-1969113409,1629114640,9866.976405,1475764588,147576458.8,8,77650,3408,1069,1639,570,1069,77650,570,1639,116.0362117,2.857938719,4.398328691,48852.92201,1342.593315,7.381615599,98990.05014,0.491602052,0.013496319,7.58473E-05,0.347773032,0.021107534,52,16
D:1| T0: 0.10| T1: 515.00| I0: 300.0| I1: 75.0| WTP: 250000,1,0.096153846,515,250000,1,0.2,300,75,-1448079271,1439048174,13026.9009,796734226.2,79673422.62,4,96599,4308,746,2164,1418,746,96599,1418,2164,300.1748634,4,11.66666667,38851.43169,2247.836066,15.75956284,98756.08743,0.390137629,0.022590817,0.000159786,0.655268022,0.022401888,27,8
D:1| T0: 0.10| T1: 515.00| I0: 300.0| I1: 75.0| WTP: 250000,1,0.096153846,515,250000,1,0.2,300,75,-1292416835,865227006,11976.89732,693571969.4,69357196.94,4,88440,3679,705,1990,1285,705,88440,1285,1990,275.0722892,4.120481928,11.79518072,34329.10843,1429.783133,16.08433735,98636.85542,0.346731923,0.014345885,0.000163076,0.645728643,0.02250164,24,7
D:1| T0: 0.10| T1: 515.00| I0: 300.0| I1: 75.0| WTP: 250000,1,0.096153846,515,250000,1,0.2,300,75,-1691078570,890479738,11095.6054,1136298300,113629830,6,88008,3838,815,1843,1028,815,88008,1028,1843,149.7808642,2.416666667,5.552469136,37508.04012,1938.632716,8.074074074,98771.28395,0.377419917,0.019499109,8.25542E-05,0.557786218,0.020941278,47,12
D:1| T0: 0.10| T1: 515.00| I0: 300.0| I1: 75.0| WTP: 250000,1,0.096153846,515,250000,1,0.2,300,75,-3667863248,1017049163,7345.451505,3300590673,330059067.3,22,60730,2751,1219,1220,1,1219,60730,1,1220,24.53033708,0.721348315,0.722097378,61236.30187,161.9745318,1.626966292,99235.94382,0.616536334,0.00163071,1.83678E-05,0.000819672,0.020089249,191,37
D:1| T0: 0.10| T1: 515.00| I0: 300.0| I1: 75.0| WTP: 250000,1,0.096153846,515,250000,1,0.2,300,75,-3872108189,1707305064,6304.261343,3556895122,355689512.2,20,52088,2351,1047,1047,0,1047,52088,0,1047,16.76345934,0.420389462,0.420389462,63704.51604,156.7199313,1.024054983,99276.23883,0.641252475,0.001576957,1.20492E-05,0,0.020100599,250,40
D:1| T0: 0.10| T1: 515.00| I0: 300.0| I1: 75.0| WTP: 250000,1,0.096153846,515,250000,1,0.2,300,75,-1286251020,400145663,11803.58029,696072005.8,69607200.58,4,86942,3738,730,1961,1231,730,86942,1231,1961,245.9270833,3.723958333,10.078125,32762.4375,1214.723958,13.875,98577.98958,0.331264071,0.012196606,0.000140896,0.627740948,0.022555267,28,7
D:1| T0: 0.10| T1: 515.00| I0: 300.0| I1: 75.0| WTP: 250000,1,0.096153846,515,250000,1,0.2,300,75,-4103917217,1662654181,7303.357887,3738749322,373874932.2,24,61110,2708,1209,1213,4,1209,61110,4,1213,19.29235294,0.542352941,0.544117647,57018.94118,147.4558824,1.256470588,99151.10059,0.574484481,0.001485176,1.43254E-05,0.003297609,0.019849777,243,42
D:1| T0: 0.10| T1: 515.00| I0: 300.0| I1: 75.0| WTP: 250000,1,0.096153846,515,250000,1,0.2,300,75,-1362182916,182136456,11380.26596,793169618,79316961.8,4,95282,4251,770,1890,1120,770,95282,1120,1890,282.1489362,4.037234043,9.909574468,37686.44149,1749.590426,14,98864.92021,0.378761919,0.017562797,0.000142007,0.592592593,0.019835856,27,8
D:1| T0: 0.10| T1: 515.00| I0: 300.0| I1: 75.0| WTP: 250000,1,0.096153846,515,250000,1,0.2,300,75,-4200271864,979575387,5912.936117,3904625058,390462505.8,22,49026,2248,982,982,0,982,49026,0,982,13.3763285,0.316908213,0.316908213,65863.63816,157.9236715,0.787439614,99311.0942,0.662836754,0.001588966,9.53006E-06,0,0.020030597,296,44
D:1| T0: 0.10| T1: 515.00| I0: 300.0| I1: 75.0| WTP: 250000,1,0.096153846,515,250000,1,0.2,300,75,-1414555815,2142525414,12519.76766,788567431.6,78856743.16,4,93670,3990,711,2080,1369,711,93670,1369,2080,256.7384615,3.523076923,10.48717949,45475.51282,1895.589744,14.17435897,98908.51282,0.456217912,0.019047371,0.000143821,0.658173077,0.022205615,28,8
D:1| T0: 0.10| T1: 515.00| I0: 300.0| I1: 75.0| WTP: 250000,1,0.096153846,515,250000,1,0.2,300,75,-1308353211,1464057597,10553.45839,780680291.3,78068029.13,4,83440,3665,765,1753,988,765,83440,988,1753,168.3247232,2.6900369,6.287822878,47638.99262,1154.653137,9.103321033,98981.90406,0.478795989,0.011598857,9.33721E-05,0.563605248,0.021010116,39,8
D:1| T0: 0.10| T1: 515.00| I0: 300.0| I1: 75.0| WTP: 250000,1,0.096153846,515,250000,1,0.2,300,75,-1363136256,364562610,11575.53304,784359603.8,78435960.38,4,90373,3854,667,1923,1256,667,90373,1256,1923,239.7939698,3.246231156,9.497487437,43443.79899,1533.854271,12.86432161,98892.47739,0.436426742,0.015401995,0.000130688,0.653146126,0.021278479,29,8
D:1| T0: 0.10| T1: 515.00| I0: 300.0| I1: 75.0| WTP: 250000,1,0.096153846,515,250000,1,0.2,300,75,-1378858728,40350784,11893.77738,784169859.3,78416985.93,4,90261,3748,686,1976,1290,686,90261,1290,1976,227.5502392,3.148325359,9.267942584,45322.52632,1657.406699,12.54545455,98905.97608,0.455083565,0.016649277,0.000127961,0.652834008,0.021892069,30,8
D:1| T0: 0.10| T1: 515.00| I0: 300.0| I1: 75.0| WTP: 250000,1,0.096153846,515,250000,1,0.2,300,75,-1265754340,804064356,9606.088596,785449910.1,78544991.01,4,84018,3843,543,1595,1052,543,84018,1052,1595,237.9466019,2.524271845,7.59223301,49044.34466,1179.524272,10.21359223,99108.40291,0.492538805,0.011823978,0.00010408,0.659561129,0.018984253,30,8
D:1| T0: 0.10| T1: 515.00| I0: 300.0| I1: 75.0| WTP: 250000,1,0.096153846,515,250000,1,0.2,300,75,-2331947281,2125493986,8649.150374,1899489762,189948976.2,14,63932,2705,1240,1437,197,1240,63932,197,1437,32.58226601,1.058128079,1.24729064,49397.36453,199.6778325,2.462068966,98869.31921,0.498995427,0.002011811,2.65414E-05,0.137091162,0.022477007,145,21
D:1| T0: 0.10| T1: 515.00| I0: 300.0| I1: 75.0| WTP: 250000,1,0.096153846,515,250000,1,0.2,300,75,-1238899457,23154253,9166.195974,780589658.5,78058965.85,4,78757,3560,713,1522,809,713,78757,809,1522,180.2627451,2.670588235,5.815686275,47154.9451,824.9607843,8.62745098,99039.89804,0.474417196,0.0082769,8.79372E-05,0.531537451,0.019325266,37,8
D:1| T0: 0.10| T1: 515.00| I0: 300.0| I1: 75.0| WTP: 250000,1,0.096153846,515,250000,1,0.2,300,75,-2755950763,1391367689,6766.848443,2417608341,241760834.1,14,52828,2399,1124,1124,0,1124,52828,0,1124,24.5394402,0.774385072,0.774385072,63675.82103,150.6361323,1.736217133,99239.38592,0.64116437,0.001515903,1.91582E-05,0,0.021276596,169,27
D:1| T0: 0.10| T1: 515.00| I0: 300.0| I1: 75.0| WTP: 250000,1,0.096153846,515,250000,1,0.2,300,75,-1552896132,574142276,8711.360882,1117328088,111732808.8,6,68260,3027,1028,1447,419,1028,68260,419,1447,58.45525903,1.489795918,2.128728414,45664.82418,492.7974882,3.739403454,98876.81319,0.460916927,0.004956339,3.90818E-05,0.289564616,0.021198359,91,12
D:1| T0: 0.10| T1: 515.00| I0: 300.0| I1: 75.0| WTP: 250000,1,0.096153846,515,250000,1,0.2,300,75,-5299999945,898736779,6779.224515,4961038719,496103871.9,28,52993,2354,1126,1126,0,1126,52993,0,1126,15.54098361,0.376536885,0.376536885,67936.28074,202.0240779,0.967213115,99315.54918,0.683538202,0.002033281,1.15962E-05,0,0.021248089,279,56
D:1| T0: 0.10| T1: 515.00| I0: 300.0| I1: 75.0| WTP: 250000,1,0.096153846,515,250000,1,0.2,300,75,-1592145177,346473503,9107.904737,1136749940,113674994,6,83659,3995,705,1512,807,705,83659,807,1512,187.6121673,2.558935361,5.593155894,47566.31939,1805.48289,8.281368821,99124.53992,0.477771188,0.018116781,8.4613E-05,0.533730159,0.018073369,38,12
D:1| T0: 0.10| T1: 515.00| I0: 300.0| I1: 75.0| WTP: 250000,1,0.096153846,515,250000,1,0.2,300,75,-1614837646,445552282,9771.244653,1126275413,112627541.3,6,74932,3334,1023,1623,600,1023,74932,600,1623,92.79039301,2.100436681,3.390829694,44598.56332,935.5764192,5.626637555,98843.41703,0.449686464,0.009411044,5.81305E-05,0.369685767,0.021659638,65,12
D:1| T0: 0.10| T1: 515.00| I0: 300.0| I1: 75.0| WTP: 250000,1,0.096153846,515,250000,1,0.2,300,75,-1357914148,911758476,11272.52828,794287734,79428773.4,4,92384,4221,734,1872,1138,734,92384,1138,1872,299.1277778,3.994444444,10.21111111,32892.38889,1436.666667,14.30555556,98743.08889,0.331642215,0.014415871,0.000145371,0.607905983,0.020263249,26,8
D:1| T0: 0.10| T1: 515.00| I0: 300.0| I1: 75.0| WTP: 250000,1,0.096153846,515,250000,1,0.2,300,75,-1381815226,1464197940,11687.88935,797420758.4,79742075.84,4,96108,4386,679,1941,1262,679,96108,1262,1941,277.2636816,3.278606965,9.527363184,38605.37313,2774.383085,12.90547264,98875.17413,0.387457565,0.027857109,0.000130907,0.650180319,0.020196029,29,8
D:1| T0: 0.10| T1: 515.00| I0: 300.0| I1: 75.0| WTP: 250000,1,0.096153846,515,250000,1,0.2,300,75,-2157215311,500405854,8602.106739,1727109974,172710997.4,10,64737,2778,1305,1429,124,1305,64737,124,1429,42.48473748,1.407814408,1.550671551,52814.27595,319.0744811,3.153846154,98978.18926,0.532806081,0.003212112,3.35824E-05,0.086773968,0.02207393,117,19
D:1| T0: 0.10| T1: 515.00| I0: 300.0| I1: 75.0| WTP: 250000,1,0.096153846,515,250000,1,0.2,300,75,-1367557469,772037341,11777.84409,778665265.1,77866526.51,4,84909,3608,627,1957,1330,627,84909,1330,1957,214.6699029,2.917475728,9.32038835,47682.80583,1350.533981,12.36893204,98881.03398,0.47935571,0.013564432,0.000125993,0.67961165,0.023048205,30,8
D:1| T0: 0.10| T1: 515.00| I0: 300.0| I1: 75.0| WTP: 250000,1,0.096153846,515,250000,1,0.2,300,75,-4542358401,1543158763,5815.648216,4251575990,425157599,24,46592,2090,966,966,0,966,46592,0,966,12.99898063,0.321100917,0.321100917,71017.30275,115.1666667,0.806829766,99399.99032,0.71405103,0.001159198,9.8898E-06,0,0.020733173,281,48
D:1| T0: 0.10| T1: 515.00| I0: 300.0| I1: 75.0| WTP: 250000,1,0.096153846,515,250000,1,0.2,300,75,-1456046314,1604932531,13319.00724,790095952.1,79009595.21,4,94892,4067,764,2213,1449,764,94892,1449,2213,253.65,3.76,10.935,33670.975,1394.895,14.74,98553.945,0.33912986,0.014029531,0.000149718,0.654767284,0.023321249,29,8
D:1| T0: 0.10| T1: 515.00| I0: 300.0| I1: 75.0| WTP: 250000,1,0.096153846,515,250000,1,0.2,300,75,-1368832810,539051477,11601.00889,788782365.3,78878236.53,4,91936,4058,718,1927,1209,718,91936,1209,1927,224.8883929,3.107142857,8.446428571,42742.0625,2343.183036,11.64285714,98910.42857,0.429129865,0.02354521,0.000118658,0.627400104,0.020960233,32,8
D:1| T0: 0.10| T1: 515.00| I0: 300.0| I1: 75.0| WTP: 250000,1,0.096153846,515,250000,1,0.2,300,75,-3878595335,1743124675,6418.638049,3557663432,355766343.2,26,52538,2397,1066,1066,0,1066,52538,0,1066,20.0690589,0.524035206,0.524035206,69818.38186,120.8070413,1.254570074,99398.7522,0.701892992,0.001216146,1.45021E-05,0,0.020290076,211,40
D:1| T0: 0.10| T1: 515.00| I0: 300.0| I1: 75.0| WTP: 250000,1,0.096153846,515,250000,1,0.2,300,75,-1902714697,1965983789,8728.905623,1466269416,146626941.6,8,67867,2932,1120,1450,330,1120,67867,330,1450,55.7202473,1.647604328,2.142194745,47688.49304,610.4250386,3.874806801,98911.63524,0.480975201,0.006140139,3.99464E-05,0.227586207,0.021365632,93,16
D:1| T0: 0.10| T1: 515.00| I0: 300.0| I1: 75.0| WTP: 250000,1,0.096153846,515,250000,1,0.2,300,75,-3494924879,516774280,7458.529078,3121998425,312199842.5,18,59459,2500,1215,1239,24,1215,59459,24,1239,21.30694444,0.685416667,0.7,53736.43542,264.8694444,1.536111111,99042.0875,0.542040157,0.002665656,1.7136E-05,0.01937046,0.020837888,205,35
D:1| T0: 0.10| T1: 515.00| I0: 300.0| I1: 75.0| WTP: 250000,1,0.096153846,515,250000,1,0.2,300,75,-1167754674,86603142,11161.37223,609686062.4,60968606.24,4,87856,3773,609,1854,1245,609,87856,1245,1854,266.8232044,3.281767956,10.1160221,31717.18785,1258.834254,13.4640884,98647.71823,0.320517154,0.012628341,0.000136634,0.671521036,0.021102714,26,6
D:1| T0: 0.10| T1: 515.00| I0: 300.0| I1: 75.0| WTP: 250000,1,0.096153846,515,250000,1,0.2,300,75,-7162636077,1431870609,7176.227024,6803824726,680382472.6,40,57913,2575,1192,1192,0,1192,57913,0,1192,12.34207436,0.294716243,0.294716243,62932.79569,155.5690802,0.762818004,99235.70607,0.633608916,0.00156704,9.38298E-06,0,0.020582598,365,77
D:1| T0: 0.10| T1: 515.00| I0: 300.0| I1: 75.0| WTP: 250000,1,0.096153846,515,250000,1,0.2,300,75,-1462335722,1592383984,8562.609011,1034205271,103420527.1,6,71495,3274,720,1422,702,720,71495,702,1422,151.4736842,2.609022556,5.206766917,55176.14286,784.5451128,7.921052632,99162.36466,0.55479237,0.007870511,8.07942E-05,0.493670886,0.019889503,38,11
D:1| T0: 0.10| T1: 515.00| I0: 300.0| I1: 75.0| WTP: 250000,1,0.096153846,515,250000,1,0.2,300,75,-1767203152,1440183867,7803.491912,1377028557,137702855.7,8,65064,2865,991,1296,305,991,65064,305,1296,49.82724719,1.293539326,1.703651685,47242.54354,440.7457865,3.092696629,98967.26404,0.476651379,0.004432179,3.22866E-05,0.235339506,0.019918849,102,15
D:1| T0: 0.10| T1: 515.00| I0: 300.0| I1: 75.0| WTP: 250000,1,0.096153846,515,250000,1,0.2,300,75,-1888403916,1696510588,8499.729687,1463417431,146341743.1,8,65038,2772,1094,1412,318,1094,65038,318,1412,49.20114123,1.420827389,1.858773181,49760.97004,436.7974322,3.415121255,98930.56776,0.502040875,0.004394225,3.59543E-05,0.225212465,0.021710385,101,16
D:1| T0: 0.10| T1: 515.00| I0: 300.0| I1: 75.0| WTP: 250000,1,0.096153846,515,250000,1,0.2,300,75,-1633756735,895039877,11713.93475,1048059997,104805999.7,6,88813,3764,680,1946,1266,680,88813,1266,1946,224.0511628,3.079069767,8.925581395,44694.49767,2177,12.06511628,98899.50233,0.448994111,0.021872122,0.00012275,0.650565262,0.021911207,31,11
D:1| T0: 0.10| T1: 515.00| I0: 300.0| I1: 75.0| WTP: 250000,1,0.096153846,515,250000,1,0.2,300,75,-2265430852,129565953,9004.636664,1815199019,181519901.9,10,66524,2823,1253,1496,243,1253,66524,243,1496,38.05452563,1.264994547,1.521264995,45386.32279,512.2104689,2.895310796,98797.23119,0.458453647,0.005156351,3.01702E-05,0.162433155,0.022488125,130,20
D:1| T0: 0.10| T1: 515.00| I0: 300.0| I1: 75.0| WTP: 250000,1,0.096153846,515,250000,1,0.2,300,75,-2082384895,1902565669,7124.353753,1726167208,172616720.8,10,62764,2790,1061,1183,122,1061,62764,122,1183,28.43556281,0.728384992,0.823001631,48484.5571,197.0464927,1.686786297,99035.59054,0.489086351,0.001982965,1.8397E-05,0.103127642,0.018848384,176,19
D:1| T0: 0.10| T1: 515.00| I0: 300.0| I1: 75.0| WTP: 250000,1,0.096153846,515,250000,1,0.2,300,75,-5380375202,1984179288,8288.29071,4965960667,496596066.7,28,62053,2605,1376,1377,1,1376,62053,1,1377,16.53113924,0.511898734,0.511898734,58121.04203,237.6491139,1.20556962,99071.94177,0.586041062,0.0023944,1.40287E-05,0.000726216,0.022190708,283,56
D:1| T0: 0.10| T1: 515.00| I0: 300.0| I1: 75.0| WTP: 250000,1,0.096153846,515,250000,1,0.2,300,75,-1672883771,677377223,10776.64854,1134051344,113405134.4,6,84378,3760,982,1790,808,982,84378,808,1790,137.5146199,2.754385965,5.076023392,44094.5,2006.149123,7.964912281,98893.07018,0.443490911,0.020177447,8.15647E-05,0.451396648,0.021214061,48,12
D:1| T0: 0.10| T1: 515.00| I0: 300.0| I1: 75.0| WTP: 250000,1,0.096153846,515,250000,1,0.2,300,75,-1636446099,973583301,10114.98174,1130697012,113069701.2,6,83161,3652,1049,1680,631,1049,83161,631,1680,116.6813472,2.593264249,4.191709845,43396.62953,1753.088083,6.904145078,98924.07772,0.436575097,0.017627865,7.11207E-05,0.375595238,0.020201777,56,12
D:1| T0: 0.10| T1: 515.00| I0: 300.0| I1: 75.0| WTP: 250000,1,0.096153846,515,250000,1,0.2,300,75,-1856171829,781062938,7679.789883,1472182335,147218233.5,8,67209,3246,1026,1275,249,1026,67209,249,1275,49.92288557,1.143034826,1.446517413,45508.20274,385.210199,2.715174129,98990.48507,0.459033208,0.003873499,2.87656E-05,0.195294118,0.018970674,115,16
D:1| T0: 0.10| T1: 515.00| I0: 300.0| I1: 75.0| WTP: 250000,1,0.096153846,515,250000,1,0.2,300,75,-1955668869,338783425,9537.685585,1478784589,147878458.9,8,78335,3480,1117,1584,467,1117,78335,467,1584,112.8989637,2.764248705,3.917098446,51237.18135,1650.994819,6.821243523,99078.8057,0.515062453,0.016597431,7.03429E-05,0.294823232,0.020220846,56,16
D:1| T0: 0.10| T1: 515.00| I0: 300.0| I1: 75.0| WTP: 250000,1,0.096153846,515,250000,1,0.2,300,75,-6385254846,1027579040,7327.687648,6018870464,601887046.4,34,60388,2755,1217,1217,0,1217,60388,0,1217,15.22788809,0.375902527,0.375902527,60704.84477,204.8185921,0.920577617,99202.22022,0.611390348,0.002062565,1.1046E-05,0,0.020153011,316,68
D:1| T0: 0.10| T1: 515.00| I0: 300.0| I1: 75.0| WTP: 250000,1,0.096153846,515,250000,1,0.2,300,75,-1929482539,764973813,9103.822861,1474291396,147429139.6,8,73054,3240,1051,1512,461,1051,73054,461,1512,84.37654321,2.047325103,2.979423868,48412.15638,1025.329218,5.148148148,98978.14198,0.487535729,0.010308046,5.30212E-05,0.30489418,0.020697302,69,16
D:1| T0: 0.10| T1: 515.00| I0: 300.0| I1: 75.0| WTP: 250000,1,0.096153846,515,250000,1,0.2,300,75,-1636982850,1245753446,10126.8896,1130638370,113063837,6,82957,3589,791,1682,891,791,82957,891,1682,146.1483871,2.432258065,5.270967742,44432.0129,1834.8,7.822580645,98945.21935,0.446895393,0.018438291,8.02072E-05,0.529726516,0.020275809,45,12
D:1| T0: 0.10| T1: 515.00| I0: 300.0| I1: 75.0| WTP: 250000,1,0.096153846,515,250000,1,0.2,300,75,-1558974130,1013177794,8890.602571,1114444001,111444400.1,6,67359,2884,1090,1477,387,1090,67359,387,1477,54.01221374,1.523664122,2.097709924,46385.86107,428.5923664,3.766412214,98854.17252,0.468359867,0.004312399,3.94282E-05,0.262017603,0.021927285,94,12
D:1| T0: 0.10| T1: 515.00| I0: 300.0| I1: 75.0| WTP: 250000,1,0.096153846,515,250000,1,0.2,300,75,-5211337294,1395089249,6897.128602,4866480864,486648086.4,28,50510,2088,1146,1146,0,1146,50510,0,1146,13.69466455,0.421024828,0.421024828,70101.06075,139.6217644,1.027997887,99321.77496,0.70523377,0.001406061,1.21711E-05,0,0.022688577,271,55
D:1| T0: 0.10| T1: 515.00| I0: 300.0| I1: 75.0| WTP: 250000,1,0.096153846,515,250000,1,0.2,300,75,-5241676617,1339545835,5797.213312,4951815951,495181595.1,28,45584,2059,963,963,0,963,45584,0,963,9.435483871,0.194298575,0.194298575,74161.59265,130.4789947,0.562265566,99460.59977,0.745201395,0.00131311,7.25652E-06,0,0.021126297,381,56
D:1| T0: 0.10| T1: 515.00| I0: 300.0| I1: 75.0| WTP: 250000,1,0.096153846,515,250000,1,0.2,300,75,-1332052832,219139554,10832.89656,790408004.2,79040800.42,4,90154,4019,758,1799,1041,758,90154,1041,1799,289.5,4.191011236,9.938202247,41275.98315,1331.713483,14.19101124,98921.76404,0.415222809,0.01335809,0.000144089,0.578654808,0.019954744,26,8
D:1| T0: 0.10| T1: 515.00| I0: 300.0| I1: 75.0| WTP: 250000,1,0.096153846,515,250000,1,0.2,300,75,-2711186587,1336508942,7572.459127,2332563631,233256363.1,14,57278,2431,1234,1258,24,1234,57278,24,1258,26.04471195,0.864144454,0.884780739,57634.92347,198.5546002,1.953568358,99094.06105,0.581072246,0.001998411,2.15442E-05,0.019077901,0.021963057,167,26
D:1| T0: 0.10| T1: 515.00| I0: 300.0| I1: 75.0| WTP: 250000,1,0.096153846,515,250000,1,0.2,300,75,-5244032812,448559423,6022.698943,4942897865,494289786.5,28,39291,1583,1001,1001,0,1001,39291,0,1001,11.16463768,0.411594203,0.411594203,74423.32348,176.9872464,0.991304348,99346.53217,0.748738381,0.001780433,1.16573E-05,0,0.025477221,247,56
D:1| T0: 0.10| T1: 515.00| I0: 300.0| I1: 75.0| WTP: 250000,1,0.096153846,515,250000,1,0.2,300,75,-1911483973,2110028840,8879.417722,1467513087,146751308.7,8,69517,3061,1230,1475,245,1230,69517,245,1475,51.83779972,1.576868829,1.902679831,47762.10014,479.5430183,3.631875882,98924.52186,0.481801812,0.004825597,3.83819E-05,0.166101695,0.021217832,102,16
D:1| T0: 0.10| T1: 515.00| I0: 300.0| I1: 75.0| WTP: 250000,1,0.096153846,515,250000,1,0.2,300,75,-1967411288,1982030155,9996.479795,1467587298,146758729.8,8,71617,2963,1139,1661,522,1139,71617,522,1661,88.08192771,2.621686747,3.848192771,52236.53012,1148.144578,6.590361446,98944.50602,0.526119546,0.01155041,6.78709E-05,0.314268513,0.023192817,60,16
D:1| T0: 0.10| T1: 515.00| I0: 300.0| I1: 75.0| WTP: 250000,1,0.096153846,515,250000,1,0.2,300,75,-1494538539,696219407,9258.390737,1031619002,103161900.2,6,70261,3097,714,1538,824,714,70261,824,1538,126.9605263,2.220394737,4.904605263,54283.64803,771.1151316,7.236842105,99049.41118,0.546300187,0.007742379,7.43982E-05,0.535760728,0.021889811,44,11
D:1| T0: 0.10| T1: 515.00| I0: 300.0| I1: 75.0| WTP: 250000,1,0.096153846,515,250000,1,0.2,300,75,-1324873222,1402539442,10665.09851,791618296.9,79161829.69,4,93537,4147,701,1771,1070,701,93537,1070,1771,257.9359606,3.359605911,8.586206897,42599.54187,2112.738916,12.03448276,99011.71921,0.427492934,0.021198924,0.000122191,0.60417843,0.018933684,29,8
D:1| T0: 0.10| T1: 515.00| I0: 300.0| I1: 75.0| WTP: 250000,1,0.096153846,515,250000,1,0.2,300,75,-1702737195,1319833493,11276.57542,1138908424,113890842.4,6,88725,3972,714,1873,1159,714,88725,1159,1873,196.827451,2.701960784,7.207843137,40723.70196,2354.388235,9.992156863,98841.07059,0.40941903,0.023663899,0.00010201,0.61879338,0.021110172,37,12
D:1| T0: 0.10| T1: 515.00| I0: 300.0| I1: 75.0| WTP: 250000,1,0.096153846,515,250000,1,0.2,300,75,-2462133129,663608076,7760.14677,2074125791,207412579.1,12,60852,2650,1168,1289,121,1168,60852,121,1289,30.06581353,0.945155393,1.052102377,50057.04753,335.6224863,2.111517367,98954.39945,0.505241563,0.003377162,2.25833E-05,0.093871218,0.021182541,157,23
D:1| T0: 0.10| T1: 515.00| I0: 300.0| I1: 75.0| WTP: 250000,1,0.096153846,515,250000,1,0.2,300,75,-2500895823,414696500,6858.043287,2157993658,215799365.8,12,55370,2418,1130,1139,9,1130,55370,9,1139,20.00129032,0.594193548,0.600645161,56238.34129,246.8509677,1.330967742,99117.61806,0.566909465,0.002483168,1.47126E-05,0.007901668,0.020570706,221,24
D:1| T0: 0.10| T1: 515.00| I0: 300.0| I1: 75.0| WTP: 250000,1,0.096153846,515,250000,1,0.2,300,75,-3846014939,1249738535,7606.414995,3465694189,346569418.9,20,50863,2100,1264,1264,0,1264,50863,0,1264,20.01587302,0.745275888,0.745275888,70806.91459,152.7097506,1.700680272,99284.35374,0.712542256,0.001538173,1.9215E-05,0,0.024851071,189,39
D:1| T0: 0.10| T1: 515.00| I0: 300.0| I1: 75.0| WTP: 250000,1,0.096153846,515,250000,1,0.2,300,75,-2512606758,614415382,7121.853711,2156514073,215651407.3,12,54642,2388,1143,1183,40,1143,54642,40,1183,30.95233161,1.029015544,1.07357513,58572.3544,356.9958549,2.250777202,99118.19171,0.590290581,0.003589956,2.42214E-05,0.033812342,0.021650013,138,24
D:1| T0: 0.10| T1: 515.00| I0: 300.0| I1: 75.0| WTP: 250000,1,0.096153846,515,250000,1,0.2,300,75,-4899140789,524899953,5782.168326,4610032373,461003237.3,26,51748,2423,960,960,0,960,51748,0,960,15.24811652,0.313912607,0.313912607,65961.34003,150.4098443,0.787041688,99379.97187,0.66329073,0.00151299,9.68499E-06,0,0.018551442,285,52
D:1| T0: 0.10| T1: 515.00| I0: 300.0| I1: 75.0| WTP: 250000,1,0.096153846,515,250000,1,0.2,300,75,-1298416506,1338977757,11848.84101,705974455.5,70597445.55,4,93037,4177,742,1968,1226,742,93037,1226,1968,246.6805556,3.384259259,9,30919.31944,1130.555556,12.43518519,98616.37963,0.311861299,0.011361959,0.000126125,0.62296748,0.021152875,31,7
D:1| T0: 0.10| T1: 515.00| I0: 300.0| I1: 75.0| WTP: 250000,1,0.096153846,515,250000,1,0.2,300,75,-1591392250,341384587,9462.256,1118279450,111827945,6,71935,3085,865,1572,707,865,71935,707,1572,64.07445008,1.304568528,2.485617597,41714.67174,415.0203046,3.947546531,98747.12521,0.421626689,0.004177007,4.15014E-05,0.449745547,0.021853366,85,12
D:1| T0: 0.10| T1: 515.00| I0: 300.0| I1: 75.0| WTP: 250000,1,0.096153846,515,250000,1,0.2,300,75,-1939928387,2032000160,9355.371822,1472159796,147215979.6,8,73150,3178,1100,1554,454,1100,73150,454,1554,92.42757009,2.453271028,3.478971963,48971.89019,1159.079439,6.039719626,98962.89019,0.493264602,0.011655925,6.23514E-05,0.292149292,0.021244019,62,16
D:1| T0: 0.10| T1: 515.00| I0: 300.0| I1: 75.0| WTP: 250000,1,0.096153846,515,250000,1,0.2,300,75,-1397049287,779488939,12224.57154,785820710.3,78582071.03,4,91732,3912,625,2031,1406,625,91732,1406,2031,228.8679245,2.844339623,9.438679245,44968.23113,1638.759434,12.38207547,98888.78302,0.451296361,0.016466312,0.000125932,0.692269818,0.022140583,31,8
D:1| T0: 0.10| T1: 515.00| I0: 300.0| I1: 75.0| WTP: 250000,1,0.096153846,515,250000,1,0.2,300,75,-2483281258,1449019578,8275.10685,2069525915,206952591.5,12,60327,2451,1272,1375,103,1272,60327,103,1375,19.28543814,0.699097938,0.762886598,49107.41366,241.1804124,1.575386598,98855.40657,0.496226808,0.00242889,1.71623E-05,0.074909091,0.022792448,221,23
D:1| T0: 0.10| T1: 515.00| I0: 300.0| I1: 75.0| WTP: 250000,1,0.096153846,515,250000,1,0.2,300,75,-4208031251,351952211,5998.18066,3908122217,390812221.7,22,51584,2358,996,996,0,996,51584,0,996,16.58073497,0.384187082,0.384187082,69843.86136,126.6185969,0.934855234,99418.5206,0.702074844,0.001274416,1.11406E-05,0,0.019308313,257,44
D:1| T0: 0.10| T1: 515.00| I0: 300.0| I1: 75.0| WTP: 250000,1,0.096153846,515,250000,1,0.2,300,75,-3227602078,486595046,7368.510386,2859176558,285917655.8,16,56559,2479,1213,1224,11,1213,56559,11,1224,20.1704918,0.655081967,0.66295082,56220.52131,306.7259016,1.459016393,99059.28393,0.566906599,0.0030864,1.60678E-05,0.008986928,0.021641501,216,32
D:1| T0: 0.10| T1: 515.00| I0: 300.0| I1: 75.0| WTP: 250000,1,0.096153846,515,250000,1,0.2,300,75,-1825607656,296745624,8891.755235,1381019894,138101989.4,8,71097,3074,991,1477,486,991,71097,486,1477,69.36095764,1.703499079,2.572744015,44953.53591,642.8213628,4.405156538,98891.53223,0.45344578,0.006463983,4.57015E-05,0.329045362,0.020774435,78,15
D:1| T0: 0.10| T1: 515.00| I0: 300.0| I1: 75.0| WTP: 250000,1,0.096153846,515,250000,1,0.2,300,75,-3195136268,1671484194,6737.557748,2858258381,285825838.1,16,55663,2502,1116,1119,3,1116,55663,3,1119,20.52454607,0.580363147,0.581708137,59912.5965,192.2212508,1.324142569,99208.10424,0.603485928,0.001934097,1.51045E-05,0.002680965,0.020103121,213,32
D:1| T0: 0.10| T1: 515.00| I0: 300.0| I1: 75.0| WTP: 250000,1,0.096153846,515,250000,1,0.2,300,75,-1400656959,422157396,12131.22765,794095577.1,79409557.71,4,96591,4263,730,2015,1285,730,96591,1285,2015,303.9602273,4.085227273,11.3125,36754.43182,2040.965909,15.46022727,98801.69318,0.369351593,0.02049057,0.000156608,0.637717122,0.020861157,26,8
D:1| T0: 0.10| T1: 515.00| I0: 300.0| I1: 75.0| WTP: 250000,1,0.096153846,515,250000,1,0.2,300,75,-1402373523,1916599091,12202.70418,792238313.8,79223831.38,4,94779,4116,740,2027,1287,740,94779,1287,2027,278.4787234,3.877659574,10.63297872,35077.48936,1759.478723,14.56382979,98720.57979,0.353014342,0.017671537,0.000147862,0.634928466,0.021386594,27,8
D:1| T0: 0.10| T1: 515.00| I0: 300.0| I1: 75.0| WTP: 250000,1,0.096153846,515,250000,1,0.2,300,75,-1394522098,1005953941,12016.98896,793672650.1,79367265.01,4,96439,4253,739,1996,1257,739,96439,1257,1996,300.8587571,4.107344633,11.1299435,35529.49153,2208.711864,15.31638418,98792.36723,0.357169885,0.022171188,0.000155156,0.629759519,0.020697021,26,8
D:1| T0: 0.10| T1: 515.00| I0: 300.0| I1: 75.0| WTP: 250000,1,0.096153846,515,250000,1,0.2,300,75,-1351808627,1422765615,11418.30215,780893519.3,78089351.93,4,84828,3612,733,1897,1164,733,84828,1164,1897,138.1939394,2.115151515,5.615151515,35722.34242,890.2272727,7.851515152,98624.77576,0.360262854,0.008957915,8.01868E-05,0.613600422,0.022362899,48,8
D:1| T0: 0.10| T1: 515.00| I0: 300.0| I1: 75.0| WTP: 250000,1,0.096153846,515,250000,1,0.2,300,75,-4886891185,699740192,5795.991131,4597091629,459709162.9,26,42969,1771,963,963,0,963,42969,0,963,10.54771979,0.291020216,0.291020216,71785.33992,120.1029619,0.748942172,99373.40009,0.721977048,0.001208801,9.09449E-06,0,0.022412028,304,52
D:1| T0: 0.10| T1: 515.00| I0: 300.0| I1: 75.0| WTP: 250000,1,0.096153846,515,250000,1,0.2,300,75,-5240659055,240885764,5749.642757,4953176917,495317691.7,28,48207,2162,955,955,0,955,48207,0,955,11.61866308,0.248990579,0.248990579,70124.22252,132.2131,0.67833109,99413.66128,0.704963911,0.00133034,8.60608E-06,0,0.019789657,319,56
D:1| T0: 0.10| T1: 515.00| I0: 300.0| I1: 75.0| WTP: 250000,1,0.096153846,515,250000,1,0.2,300,75,-1584343244,2023806564,9152.798641,1126703312,112670331.2,6,75258,3396,960,1520,560,960,75258,560,1520,95.45777778,2.011111111,3.222222222,42319.47111,696.26,5.357777778,98873.16889,0.426830896,0.007001431,5.5422E-05,0.368421053,0.020197188,65,12
D:1| T0: 0.10| T1: 515.00| I0: 300.0| I1: 75.0| WTP: 250000,1,0.096153846,515,250000,1,0.2,300,75,-3551299922,1907493879,6916.627072,3205468568,320546856.8,18,53805,2283,1149,1149,0,1149,53805,0,1149,17.26670717,0.532199271,0.532199271,61713.61118,204.0874848,1.230862697,99179.94836,0.621749424,0.002054015,1.40331E-05,0,0.021354893,235,36
D:1| T0: 0.10| T1: 515.00| I0: 300.0| I1: 75.0| WTP: 250000,1,0.096153846,515,250000,1,0.2,300,75,-2006116322,1565815291,10623.41755,1474945445,147494544.5,8,76751,3304,1108,1765,657,1108,76751,657,1765,121.8869048,3.175595238,5.077380952,53762.17857,1840.910714,8.375,99013.96131,0.540680734,0.018513514,8.60053E-05,0.37223796,0.022996443,48,16
D:1| T0: 0.10| T1: 515.00| I0: 300.0| I1: 75.0| WTP: 250000,1,0.096153846,515,250000,1,0.2,300,75,-4873746954,784442364,5460.864621,4600703723,460070372.3,26,45248,1983,907,907,0,907,45248,0,907,14.93470375,0.362756953,0.362756953,71089.88392,144.5501814,0.899637243,99432.29202,0.714611974,0.001453692,1.10106E-05,0,0.020045085,236,52
D:1| T0: 0.10| T1: 515.00| I0: 300.0| I1: 75.0| WTP: 250000,1,0.096153846,515,250000,1,0.2,300,75,-1328696419,206369745,10808.1209,788290373.8,78829037.38,4,89831,3978,651,1795,1144,651,89831,1144,1795,221.8854626,2.748898678,7.735682819,43566.67401,1652.828194,10.59911894,98966.01322,0.437483646,0.016592473,0.000108216,0.637325905,0.019981966,33,8
D:1| T0: 0.10| T1: 515.00| I0: 300.0| I1: 75.0| WTP: 250000,1,0.096153846,515,250000,1,0.2,300,75,-1399854953,2087235992,12154.60119,792124894.1,79212489.41,4,96085,4163,716,2019,1303,716,96085,1303,2019,244.4439252,3.271028037,9.299065421,35212.33178,1958.341121,12.64485981,98751.13084,0.353717758,0.019681409,0.000128441,0.645368995,0.021012645,31,8
D:1| T0: 0.10| T1: 515.00| I0: 300.0| I1: 75.0| WTP: 250000,1,0.096153846,515,250000,1,0.2,300,75,-1888918648,1019092536,8428.974663,1467469915,146746991.5,8,68486,3012,1175,1400,225,1175,68486,225,1400,47.73514212,1.351421189,1.630490956,47432.21189,489.2596899,3.147286822,98953.3553,0.478391663,0.004922074,3.34598E-05,0.160714286,0.020442433,111,16
D:1| T0: 0.10| T1: 515.00| I0: 300.0| I1: 75.0| WTP: 250000,1,0.096153846,515,250000,1,0.2,300,75,-1516146340,1885906113,8126.405233,1109826079,110982607.9,6,62004,2636,1026,1350,324,1026,62004,324,1350,66.26868687,1.884848485,2.525252525,53878.5596,383.0848485,4.612121212,99027.85657,0.543218206,0.00385044,4.82333E-05,0.24,0.021774545,71,12
D:1| T0: 0.10| T1: 515.00| I0: 300.0| I1: 75.0| WTP: 250000,1,0.096153846,515,250000,1,0.2,300,75,-4024280111,2028637200,7412.297276,3653665248,365366524.8,24,61780,2774,1230,1231,1,1230,61780,1,1231,21.3985056,0.580946451,0.581569116,55828.14508,148.143213,1.350560399,99124.48319,0.562642346,0.00149219,1.54089E-05,0.000812348,0.019925542,230,41
D:1| T0: 0.10| T1: 515.00| I0: 300.0| I1: 75.0| WTP: 250000,1,0.096153846,515,250000,1,0.2,300,75,-1348419305,181476086,11216.21996,787608306.9,78760830.69,4,90943,4062,602,1863,1261,602,90943,1261,1863,222.6339286,2.558035714,8.147321429,41150.10714,1895.102679,10.85267857,98895.33036,0.413318973,0.019025792,0.000110546,0.676865271,0.020485359,32,8
D:1| T0: 0.10| T1: 515.00| I0: 300.0| I1: 75.0| WTP: 250000,1,0.096153846,515,250000,1,0.2,300,75,-1373254053,2097578470,11685.14698,788996704.4,78899670.44,4,89677,4071,709,1941,1232,709,89677,1232,1941,204.465587,2.761133603,7.71659919,39028.49798,1979.57085,10.57894737,98772.87449,0.392509754,0.019896899,0.00010786,0.634724369,0.021644346,36,8
D:1| T0: 0.10| T1: 515.00| I0: 300.0| I1: 75.0| WTP: 250000,1,0.096153846,515,250000,1,0.2,300,75,-1918339302,119646392,9058.946356,1465391984,146539198.4,8,66491,2790,1175,1505,330,1175,66491,330,1505,68.68023256,2.147286822,2.763565891,53410.46705,806.5620155,5.044573643,98979.2345,0.538191609,0.008112949,5.22235E-05,0.219269103,0.022634642,74,16
D:1| T0: 0.10| T1: 515.00| I0: 300.0| I1: 75.0| WTP: 250000,1,0.096153846,515,250000,1,0.2,300,75,-1370247682,1298895859,11601.48818,790173272.4,79017327.24,4,93306,4115,776,1927,1151,776,93306,1151,1927,241.3113208,3.566037736,8.938679245,37637.36321,1834.410377,12.61320755,98806.64151,0.378343302,0.018428409,0.000128055,0.597301505,0.020652477,31,8
D:1| T0: 0.10| T1: 515.00| I0: 300.0| I1: 75.0| WTP: 250000,1,0.096153846,515,250000,1,0.2,300,75,-1281086956,1489316290,10024.69192,779852360.3,77985236.03,4,79345,3565,660,1665,1005,660,79345,1005,1665,180.0277778,2.492063492,6.44047619,46518.76587,1094.714286,9.075396825,98935.94841,0.468242795,0.010993592,9.26423E-05,0.603603604,0.020984309,36,8
D:1| T0: 0.10| T1: 515.00| I0: 300.0| I1: 75.0| WTP: 250000,1,0.096153846,515,250000,1,0.2,300,75,-1452302520,855602142,13311.86476,786709281.5,78670928.15,4,96804,3861,655,2212,1557,655,96804,1557,2212,211.2857143,2.761904762,9.454545455,32627.65368,1496.593074,12.29004329,98553.32468,0.327857515,0.015056015,0.000124876,0.703887884,0.022850295,33,8
D:1| T0: 0.10| T1: 515.00| I0: 300.0| I1: 75.0| WTP: 250000,1,0.096153846,515,250000,1,0.2,300,75,-1894139245,1438649896,8507.478514,1468765319,146876531.9,8,68900,3023,1031,1413,382,1031,68900,382,1413,67.20284698,1.722419929,2.393238434,47425.13879,623.475089,4.229537367,98950.07651,0.478202688,0.006269348,4.37207E-05,0.27034678,0.020507983,80,16
D:1| T0: 0.10| T1: 515.00| I0: 300.0| I1: 75.0| WTP: 250000,1,0.096153846,515,250000,1,0.2,300,75,-5933650464,952489126,7323.417812,5567479573,556747957.3,32,52080,2142,1217,1217,0,1217,52080,0,1217,10.94122658,0.350511073,0.350511073,62992.73339,170.5549404,0.865843271,99147.67504,0.634840673,0.001717609,1.04253E-05,0,0.023367896,336,63
D:1| T0: 0.10| T1: 515.00| I0: 300.0| I1: 75.0| WTP: 250000,1,0.096153846,515,250000,1,0.2,300,75,-1139908859,1550779155,10709.2349,604447113.9,60444711.39,4,84344,3554,549,1779,1230,549,84344,1230,1779,228.5606061,2.666666667,8.833333333,31327.41919,1191.515152,11.61616162,98631.5101,0.317057843,0.011953381,0.00011807,0.691399663,0.021092194,29,6
D:1| T0: 0.10| T1: 515.00| I0: 300.0| I1: 75.0| WTP: 250000,1,0.096153846,515,250000,1,0.2,300,75,-5379776938,607323321,6693.965543,5045078660,504507866,30,52400,2287,1112,1112,0,1112,52400,0,1112,12.02698073,0.314775161,0.314775161,65070.84154,107.7139186,0.782012848,99263.75161,0.654977556,0.001085242,9.57374E-06,0,0.021221374,334,57
D:1| T0: 0.10| T1: 515.00| I0: 300.0| I1: 75.0| WTP: 250000,1,0.096153846,515,250000,1,0.2,300,75,-1508441244,2103646485,7946.611489,1111110670,111111067,6,62287,2719,864,1320,456,864,62287,456,1320,63.35084428,1.491557223,2.335834897,50390.0863,351.3320826,3.943714822,98970.16135,0.508481349,0.003531716,4.11747E-05,0.345454545,0.021192223,77,12
D:1| T0: 0.10| T1: 515.00| I0: 300.0| I1: 75.0| WTP: 250000,1,0.096153846,515,250000,1,0.2,300,75,-1276594682,258120157,9822.37854,785475755,78547575.5,4,86451,3878,766,1631,865,766,86451,865,1631,245.9393939,3.782828283,8.075757576,35194.74242,1110.146465,11.93939394,98852.54545,0.355139236,0.011134346,0.000121481,0.530349479,0.018866179,29,8
D:1| T0: 0.10| T1: 515.00| I0: 300.0| I1: 75.0| WTP: 250000,1,0.096153846,515,250000,1,0.2,300,75,-2905908971,1068951401,7785.492704,2516634336,251663433.6,16,64014,2897,1258,1293,35,1258,64014,35,1293,29.66889074,0.861551293,0.890742285,53350.49208,207.8790659,1.932443703,99075.64804,0.537897814,0.002092826,2.13968E-05,0.027068832,0.020198707,172,28
D:1| T0: 0.10| T1: 515.00| I0: 300.0| I1: 75.0| WTP: 250000,1,0.096153846,515,250000,1,0.2,300,75,-2226758050,635956235,8330.404531,1810237823,181023782.3,10,61109,2663,1278,1384,106,1278,61109,106,1384,28.23300971,1.028243601,1.114739629,49927.49426,410.3654016,2.240953222,98888.60724,0.504073485,0.004129585,2.3637E-05,0.076589595,0.022648426,161,20
D:1| T0: 0.10| T1: 515.00| I0: 300.0| I1: 75.0| WTP: 250000,1,0.096153846,515,250000,1,0.2,300,75,-4446304813,1346693470,5700.687944,4161270415,416127041.5,24,46252,1970,947,947,0,947,46252,0,947,12.64849127,0.329804129,0.329804129,71601.0397,125.0359979,0.832186342,99425.67178,0.719748801,0.001258039,1.00688E-05,0,0.020475233,270,47
D:1| T0: 0.10| T1: 515.00| I0: 300.0| I1: 75.0| WTP: 250000,1,0.096153846,515,250000,1,0.2,300,75,-1436811384,847102011,12905.10747,791556010.2,79155601.02,4,96205,4107,751,2144,1393,751,96205,1393,2144,273.8465608,3.899470899,11.17989418,35680.60317,1746.306878,15.15873016,98687.22751,0.35874908,0.017551088,0.000153949,0.649720149,0.022285744,27,8
D:1| T0: 0.10| T1: 515.00| I0: 300.0| I1: 75.0| WTP: 250000,1,0.096153846,515,250000,1,0.2,300,75,-1714735427,812083272,11705.96907,1129436974,112943697.4,6,83229,3514,929,1945,1016,929,83229,1016,1945,144.9046053,2.927631579,6.226973684,47286.86513,1685.930921,9.289473684,98850.78289,0.475603073,0.016966441,9.51709E-05,0.522365039,0.023369258,44,12
D:1| T0: 0.10| T1: 515.00| I0: 300.0| I1: 75.0| WTP: 250000,1,0.096153846,515,250000,1,0.2,300,75,-1329200586,2146825809,10784.68261,789966455.8,78996645.58,4,92017,4213,791,1791,1000,791,92017,1000,1791,304.4285714,4.642857143,10.5,37555.85714,1728.714286,15.19642857,98890.13095,0.378191999,0.017334485,0.000154162,0.558347292,0.019463795,24,8
D:1| T0: 0.10| T1: 515.00| I0: 300.0| I1: 75.0| WTP: 250000,1,0.096153846,515,250000,1,0.2,300,75,-1422160518,226186520,12664.04666,788958184.6,78895818.46,4,95343,4023,741,2104,1363,741,95343,1363,2104,260.0829016,3.797927461,10.79274611,37185.46114,1436.834197,14.62176166,98720.09845,0.373754352,0.014436702,0.00014812,0.647813688,0.022067692,28,8
D:1| T0: 0.10| T1: 515.00| I0: 300.0| I1: 75.0| WTP: 250000,1,0.096153846,515,250000,1,0.2,300,75,-1671403457,1110225441,10793.9403,1131706442,113170644.2,6,83782,3620,1052,1793,741,1052,83782,741,1793,109.9299517,2.446859903,4.200483092,41402.09903,1563.417874,6.734299517,98811.07971,0.416752734,0.015736354,6.91861E-05,0.413273843,0.021400778,60,12
D:1| T0: 0.10| T1: 515.00| I0: 300.0| I1: 75.0| WTP: 250000,1,0.096153846,515,250000,1,0.2,300,75,-1549218757,1190767082,8438.31671,1127302922,112730292.2,6,76949,3602,948,1401,453,948,76949,453,1401,118.9835616,2.449315068,3.660273973,47656.75068,1125.112329,6.265753425,99097.87671,0.479408559,0.011297258,6.46439E-05,0.323340471,0.018206864,53,12
D:1| T0: 0.10| T1: 515.00| I0: 300.0| I1: 75.0| WTP: 250000,1,0.096153846,515,250000,1,0.2,300,75,-2520293572,2108234095,7342.938323,2153146656,215314665.6,12,54903,2265,1162,1220,58,1162,54903,58,1220,20.5203252,0.732446415,0.773096822,54719.4139,248.2135994,1.638580931,99004.56319,0.552228801,0.002497523,1.77003E-05,0.047540984,0.022221008,194,24
D:1| T0: 0.10| T1: 515.00| I0: 300.0| I1: 75.0| WTP: 250000,1,0.096153846,515,250000,1,0.2,300,75,-1427185703,465621985,12659.72959,794199223.5,79419922.35,4,95321,4277,739,2103,1364,739,95321,1364,2103,254.4666667,3.428571429,9.880952381,29536.09524,1563.871429,13.39047619,98550.21429,0.297670185,0.015724434,0.000136115,0.648597242,0.022062295,30,8
D:1| T0: 0.10| T1: 515.00| I0: 300.0| I1: 75.0| WTP: 250000,1,0.096153846,515,250000,1,0.2,300,75,-2359875289,1487072553,7442.253894,1987762594,198776259.4,12,59599,2692,1131,1236,105,1131,59599,105,1236,32.19885823,0.93434824,1.030447193,52736.8411,202.8087536,2.085632731,99036.03235,0.532026943,0.002041107,2.26407E-05,0.084951456,0.020738603,151,22
D:1| T0: 0.10| T1: 515.00| I0: 300.0| I1: 75.0| WTP: 250000,1,0.096153846,515,250000,1,0.2,300,75,-1585188215,1213733847,9300.804262,1120148002,112014800.2,6,70532,3040,894,1545,651,894,70532,651,1545,119.8707692,2.618461538,4.593846154,51998.73538,921.44,7.335384615,99000.21846,0.523719141,0.009257401,7.54013E-05,0.421359223,0.021904951,47,12
D:1| T0: 0.10| T1: 515.00| I0: 300.0| I1: 75.0| WTP: 250000,1,0.096153846,515,250000,1,0.2,300,75,-1536386360,2003658337,9992.72757,1036749982,103674998.2,6,77292,3289,715,1660,945,715,77292,945,1660,121.2157434,2,4.728862974,44370.46647,921.8163265,6.807580175,98855.60641,0.447068441,0.009265276,6.96027E-05,0.569277108,0.021476996,49,11
D:1| T0: 0.10| T1: 515.00| I0: 300.0| I1: 75.0| WTP: 250000,1,0.096153846,515,250000,1,0.2,300,75,-6342803108,1170868072,6658.103828,6009897916,600989791.6,36,53244,2331,1106,1106,0,1106,53244,0,1106,12.28964332,0.294800172,0.294800172,68352.43318,133.0253545,0.768801031,99353.26171,0.687441017,0.001339413,9.55454E-06,0,0.020772684,333,68
D:1| T0: 0.10| T1: 515.00| I0: 300.0| I1: 75.0| WTP: 250000,1,0.096153846,515,250000,1,0.2,300,75,-1335608429,569919592,10946.28814,788294021.8,78829402.18,4,90824,4024,754,1818,1064,754,90824,1064,1818,264.0842105,3.878947368,9.410526316,31576.06316,1246.510526,13.38947368,98725.11053,0.318722427,0.012508754,0.000135951,0.585258526,0.020016736,28,8
D:1| T0: 0.10| T1: 515.00| I0: 300.0| I1: 75.0| WTP: 250000,1,0.096153846,515,250000,1,0.2,300,75,-1536052886,1833180623,8233.200098,1124392881,112439288.1,6,73609,3467,1010,1367,357,1010,73609,357,1367,94.02031603,2.119638826,2.898419865,46665.58916,775.4740406,5.162528217,99053.39278,0.469996077,0.007789716,5.39094E-05,0.261155816,0.018571099,64,12
D:1| T0: 0.10| T1: 515.00| I0: 300.0| I1: 75.0| WTP: 250000,1,0.096153846,515,250000,1,0.2,300,75,-1449906411,1123666637,13169.32017,791440402.2,79144040.22,4,93680,4045,755,2188,1433,755,93680,1433,2188,305.5621302,4.384615385,12.77514793,40612.14201,1667.100592,17.24260355,98739.3432,0.408409567,0.01674863,0.000174963,0.654936015,0.023356106,25,8
D:1| T0: 0.10| T1: 515.00| I0: 300.0| I1: 75.0| WTP: 250000,1,0.096153846,515,250000,1,0.2,300,75,-1704109548,1682024981,11412.92154,1133463471,113346347.1,6,89643,3842,764,1896,1132,764,89643,1132,1896,188.3951613,2.943548387,7.475806452,45053.7621,2954.197581,10.55241935,98945.47581,0.452364142,0.029691437,0.000107839,0.597046414,0.021150564,35,12
D:1| T0: 0.10| T1: 515.00| I0: 300.0| I1: 75.0| WTP: 250000,1,0.096153846,515,250000,1,0.2,300,75,-1614347386,1687523543,9853.780441,1121658364,112165836.4,6,73916,3191,910,1637,727,910,73916,727,1637,121.412844,2.660550459,4.856269113,51852.32722,863.6544343,7.617737003,98992.85015,0.521887287,0.008680329,7.82927E-05,0.44410507,0.02214736,47,12
D:1| T0: 0.10| T1: 515.00| I0: 300.0| I1: 75.0| WTP: 250000,1,0.096153846,515,250000,1,0.2,300,75,-1345635842,178034412,11156.26963,787822360.1,78782236.01,4,88629,4029,653,1853,1200,653,88629,1200,1853,261.5811518,3.287958115,9.523560209,46469.73822,1635.806283,12.93717277,98981.01571,0.466733283,0.016413064,0.000131658,0.647598489,0.020907378,28,8
D:1| T0: 0.10| T1: 515.00| I0: 300.0| I1: 75.0| WTP: 250000,1,0.096153846,515,250000,1,0.2,300,75,-1343632261,739490003,11055.20661,790871930.9,79087193.09,4,91593,4084,689,1836,1147,689,91593,1147,1836,260.4773869,3.376884422,9.085427136,41796.68844,1289.628141,12.54271357,98924.0804,0.419874794,0.012941805,0.00012734,0.624727669,0.0200452,29,8
D:1| T0: 0.10| T1: 515.00| I0: 300.0| I1: 75.0| WTP: 250000,1,0.096153846,515,250000,1,0.2,300,75,-1632749712,178482706,10255.52932,1119973245,111997324.5,6,73756,3058,723,1704,981,723,73756,981,1704,125.6019417,2.223300971,5.365695793,48541.16828,1021.236246,7.699029126,98876.09385,0.489142598,0.010260109,7.89631E-05,0.576042278,0.023089647,45,12
D:1| T0: 0.10| T1: 515.00| I0: 300.0| I1: 75.0| WTP: 250000,1,0.096153846,515,250000,1,0.2,300,75,-1600293509,1919366370,9565.681338,1122009442,112200944.2,6,72536,3120,1061,1589,528,1061,72536,528,1589,79.68263473,1.966067864,2.992015968,46096.87226,498.7105788,5.119760479,98854.37126,0.464988624,0.005017954,5.3222E-05,0.332284456,0.021906666,72,12
D:1| T0: 0.10| T1: 515.00| I0: 300.0| I1: 75.0| WTP: 250000,1,0.096153846,515,250000,1,0.2,300,75,-1350194507,1819796913,11110.46298,794671358.1,79467135.81,4,96556,4424,693,1845,1152,693,96556,1152,1845,305.4971751,3.858757062,10.31638418,39525.46893,2242.305085,14.22033898,98959.40113,0.396708982,0.022489033,0.000143838,0.624390244,0.019108082,26,8
D:1| T0: 0.10| T1: 515.00| I0: 300.0| I1: 75.0| WTP: 250000,1,0.096153846,515,250000,1,0.2,300,75,-2010765753,1866591913,10583.52646,1481589430,148158943,8,83928,3660,1083,1758,675,1083,83928,675,1758,134.4268657,3.140298507,5.11641791,53016.58806,2060.208955,8.328358209,99104.49552,0.532233364,0.020715747,8.52932E-05,0.383959044,0.020946526,48,16
D:1| T0: 0.10| T1: 515.00| I0: 300.0| I1: 75.0| WTP: 250000,1,0.096153846,515,250000,1,0.2,300,75,-1369589293,1219425989,11619.00268,788639159.1,78863915.91,4,90583,4102,788,1930,1142,788,90583,1142,1930,291.6686047,4.488372093,11.04651163,34593.16279,1358.366279,15.62209302,98721.4593,0.349013794,0.013630391,0.000158696,0.591709845,0.021306426,25,8
D:1| T0: 0.10| T1: 515.00| I0: 300.0| I1: 75.0| WTP: 250000,1,0.096153846,515,250000,1,0.2,300,75,-1375186767,502409586,11691.69309,790602112.6,79060211.26,4,94589,4132,740,1942,1202,740,94589,1202,1942,234.9086758,3.292237443,8.716894977,35365.22374,1740.424658,12.12328767,98775.38813,0.355504956,0.017480772,0.000123025,0.618949537,0.020530929,32,8
D:1| T0: 0.10| T1: 515.00| I0: 300.0| I1: 75.0| WTP: 250000,1,0.096153846,515,250000,1,0.2,300,75,-1298231005,1405887957,10390.66199,778697905.8,77869790.58,4,81475,3596,731,1726,995,731,81475,995,1726,190.7467811,3.017167382,7.253218884,47510.91416,1061.261803,10.39484979,98959.02575,0.477923174,0.010656147,0.000105861,0.576477404,0.021184412,34,8
D:1| T0: 0.10| T1: 515.00| I0: 300.0| I1: 75.0| WTP: 250000,1,0.096153846,515,250000,1,0.2,300,75,-1310750888,283033753,10772.86618,772107578.5,77210757.85,4,78441,3243,736,1790,1054,736,78441,1054,1790,159.4703557,2.754940711,6.865612648,46613.99605,821.6679842,9.794466403,98849.01581,0.469582242,0.008255853,0.000100309,0.588826816,0.022819699,37,8
D:1| T0: 0.10| T1: 515.00| I0: 300.0| I1: 75.0| WTP: 250000,1,0.096153846,515,250000,1,0.2,300,75,-1631707308,1083157068,10178.47526,1122783545,112278354.5,6,75552,3236,1104,1691,587,1104,75552,587,1691,82.34836066,2.096311475,3.266393443,42607.33607,785.3504098,5.540983607,98773.31967,0.429969257,0.007901423,5.76564E-05,0.347131875,0.022381936,70,12
D:1| T0: 0.10| T1: 515.00| I0: 300.0| I1: 75.0| WTP: 250000,1,0.096153846,515,250000,1,0.2,300,75,-1564332210,1988704626,9034.193081,1112622556,111262255.6,6,67100,2768,1203,1501,298,1203,67100,298,1501,64.71537002,2.102466793,2.652751423,51775.22201,327.0910816,4.935483871,98950.97154,0.522184476,0.003291057,5.16087E-05,0.19853431,0.022369598,76,12
D:1| T0: 0.10| T1: 515.00| I0: 300.0| I1: 75.0| WTP: 250000,1,0.096153846,515,250000,1,0.2,300,75,-1235553535,884761309,10818.19661,694643704,69464370.4,4,83967,3749,680,1797,1117,680,83967,1117,1797,191.8065844,2.703703704,7.279835391,29886.15226,898.345679,10.08230453,98566.96708,0.302686556,0.009023984,0.000102489,0.621591541,0.02140152,35,7
D:1| T0: 0.10| T1: 515.00| I0: 300.0| I1: 75.0| WTP: 250000,1,0.096153846,515,250000,1,0.2,300,75,-2613409908,533485933,7161.477747,2255336020,225533602,14,63123,2936,1175,1189,14,1175,63123,14,1189,40.13973799,1.076419214,1.091703057,58018.17904,188.3482533,2.368995633,99217.1321,0.584162804,0.001895055,2.59335E-05,0.011774601,0.018837733,131,25
D:1| T0: 0.10| T1: 515.00| I0: 300.0| I1: 75.0| WTP: 250000,1,0.096153846,515,250000,1,0.2,300,75,-2228177635,632196071,8324.917685,1811931751,181193175.1,12,63059,2708,1298,1383,85,1298,63059,85,1383,40.35079172,1.381242387,1.479902558,56387.1011,198.2192448,3.065773447,99060.37759,0.568539415,0.001995848,3.28447E-05,0.061460593,0.021931842,118,20
D:1| T0: 0.10| T1: 515.00| I0: 300.0| I1: 75.0| WTP: 250000,1,0.096153846,515,250000,1,0.2,300,75,-1367451527,393400457,11482.34108,793334472.9,79333447.29,4,94442,4189,581,1907,1326,581,94442,1326,1907,266.935,2.815,9.385,40691.735,1473.695,12.275,98891.985,0.408448052,0.014792933,0.000124897,0.695332984,0.020192287,29,8
D:1| T0: 0.10| T1: 515.00| I0: 300.0| I1: 75.0| WTP: 250000,1,0.096153846,515,250000,1,0.2,300,75,-1308958325,398973227,10671.83767,775366441.6,77536644.16,4,79252,3307,687,1773,1086,687,79252,1086,1773,156.6273063,2.420664207,6.383763838,44968.54613,876.2804428,8.915129151,98833.99631,0.453017302,0.00880499,9.123E-05,0.612521151,0.02237224,39,8
D:1| T0: 0.10| T1: 515.00| I0: 300.0| I1: 75.0| WTP: 250000,1,0.096153846,515,250000,1,0.2,300,75,-1625618266,1402256491,9910.577449,1130089394,113008939.4,6,80612,3629,974,1646,672,974,80612,672,1646,151.8067797,3.166101695,5.396610169,50178.82712,1719.433898,8.708474576,99058.63729,0.504385303,0.017273538,8.92648E-05,0.408262454,0.020418796,43,12
D:1| T0: 0.10| T1: 515.00| I0: 300.0| I1: 75.0| WTP: 250000,1,0.096153846,515,250000,1,0.2,300,75,-1417702314,2102527413,12585.78621,788413003.6,78841300.36,4,91625,3900,698,2091,1393,698,91625,1393,2091,198.4365079,2.662698413,8.154761905,39848.72619,2102.353175,10.92063492,98734.33333,0.400390378,0.021147796,0.000111369,0.666188427,0.022821282,36,8
D:1| T0: 0.10| T1: 515.00| I0: 300.0| I1: 75.0| WTP: 250000,1,0.096153846,515,250000,1,0.2,300,75,-1376646080,1748031099,11822.1405,785539054.7,78553905.47,4,91504,3881,672,1964,1292,672,91504,1292,1964,205.0805085,2.737288136,8.177966102,38983.5339,2100.516949,11.00847458,98797.72458,0.39176593,0.021109395,0.000112304,0.657841141,0.021464012,34,8
D:1| T0: 0.10| T1: 515.00| I0: 300.0| I1: 75.0| WTP: 250000,1,0.096153846,515,250000,1,0.2,300,75,-1893686662,1946754629,8578.23922,1464774701,146477470.1,8,65190,2894,1192,1425,233,1192,65190,233,1425,45.28791774,1.367609254,1.650385604,50899.08098,322.033419,3.176092545,98944.10283,0.513580407,0.003241133,3.38349E-05,0.163508772,0.021859181,112,16
D:1| T0: 0.10| T1: 515.00| I0: 300.0| I1: 75.0| WTP: 250000,1,0.096153846,515,250000,1,0.2,300,75,-1513576986,2097712204,8013.258541,1112914059,111291405.9,6,64921,2912,1013,1331,318,1013,64921,318,1331,62.7920434,1.638336347,2.198915009,51456.95118,366.3562387,4.048824593,99031.05606,0.518807863,0.003683309,4.25992E-05,0.238918107,0.020501841,79,12
D:1| T0: 0.10| T1: 515.00| I0: 300.0| I1: 75.0| WTP: 250000,1,0.096153846,515,250000,1,0.2,300,75,-1885383761,1198827119,8427.924174,1463987552,146398755.2,8,61458,2695,1235,1400,165,1235,61458,165,1400,46.82479784,1.517520216,1.735849057,54867.54582,532.3989218,3.396226415,98998.42453,0.553175636,0.005355092,3.57125E-05,0.117857143,0.022779785,106,16
D:1| T0: 0.10| T1: 515.00| I0: 300.0| I1: 75.0| WTP: 250000,1,0.096153846,515,250000,1,0.2,300,75,-4891704355,109253198,5850.678524,4599170428,459917042.8,26,45677,1942,972,972,0,972,45677,0,972,12.11235955,0.307967314,0.307967314,75052.78447,163.2671093,0.803370787,99469.99081,0.754098186,0.001642364,9.97186E-06,0,0.021279856,279,52
D:1| T0: 0.10| T1: 515.00| I0: 300.0| I1: 75.0| WTP: 250000,1,0.096153846,515,250000,1,0.2,300,75,-3139122047,314481292,7356.407018,2771301696,277130169.6,20,56871,2504,1217,1222,5,1217,56871,5,1222,25.38442419,0.81938691,0.822700911,60445.25269,140.1060481,1.831814416,99155.76471,0.609018376,0.001411007,2.03143E-05,0.004095004,0.021470019,173,31
D:1| T0: 0.10| T1: 515.00| I0: 300.0| I1: 100.0| WTP: 300000,1,0.096153846,515,300000,1,0.2,300,100,-4343684919,1178568022,7030.031289,3992183354,399218335.4,24,52558,2199,1168,1168,0,1168,52558,0,1168,16.54889976,0.540953545,0.540953545,62792.82763,165.2646699,1.261002445,99174.76834,0.632625726,0.001663894,1.43536E-05,0,0.022223491,233,45
D:1| T0: 0.10| T1: 515.00| I0: 300.0| I1: 100.0| WTP: 300000,1,0.096153846,515,300000,1,0.2,300,100,-1383520751,2029998696,11830.2407,792008715.4,79200871.54,4,94945,4164,648,1965,1317,648,94945,1317,1965,230.8502203,2.753303965,8.524229075,35657.04846,1414.511013,11.37444934,98757.2467,0.358235323,0.014213002,0.00011567,0.670229008,0.020696193,33,8
D:1| T0: 0.10| T1: 515.00| I0: 300.0| I1: 100.0| WTP: 300000,1,0.096153846,515,300000,1,0.2,300,100,-1413972414,776062361,12590.52504,784446162.6,78444616.26,4,92374,3822,796,2092,1296,796,92374,1296,2092,176.2304833,2.862453532,7.643122677,39223.80669,2136.762082,10.60594796,98727.87361,0.394065151,0.021505698,0.000108069,0.619502868,0.022647065,38,8
D:1| T0: 0.10| T1: 515.00| I0: 300.0| I1: 100.0| WTP: 300000,1,0.096153846,515,300000,1,0.2,300,100,-3871129224,1813046880,7898.07647,3476225401,347622540.1,20,59069,2611,1306,1312,6,1306,59069,6,1312,18.07916438,0.551401869,0.554150632,56411.35019,205.1253436,1.286970863,99033.78725,0.569015551,0.002066315,1.44795E-05,0.004573171,0.022212064,260,39
D:1| T0: 0.10| T1: 515.00| I0: 300.0| I1: 100.0| WTP: 300000,1,0.096153846,515,300000,1,0.2,300,100,-2194348015,2032407216,7569.463746,1815874827,181587482.7,12,64018,2854,1152,1257,105,1152,64018,105,1257,40.09375,1.099330357,1.2109375,51866.8125,250.3470982,2.498883929,99073.83036,0.522888954,0.002518297,2.70267E-05,0.08353222,0.019635103,128,20
D:1| T0: 0.10| T1: 515.00| I0: 300.0| I1: 100.0| WTP: 300000,1,0.096153846,515,300000,1,0.2,300,100,-6253181127,1507873352,6740.161295,5916173062,591617306.2,36,49096,2034,1120,1120,0,1120,49096,0,1120,9.371246246,0.24024024,0.24024024,71248.82995,134.1996997,0.665540541,99359.03979,0.716508015,0.00135138,8.45259E-06,0,0.022812449,380,67
D:1| T0: 0.10| T1: 515.00| I0: 300.0| I1: 100.0| WTP: 300000,1,0.096153846,515,300000,1,0.2,300,100,-3353111441,1855899401,6460.201436,3030101369,303010136.9,18,51352,2273,1073,1073,0,1073,51352,0,1073,23.59271523,0.69205298,0.69205298,69434.09685,159.0256623,1.583609272,99362.46358,0.698308845,0.001600105,1.78458E-05,0,0.020895813,173,34
D:1| T0: 0.10| T1: 515.00| I0: 300.0| I1: 100.0| WTP: 300000,1,0.096153846,515,300000,1,0.2,300,100,-1447033641,1819459251,9986.269449,947720168.5,94772016.85,6,74903,3238,711,1659,948,711,74903,948,1659,166.9344262,2.795081967,6.635245902,52835.87705,1101.565574,9.532786885,99029.59836,0.53152131,0.011056307,9.75295E-05,0.571428571,0.022148646,35,10
D:1| T0: 0.10| T1: 515.00| I0: 300.0| I1: 100.0| WTP: 300000,1,0.096153846,515,300000,1,0.2,300,100,-3296610155,909791748,7019.707624,2945624774,294562477.4,22,52710,2440,1166,1166,0,1166,52710,0,1166,20.96406358,0.600552868,0.600552868,66774.67519,117.9253628,1.417415342,99272.30062,0.672052727,0.001187828,1.61993E-05,0,0.022121879,207,33
D:1| T0: 0.10| T1: 515.00| I0: 300.0| I1: 100.0| WTP: 300000,1,0.096153846,515,300000,1,0.2,300,100,-1476838419,1339092841,9063.685199,1023654159,102365415.9,6,65749,2721,812,1506,694,812,65749,694,1506,89.15915119,2.068965517,3.888594164,51412.98674,627.1883289,6.031830239,98925.66048,0.518515701,0.006302596,6.17803E-05,0.460823373,0.02290564,54,11
D:1| T0: 0.10| T1: 515.00| I0: 300.0| I1: 100.0| WTP: 300000,1,0.096153846,515,300000,1,0.2,300,100,-1403507233,1365866345,12208.93929,793060268.4,79306026.84,4,95855,4267,715,2028,1313,715,95855,1313,2028,219.3112033,2.887966805,8.298755187,32980.77593,1247.344398,11.24481328,98667.9917,0.331489792,0.0125414,0.000114431,0.647435897,0.021156956,35,8
D:1| T0: 0.10| T1: 515.00| I0: 300.0| I1: 100.0| WTP: 300000,1,0.096153846,515,300000,1,0.2,300,100,-1572425539,825453433,8912.60515,1126795282,112679528.2,6,75128,3348,899,1480,581,899,75128,581,1480,106.8044554,2.094059406,3.514851485,45192.02475,946.3836634,5.747524752,98971.0198,0.455215944,0.009507945,5.91903E-05,0.392567568,0.019699712,58,12
D:1| T0: 0.10| T1: 515.00| I0: 300.0| I1: 100.0| WTP: 300000,1,0.096153846,515,300000,1,0.2,300,100,-1392680308,939711378,11974.9893,793930842.6,79393084.26,4,96951,4287,640,1989,1349,640,96951,1349,1989,232.7434783,2.726086957,8.539130435,32911.42174,1656.417391,11.30434783,98717.07391,0.330585224,0.016642516,0.000114881,0.678230266,0.020515518,33,8
D:1| T0: 0.10| T1: 515.00| I0: 300.0| I1: 100.0| WTP: 300000,1,0.096153846,515,300000,1,0.2,300,100,-1894952660,638950699,8430.951515,1473405084,147340508.4,8,70609,3151,1087,1400,313,1087,70609,313,1400,69.30204778,1.747440273,2.262798635,45785.31399,760.7542662,4.126279863,98958.57167,0.461567767,0.007648648,4.26643E-05,0.223571429,0.019827501,84,16
D:1| T0: 0.10| T1: 515.00| I0: 300.0| I1: 100.0| WTP: 300000,1,0.096153846,515,300000,1,0.2,300,100,-2295228574,938699148,7869.18058,1901769545,190176954.5,12,64058,2860,1225,1307,82,1225,64058,82,1307,42.82076638,1.313967862,1.410383189,55313.21261,266.9295426,2.907292954,99103.41286,0.557381921,0.002685697,3.14657E-05,0.062787136,0.020388092,116,21
D:1| T0: 0.10| T1: 515.00| I0: 300.0| I1: 100.0| WTP: 300000,1,0.096153846,515,300000,1,0.2,300,100,-4668881089,121790188,6395.460807,4349108048,434910804.8,26,54118,2492,1062,1062,0,1062,54118,0,1062,16.7412962,0.412426352,0.412426352,61470.46599,209.2592394,0.979646492,99252.06909,0.618850659,0.002105019,1.1431E-05,0,0.019623785,266,49
D:1| T0: 0.10| T1: 515.00| I0: 300.0| I1: 100.0| WTP: 300000,1,0.096153846,515,300000,1,0.2,300,100,-1618858892,1331335240,11336.8885,1052014467,105201446.7,6,90734,3926,720,1883,1163,720,90734,1163,1883,202.708,2.764,7.368,40985.628,2391.792,10.244,98879.656,0.41171151,0.024033941,0.000104673,0.617631439,0.02075297,36,11
D:1| T0: 0.10| T1: 515.00| I0: 300.0| I1: 100.0| WTP: 300000,1,0.096153846,515,300000,1,0.2,300,100,-1344883793,470935411,12850.55476,702356055.6,70235605.56,4,93723,3995,728,2135,1407,728,93723,1407,2135,299.1823529,4.194117647,12.37647059,34795.56471,1426.711765,16.67058824,98640.10588,0.350554058,0.014330058,0.000169245,0.659016393,0.022779894,25,7
D:1| T0: 0.10| T1: 515.00| I0: 300.0| I1: 100.0| WTP: 300000,1,0.096153846,515,300000,1,0.2,300,100,-1924983161,823434397,9185.118921,1465727214,146572721.4,8,65891,2828,1042,1526,484,1042,65891,484,1526,82.72916667,2.291666667,3.372685185,55363.47685,781.5231481,5.784722222,99004.28009,0.557731897,0.00785894,5.97582E-05,0.317169069,0.023160515,62,16
D:1| T0: 0.10| T1: 515.00| I0: 300.0| I1: 100.0| WTP: 300000,1,0.096153846,515,300000,1,0.2,300,100,-2733290654,493045351,6328.209624,2416880173,241688017.3,18,53076,2349,1051,1051,0,1051,53076,0,1051,26.84348641,0.803186504,0.803186504,64843.80412,126.4686036,1.78163074,99310.56232,0.652416011,0.001272534,1.97853E-05,0,0.019801794,153,27
D:1| T0: 0.10| T1: 515.00| I0: 300.0| I1: 100.0| WTP: 300000,1,0.096153846,515,300000,1,0.2,300,100,-1755128038,1700216563,7439.205727,1383167752,138316775.2,8,65454,3003,988,1235,247,988,65454,247,1235,94.81204819,2.262650602,2.83373494,57538.34458,847.0433735,5.207228916,99240.98795,0.578572346,0.008501784,5.37672E-05,0.2,0.018868213,60,15
D:1| T0: 0.10| T1: 515.00| I0: 300.0| I1: 100.0| WTP: 300000,1,0.096153846,515,300000,1,0.2,300,100,-1762581707,1744119059,7689.729462,1378095233,137809523.3,8,64075,2981,1133,1277,144,1133,64075,144,1277,58.29886914,1.620355412,1.844911147,53829.28595,286.3812601,3.675282714,99103.937,0.542536813,0.002879593,3.91244E-05,0.112764291,0.019930081,89,15
D:1| T0: 0.10| T1: 515.00| I0: 300.0| I1: 100.0| WTP: 300000,1,0.096153846,515,300000,1,0.2,300,100,-2900529551,2036906360,7866.503321,2507204385,250720438.5,14,59275,2528,1285,1307,22,1285,59275,22,1307,22.8156682,0.811059908,0.827956989,55100.05453,315.9347158,1.817204301,99029.76267,0.555693732,0.003179924,2.0023E-05,0.016832441,0.022049768,185,28
D:1| T0: 0.10| T1: 515.00| I0: 300.0| I1: 100.0| WTP: 300000,1,0.096153846,515,300000,1,0.2,300,100,-1877769364,809704121,8171.308232,1469203953,146920395.3,8,67694,3069,1009,1357,348,1009,67694,348,1357,91.42925659,2.278177458,3.09352518,55503.19664,838.7889688,5.51558753,99149.98561,0.558406623,0.008424791,5.69833E-05,0.256448047,0.02004609,59,16
D:1| T0: 0.10| T1: 515.00| I0: 300.0| I1: 100.0| WTP: 300000,1,0.096153846,515,300000,1,0.2,300,100,-1684505053,1219866412,10945.81042,1137214532,113721453.2,6,87994,3874,920,1818,898,920,87994,898,1818,155.5904762,2.80952381,5.619047619,38110.63492,2295.539683,8.53015873,98804.75238,0.383511001,0.02308472,8.74619E-05,0.493949395,0.0206605,45,12
D:1| T0: 0.10| T1: 515.00| I0: 300.0| I1: 100.0| WTP: 300000,1,0.096153846,515,300000,1,0.2,300,100,-5192753835,843498920,6554.329315,4865037369,486503736.9,34,48875,2094,1089,1089,0,1089,48875,0,1089,12.96439628,0.389060888,0.389060888,68924.49948,121.0856553,0.956140351,99311.24768,0.693501526,0.001219318,1.1294E-05,0,0.02228133,277,55
D:1| T0: 0.10| T1: 515.00| I0: 300.0| I1: 100.0| WTP: 300000,1,0.096153846,515,300000,1,0.2,300,100,-1981660987,107351963,10326.07949,1465357012,146535701.2,8,71840,2807,1295,1716,421,1295,71840,421,1716,48.4813278,1.64868603,2.215767635,44824.26694,690.9377593,3.987551867,98718.40387,0.452727074,0.006959652,4.19493E-05,0.245337995,0.023886414,104,16
D:1| T0: 0.10| T1: 515.00| I0: 300.0| I1: 100.0| WTP: 300000,1,0.096153846,515,300000,1,0.2,300,100,-1938570457,773789021,9313.572893,1472891812,147289181.2,8,69960,3174,1120,1547,427,1120,69960,427,1547,80.8989899,2.125252525,2.965656566,51247.27879,958.0060606,5.22020202,98966.28485,0.516321658,0.009635197,5.41865E-05,0.2760181,0.022112636,71,16
D:1| T0: 0.10| T1: 515.00| I0: 300.0| I1: 100.0| WTP: 300000,1,0.096153846,515,300000,1,0.2,300,100,-1618199969,850936611,10020.55179,1117172380,111717238,6,69867,2894,1127,1665,538,1127,69867,538,1665,57.07142857,1.641304348,2.448757764,44639.63509,575.613354,4.187888199,98709.67081,0.451028243,0.005796502,4.36564E-05,0.323123123,0.023830993,92,12
D:1| T0: 0.10| T1: 515.00| I0: 300.0| I1: 100.0| WTP: 300000,1,0.096153846,515,300000,1,0.2,300,100,-1568445633,1701318364,8982.293752,1119330945,111933094.5,6,70496,3025,1075,1492,417,1075,70496,417,1492,60.82250396,1.580031696,2.228209192,42821.13154,470.340729,3.93977813,98808.25674,0.43253079,0.004732987,4.09292E-05,0.279490617,0.021164321,91,12
D:1| T0: 0.10| T1: 515.00| I0: 300.0| I1: 100.0| WTP: 300000,1,0.096153846,515,300000,1,0.2,300,100,-3924769173,778708269,7337.556977,3557891324,355789132.4,20,55725,2393,1219,1219,0,1219,55725,0,1219,14.01663498,0.419201521,0.419201521,59624.90589,202.956749,0.986692015,99135.5789,0.600889963,0.002043241,1.16529E-05,0,0.02187528,301,40
D:1| T0: 0.10| T1: 515.00| I0: 300.0| I1: 100.0| WTP: 300000,1,0.096153846,515,300000,1,0.2,300,100,-3107399926,1391938506,8426.209776,2686089437,268608943.7,18,59698,2537,1354,1400,46,1354,59698,46,1400,25.89169381,0.903094463,0.939739414,57034.3184,173.7442997,2.046416938,99003.83795,0.575463358,0.001750786,2.25671E-05,0.032857143,0.023451372,176,30
D:1| T0: 0.10| T1: 515.00| I0: 300.0| I1: 100.0| WTP: 300000,1,0.096153846,515,300000,1,0.2,300,100,-4569450294,43418681,6373.898211,4250755383,425075538.3,26,49117,2116,1059,1059,0,1059,49117,0,1059,13.3588775,0.385321101,0.385321101,71603.25256,149.3912574,0.950350783,99385.53805,0.719977351,0.001503635,1.14847E-05,0,0.021561202,265,48
D:1| T0: 0.10| T1: 515.00| I0: 300.0| I1: 100.0| WTP: 300000,1,0.096153846,515,300000,1,0.2,300,100,-1417547193,817384966,12692.12962,782940711.9,78294071.19,4,90602,3756,789,2109,1320,789,90602,1320,2109,252.4456522,4.195652174,11.2826087,40878.88587,1341.407609,15.5923913,98743.14674,0.411496812,0.013472938,0.000158227,0.625889047,0.023277632,27,8
D:1| T0: 0.10| T1: 515.00| I0: 300.0| I1: 100.0| WTP: 300000,1,0.096153846,515,300000,1,0.2,300,100,-1329680087,762053968,10908.90403,784234885.7,78423488.57,4,89409,3903,706,1812,1106,706,89409,1106,1812,233.9460784,3.362745098,8.730392157,42878.75,1366.02451,12.18627451,98936.04902,0.430944848,0.013709946,0.000123882,0.610375276,0.020266416,30,8
D:1| T0: 0.10| T1: 515.00| I0: 300.0| I1: 100.0| WTP: 300000,1,0.096153846,515,300000,1,0.2,300,100,-2203774780,1692506311,7726.122047,1817468677,181746867.7,10,67031,3056,1176,1283,107,1176,67031,107,1283,37.49795918,1.047959184,1.154081633,47771.57347,453.5826531,2.357142857,99020.71122,0.481665051,0.004562278,2.5228E-05,0.083398285,0.019140398,139,20
D:1| T0: 0.10| T1: 515.00| I0: 300.0| I1: 100.0| WTP: 300000,1,0.096153846,515,300000,1,0.2,300,100,-3422065515,1037620300,6211.885242,3111471253,311147125.3,20,48702,2056,1032,1032,0,1032,48702,0,1032,19.00306748,0.587423313,0.587423313,69933.86043,156.3328221,1.391871166,99376.17715,0.703238693,0.001572655,1.5898E-05,0,0.021190095,187,35
D:1| T0: 0.10| T1: 515.00| I0: 300.0| I1: 100.0| WTP: 300000,1,0.096153846,515,300000,1,0.2,300,100,-3244504811,301400999,7645.729177,2862218352,286221835.2,18,60383,2578,1251,1270,19,1251,60383,19,1270,25.73107256,0.786277603,0.800473186,57828.86751,198.2641956,1.802050473,99129.37066,0.582763702,0.001995897,1.99931E-05,0.01496063,0.02103241,182,32
D:1| T0: 0.10| T1: 515.00| I0: 300.0| I1: 100.0| WTP: 300000,1,0.096153846,515,300000,1,0.2,300,100,-1333353780,1868336855,11034.19698,781643931.1,78164393.11,4,85024,3691,738,1833,1095,738,85024,1095,1833,181.6062992,2.767716535,7.05511811,45113.5,1305.53937,9.94488189,98904.12598,0.453593972,0.013117366,0.000101749,0.597381342,0.021558619,37,8
D:1| T0: 0.10| T1: 515.00| I0: 300.0| I1: 100.0| WTP: 300000,1,0.096153846,515,300000,1,0.2,300,100,-1495969066,1868498144,10876.47521,952145305.9,95214530.59,6,82271,3532,714,1807,1093,714,82271,1093,1807,143.1258278,2.245033113,5.831125828,42091,1136.758278,8.215231788,98794.66556,0.42389333,0.011430018,8.39388E-05,0.60486995,0.021963997,44,10
D:1| T0: 0.10| T1: 515.00| I0: 300.0| I1: 100.0| WTP: 300000,1,0.096153846,515,300000,1,0.2,300,100,-2782702568,2101566889,7236.342826,2420885427,242088542.7,14,56177,2448,1196,1202,6,1196,56177,6,1202,19.96121526,0.610859729,0.614738203,57175.97738,205.5707822,1.385261797,99079.31739,0.576614316,0.002069424,1.55844E-05,0.004991681,0.021396657,221,27
D:1| T0: 0.10| T1: 515.00| I0: 300.0| I1: 100.0| WTP: 300000,1,0.096153846,515,300000,1,0.2,300,100,-1326607715,1665097450,12466.49921,703282753.9,70328275.39,4,95376,4092,712,2071,1359,712,95376,1359,2071,268.265625,3.651041667,10.65625,33922.08333,1700.838542,14.359375,98663.69271,0.341408236,0.017091824,0.000145674,0.656204732,0.021714058,28,7
D:1| T0: 0.10| T1: 515.00| I0: 300.0| I1: 100.0| WTP: 300000,1,0.096153846,515,300000,1,0.2,300,100,-1337506518,1716179948,10775.50476,798731279.7,79873127.97,4,97436,4498,713,1789,1076,713,97436,1076,1789,304.7365591,3.747311828,9.478494624,36982.23118,1808.892473,13.31182796,98946.6129,0.371245615,0.018147954,0.000134933,0.601453326,0.01836077,27,8
D:1| T0: 0.10| T1: 515.00| I0: 300.0| I1: 100.0| WTP: 300000,1,0.096153846,515,300000,1,0.2,300,100,-3000652635,1560278715,8148.297878,2593237741,259323774.1,16,55530,2299,1354,1354,0,1354,55530,0,1354,26.26997245,1.039485767,1.039485767,65008.45638,174.2029385,2.28466483,99158.7236,0.654889439,0.001754626,2.50131E-05,0,0.024383216,155,29
D:1| T0: 0.10| T1: 515.00| I0: 300.0| I1: 100.0| WTP: 300000,1,0.096153846,515,300000,1,0.2,300,100,-1400544680,991019385,12343.8999,783349685.4,78334968.54,4,90105,3827,713,2051,1338,713,90105,1338,2051,176.2255639,2.560150376,7.567669173,38985.35338,2004.496241,10.26691729,98708.37218,0.392013411,0.020164468,0.000104562,0.6523647,0.022762333,38,8
D:1| T0: 0.10| T1: 515.00| I0: 300.0| I1: 100.0| WTP: 300000,1,0.096153846,515,300000,1,0.2,300,100,-1350120201,118052103,11293.66053,785437174.6,78543717.46,4,87357,3891,765,1876,1111,765,87357,1111,1876,180.4701493,2.720149254,6.824626866,45449.93657,1649.537313,9.701492537,98919.63433,0.456590564,0.016581293,9.90906E-05,0.592217484,0.021475096,39,8
D:1| T0: 0.10| T1: 515.00| I0: 300.0| I1: 100.0| WTP: 300000,1,0.096153846,515,300000,1,0.2,300,100,-1405055439,1209758844,12434.00238,783355320.1,78335532.01,4,89402,3728,691,2066,1375,691,89402,1375,2066,240.5179487,3.441025641,10.44102564,45146.83077,1345.369231,13.96410256,98835.05128,0.45362038,0.013515966,0.000142049,0.66553727,0.023109103,28,8
D:1| T0: 0.10| T1: 515.00| I0: 300.0| I1: 100.0| WTP: 300000,1,0.096153846,515,300000,1,0.2,300,100,-6191830808,70671723,7115.038217,5836078897,583607889.7,36,54897,2379,1182,1182,0,1182,54897,0,1182,13.40778032,0.353775744,0.353775744,65142.9492,154.8512586,0.908009153,99249.71899,0.655772758,0.001559578,1.08785E-05,0,0.021531231,313,66
D:1| T0: 0.10| T1: 515.00| I0: 300.0| I1: 100.0| WTP: 300000,1,0.096153846,515,300000,1,0.2,300,100,-3434160052,1722612191,6257.098596,3121305122,312130512.2,18,53065,2522,1039,1039,0,1039,53065,0,1039,18.27919384,0.449318317,0.449318317,62880.65857,173.5103734,1.065797273,99278.02312,0.632866731,0.00174573,1.23746E-05,0,0.019579761,240,35
D:1| T0: 0.10| T1: 515.00| I0: 300.0| I1: 100.0| WTP: 300000,1,0.096153846,515,300000,1,0.2,300,100,-3159790273,1968291596,6046.631627,2857458691,285745869.1,16,53084,2423,1004,1004,0,1004,53084,0,1004,22.39380531,0.544247788,0.544247788,65276.7146,156.6076696,1.296460177,99353.76401,0.656505589,0.001575249,1.48719E-05,0,0.018895294,194,32
D:1| T0: 0.10| T1: 515.00| I0: 300.0| I1: 100.0| WTP: 300000,1,0.096153846,515,300000,1,0.2,300,100,-1449474365,1877569084,13169.17406,791015662.1,79101566.21,4,96488,4069,745,2188,1443,745,96488,1443,2188,266.1295337,3.813471503,11.21243523,35133.56995,1600.093264,15.05181347,98644.61658,0.353250926,0.016087307,0.00015278,0.659506399,0.022676395,28,8
D:1| T0: 0.10| T1: 515.00| I0: 300.0| I1: 100.0| WTP: 300000,1,0.096153846,515,300000,1,0.2,300,100,-1400909269,1726322189,12190.40189,791389174.1,79138917.41,4,95421,4151,742,2025,1283,742,95421,1283,2025,268.4352332,3.777202073,10.33678756,36894.84456,1673.772021,14.19170984,98778.33161,0.370759373,0.0168105,0.000144015,0.633580247,0.021221744,28,8
D:1| T0: 0.10| T1: 515.00| I0: 300.0| I1: 100.0| WTP: 300000,1,0.096153846,515,300000,1,0.2,300,100,-1390977632,307848836,12063.07059,787824102.3,78782410.23,4,91431,4027,613,2004,1391,613,91431,1391,2004,231.5627907,2.772093023,9.195348837,41100.16744,1495.390698,12.03255814,98811.69767,0.412902006,0.015021828,0.000122332,0.694111776,0.021918168,31,8
D:1| T0: 0.10| T1: 515.00| I0: 300.0| I1: 100.0| WTP: 300000,1,0.096153846,515,300000,1,0.2,300,100,-1256273041,1154000220,11067.13265,702916408,70291640.8,4,91009,4125,749,1838,1089,749,91009,1089,1838,280.1630435,3.983695652,9.836956522,33230.30978,1286.51087,13.89673913,98752.70652,0.335189924,0.012907515,0.000141173,0.592491839,0.020195805,27,7
D:1| T0: 0.10| T1: 515.00| I0: 300.0| I1: 100.0| WTP: 300000,1,0.096153846,515,300000,1,0.2,300,100,-5090010016,2028661055,6242.244492,4777897792,477789779.2,30,46984,2038,1037,1037,0,1037,46984,0,1037,16.12444725,0.466203411,0.466203411,71320.36008,154.5198989,1.12381554,99384.35944,0.717160708,0.00155459,1.31616E-05,0,0.022071343,227,54
D:1| T0: 0.10| T1: 515.00| I0: 300.0| I1: 100.0| WTP: 300000,1,0.096153846,515,300000,1,0.2,300,100,-1881607245,1629114640,9872.933435,1387960573,138796057.3,8,77706,3400,1070,1640,570,1070,77706,570,1640,121.5146199,3.005847953,4.622807018,50148.26608,1410.076023,7.748538012,99020.85965,0.504481775,0.014172465,7.96657E-05,0.347560976,0.021105463,49,15
D:1| T0: 0.10| T1: 515.00| I0: 300.0| I1: 100.0| WTP: 300000,1,0.096153846,515,300000,1,0.2,300,100,-1448079271,1439048174,13026.9009,796734226.2,79673422.62,4,96599,4308,746,2164,1418,746,96599,1418,2164,300.1748634,4,11.66666667,38851.43169,2247.836066,15.75956284,98756.08743,0.390137629,0.022590817,0.000159786,0.655268022,0.022401888,27,8
D:1| T0: 0.10| T1: 515.00| I0: 300.0| I1: 100.0| WTP: 300000,1,0.096153846,515,300000,1,0.2,300,100,-1292416835,865227006,11976.89732,693571969.4,69357196.94,4,88440,3679,705,1990,1285,705,88440,1285,1990,275.0722892,4.120481928,11.79518072,34329.10843,1429.783133,16.08433735,98636.85542,0.346731923,0.014345885,0.000163076,0.645728643,0.02250164,24,7
D:1| T0: 0.10| T1: 515.00| I0: 300.0| I1: 100.0| WTP: 300000,1,0.096153846,515,300000,1,0.2,300,100,-1691078570,890479738,11095.6054,1136298300,113629830,6,88008,3838,815,1843,1028,815,88008,1028,1843,149.7808642,2.416666667,5.552469136,37508.04012,1938.632716,8.074074074,98771.28395,0.377419917,0.019499109,8.25542E-05,0.557786218,0.020941278,47,12
D:1| T0: 0.10| T1: 515.00| I0: 300.0| I1: 100.0| WTP: 300000,1,0.096153846,515,300000,1,0.2,300,100,-3503408918,1017049163,7549.877416,3125915047,312591504.7,22,60372,2709,1253,1254,1,1253,60372,1,1254,28.4363167,0.86919105,0.870051635,62573.69363,185.1798623,1.938037866,99254.73924,0.629851528,0.001863884,2.16921E-05,0.000797448,0.020771218,166,35
D:1| T0: 0.10| T1: 515.00| I0: 300.0| I1: 100.0| WTP: 300000,1,0.096153846,515,300000,1,0.2,300,100,-3801964269,1707305064,6587.640917,3472582224,347258222.4,20,54791,2496,1094,1094,0,1094,54791,0,1094,20.98921833,0.543126685,0.543126685,64637.64488,194.0316712,1.28638814,99296.1469,0.650419417,0.001952246,1.48149E-05,0,0.019966783,212,39
D:1| T0: 0.10| T1: 515.00| I0: 300.0| I1: 100.0| WTP: 300000,1,0.096153846,515,300000,1,0.2,300,100,-1286251020,400145663,11803.58029,696072005.8,69607200.58,4,86942,3738,730,1961,1231,730,86942,1231,1961,245.9270833,3.723958333,10.078125,32762.4375,1214.723958,13.875,98577.98958,0.331264071,0.012196606,0.000140896,0.627740948,0.022555267,28,7
D:1| T0: 0.10| T1: 515.00| I0: 300.0| I1: 100.0| WTP: 300000,1,0.096153846,515,300000,1,0.2,300,100,-3857613461,1662654181,7592.385364,3477994193,347799419.3,24,62137,2767,1257,1261,4,1257,62137,4,1261,26.70676101,0.786949686,0.789308176,60896.0794,201.4669811,1.777515723,99229.54638,0.613015577,0.002028067,1.99054E-05,0.003172086,0.020294193,182,39
D:1| T0: 0.10| T1: 515.00| I0: 300.0| I1: 100.0| WTP: 300000,1,0.096153846,515,300000,1,0.2,300,100,-1362182916,182136456,11380.26596,793169618,79316961.8,4,95282,4251,770,1890,1120,770,95282,1120,1890,282.1489362,4.037234043,9.909574468,37686.44149,1749.590426,14,98864.92021,0.378761919,0.017562797,0.000142007,0.592592593,0.019835856,27,8
D:1| T0: 0.10| T1: 515.00| I0: 300.0| I1: 100.0| WTP: 300000,1,0.096153846,515,300000,1,0.2,300,100,-4200271864,979575387,5912.936117,3904625058,390462505.8,22,49026,2248,982,982,0,982,49026,0,982,13.3763285,0.316908213,0.316908213,65863.63816,157.9236715,0.787439614,99311.0942,0.662836754,0.001588966,9.53006E-06,0,0.020030597,296,44
D:1| T0: 0.10| T1: 515.00| I0: 300.0| I1: 100.0| WTP: 300000,1,0.096153846,515,300000,1,0.2,300,100,-1414555815,2142525414,12519.76766,788567431.6,78856743.16,4,93670,3990,711,2080,1369,711,93670,1369,2080,256.7384615,3.523076923,10.48717949,45475.51282,1895.589744,14.17435897,98908.51282,0.456217912,0.019047371,0.000143821,0.658173077,0.022205615,28,8
D:1| T0: 0.10| T1: 515.00| I0: 300.0| I1: 100.0| WTP: 300000,1,0.096153846,515,300000,1,0.2,300,100,-1308353211,1464057597,10553.45839,780680291.3,78068029.13,4,83440,3665,765,1753,988,765,83440,988,1753,168.3247232,2.6900369,6.287822878,47638.99262,1154.653137,9.103321033,98981.90406,0.478795989,0.011598857,9.33721E-05,0.563605248,0.021010116,39,8
D:1| T0: 0.10| T1: 515.00| I0: 300.0| I1: 100.0| WTP: 300000,1,0.096153846,515,300000,1,0.2,300,100,-1363136256,364562610,11575.53304,784359603.8,78435960.38,4,90373,3854,667,1923,1256,667,90373,1256,1923,239.7939698,3.246231156,9.497487437,43443.79899,1533.854271,12.86432161,98892.47739,0.436426742,0.015401995,0.000130688,0.653146126,0.021278479,29,8
D:1| T0: 0.10| T1: 515.00| I0: 300.0| I1: 100.0| WTP: 300000,1,0.096153846,515,300000,1,0.2,300,100,-1378858728,40350784,11893.77738,784169859.3,78416985.93,4,90261,3748,686,1976,1290,686,90261,1290,1976,227.5502392,3.148325359,9.267942584,45322.52632,1657.406699,12.54545455,98905.97608,0.455083565,0.016649277,0.000127961,0.652834008,0.021892069,30,8
D:1| T0: 0.10| T1: 515.00| I0: 300.0| I1: 100.0| WTP: 300000,1,0.096153846,515,300000,1,0.2,300,100,-1265754340,804064356,9606.088596,785449910.1,78544991.01,4,84018,3843,543,1595,1052,543,84018,1052,1595,237.9466019,2.524271845,7.59223301,49044.34466,1179.524272,10.21359223,99108.40291,0.492538805,0.011823978,0.00010408,0.659561129,0.018984253,30,8
D:1| T0: 0.10| T1: 515.00| I0: 300.0| I1: 100.0| WTP: 300000,1,0.096153846,515,300000,1,0.2,300,100,-2331947281,2125493986,8649.150374,1899489762,189948976.2,14,63932,2705,1240,1437,197,1240,63932,197,1437,32.58226601,1.058128079,1.24729064,49397.36453,199.6778325,2.462068966,98869.31921,0.498995427,0.002011811,2.65414E-05,0.137091162,0.022477007,145,21
D:1| T0: 0.10| T1: 515.00| I0: 300.0| I1: 100.0| WTP: 300000,1,0.096153846,515,300000,1,0.2,300,100,-1238899457,23154253,9166.195974,780589658.5,78058965.85,4,78757,3560,713,1522,809,713,78757,809,1522,180.2627451,2.670588235,5.815686275,47154.9451,824.9607843,8.62745098,99039.89804,0.474417196,0.0082769,8.79372E-05,0.531537451,0.019325266,37,8
D:1| T0: 0.10| T1: 515.00| I0: 300.0| I1: 100.0| WTP: 300000,1,0.096153846,515,300000,1,0.2,300,100,-2833767873,1391367689,6586.406862,2504447530,250444753,16,49940,2280,1094,1094,0,1094,49940,0,1094,21.40194611,0.643712575,0.643712575,63103.97156,126.1137725,1.466317365,99209.50374,0.635675392,0.001269373,1.64547E-05,0,0.021906288,191,28
D:1| T0: 0.10| T1: 515.00| I0: 300.0| I1: 100.0| WTP: 300000,1,0.096153846,515,300000,1,0.2,300,100,-1552896132,574142276,8711.360882,1117328088,111732808.8,6,68260,3027,1028,1447,419,1028,68260,419,1447,58.45525903,1.489795918,2.128728414,45664.82418,492.7974882,3.739403454,98876.81319,0.460916927,0.004956339,3.90818E-05,0.289564616,0.021198359,91,12
D:1| T0: 0.10| T1: 515.00| I0: 300.0| I1: 100.0| WTP: 300000,1,0.096153846,515,300000,1,0.2,300,100,-5299999945,898736779,6779.224515,4961038719,496103871.9,28,52993,2354,1126,1126,0,1126,52993,0,1126,15.54098361,0.376536885,0.376536885,67936.28074,202.0240779,0.967213115,99315.54918,0.683538202,0.002033281,1.15962E-05,0,0.021248089,279,56
D:1| T0: 0.10| T1: 515.00| I0: 300.0| I1: 100.0| WTP: 300000,1,0.096153846,515,300000,1,0.2,300,100,-1592145177,346473503,9107.904737,1136749940,113674994,6,83659,3995,705,1512,807,705,83659,807,1512,187.6121673,2.558935361,5.593155894,47566.31939,1805.48289,8.281368821,99124.53992,0.477771188,0.018116781,8.4613E-05,0.533730159,0.018073369,38,12
D:1| T0: 0.10| T1: 515.00| I0: 300.0| I1: 100.0| WTP: 300000,1,0.096153846,515,300000,1,0.2,300,100,-1614837646,445552282,9771.244653,1126275413,112627541.3,6,74932,3334,1023,1623,600,1023,74932,600,1623,92.79039301,2.100436681,3.390829694,44598.56332,935.5764192,5.626637555,98843.41703,0.449686464,0.009411044,5.81305E-05,0.369685767,0.021659638,65,12
D:1| T0: 0.10| T1: 515.00| I0: 300.0| I1: 100.0| WTP: 300000,1,0.096153846,515,300000,1,0.2,300,100,-1270786973,911758476,11284.51619,706561163.2,70656116.32,4,92449,4212,736,1874,1138,736,92449,1138,1874,252.5492958,3.384976526,8.638497653,28949.4554,1215.075117,12.10798122,98646.93427,0.292196282,0.012203292,0.000123144,0.607257204,0.020270636,31,7
D:1| T0: 0.10| T1: 515.00| I0: 300.0| I1: 100.0| WTP: 300000,1,0.096153846,515,300000,1,0.2,300,100,-1381815226,1464197940,11687.88935,797420758.4,79742075.84,4,96108,4386,679,1941,1262,679,96108,1262,1941,277.2636816,3.278606965,9.527363184,38605.37313,2774.383085,12.90547264,98875.17413,0.387457565,0.027857109,0.000130907,0.650180319,0.020196029,29,8
D:1| T0: 0.10| T1: 515.00| I0: 300.0| I1: 100.0| WTP: 300000,1,0.096153846,515,300000,1,0.2,300,100,-2157215311,500405854,8602.106739,1727109974,172710997.4,10,64737,2778,1305,1429,124,1305,64737,124,1429,42.48473748,1.407814408,1.550671551,52814.27595,319.0744811,3.153846154,98978.18926,0.532806081,0.003212112,3.35824E-05,0.086773968,0.02207393,117,19
D:1| T0: 0.10| T1: 515.00| I0: 300.0| I1: 100.0| WTP: 300000,1,0.096153846,515,300000,1,0.2,300,100,-1367557469,772037341,11777.84409,778665265.1,77866526.51,4,84909,3608,627,1957,1330,627,84909,1330,1957,214.6699029,2.917475728,9.32038835,47682.80583,1350.533981,12.36893204,98881.03398,0.47935571,0.013564432,0.000125993,0.67961165,0.023048205,30,8
D:1| T0: 0.10| T1: 515.00| I0: 300.0| I1: 100.0| WTP: 300000,1,0.096153846,515,300000,1,0.2,300,100,-4110236437,1543158763,5906.252246,3814923825,381492382.5,24,47993,2198,981,981,0,981,47993,0,981,15.85954382,0.390756303,0.390756303,71903.47659,139.3157263,0.977791116,99423.15666,0.722734837,0.001401732,1.18276E-05,0,0.020440481,238,43
D:1| T0: 0.10| T1: 515.00| I0: 300.0| I1: 100.0| WTP: 300000,1,0.096153846,515,300000,1,0.2,300,100,-1456046314,1604932531,13319.00724,790095952.1,79009595.21,4,94892,4067,764,2213,1449,764,94892,1449,2213,253.65,3.76,10.935,33670.975,1394.895,14.74,98553.945,0.33912986,0.014029531,0.000149718,0.654767284,0.023321249,29,8
D:1| T0: 0.10| T1: 515.00| I0: 300.0| I1: 100.0| WTP: 300000,1,0.096153846,515,300000,1,0.2,300,100,-1368832810,539051477,11601.00889,788782365.3,78878236.53,4,91936,4058,718,1927,1209,718,91936,1209,1927,224.8883929,3.107142857,8.446428571,42742.0625,2343.183036,11.64285714,98910.42857,0.429129865,0.02354521,0.000118658,0.627400104,0.020960233,32,8
D:1| T0: 0.10| T1: 515.00| I0: 300.0| I1: 100.0| WTP: 300000,1,0.096153846,515,300000,1,0.2,300,100,-3462215838,1743124675,6845.259715,3119952852,311995285.2,24,53560,2357,1137,1137,0,1137,53560,0,1137,21.96531365,0.641328413,0.641328413,68683.90332,133.8568266,1.473800738,99347.87528,0.690747672,0.00134761,1.68657E-05,0,0.021228529,194,35
D:1| T0: 0.10| T1: 515.00| I0: 300.0| I1: 100.0| WTP: 300000,1,0.096153846,515,300000,1,0.2,300,100,-1902714697,1965983789,8728.905623,1466269416,146626941.6,8,67867,2932,1120,1450,330,1120,67867,330,1450,55.7202473,1.647604328,2.142194745,47688.49304,610.4250386,3.874806801,98911.63524,0.480975201,0.006140139,3.99464E-05,0.227586207,0.021365632,93,16
D:1| T0: 0.10| T1: 515.00| I0: 300.0| I1: 100.0| WTP: 300000,1,0.096153846,515,300000,1,0.2,300,100,-3257032328,516774280,7880.189379,2863022859,286302285.9,18,62432,2682,1285,1309,24,1285,62432,24,1309,19.42647059,0.600588235,0.612941176,50194.50647,235.7294118,1.364705882,98966.01353,0.506649282,0.002373761,1.53504E-05,0.018334607,0.020966812,242,32
D:1| T0: 0.10| T1: 515.00| I0: 300.0| I1: 100.0| WTP: 300000,1,0.096153846,515,300000,1,0.2,300,100,-1167754674,86603142,11161.37223,609686062.4,60968606.24,4,87856,3773,609,1854,1245,609,87856,1245,1854,266.8232044,3.281767956,10.1160221,31717.18785,1258.834254,13.4640884,98647.71823,0.320517154,0.012628341,0.000136634,0.671521036,0.021102714,26,6
D:1| T0: 0.10| T1: 515.00| I0: 300.0| I1: 100.0| WTP: 300000,1,0.096153846,515,300000,1,0.2,300,100,-6816519670,1431870609,7272.224727,6452908434,645290843.4,40,58177,2570,1208,1208,0,1208,58177,0,1208,12.76970192,0.318089016,0.318089016,62879.48795,162.5741119,0.809718252,99233.66149,0.63304127,0.001637473,9.92113E-06,0,0.02076422,350,73
D:1| T0: 0.10| T1: 515.00| I0: 300.0| I1: 100.0| WTP: 300000,1,0.096153846,515,300000,1,0.2,300,100,-1462335722,1592383984,8562.609011,1034205271,103420527.1,6,71495,3274,720,1422,702,720,71495,702,1422,151.4736842,2.609022556,5.206766917,55176.14286,784.5451128,7.921052632,99162.36466,0.55479237,0.007870511,8.07942E-05,0.493670886,0.019889503,38,11
D:1| T0: 0.10| T1: 515.00| I0: 300.0| I1: 100.0| WTP: 300000,1,0.096153846,515,300000,1,0.2,300,100,-1767203152,1440183867,7803.491912,1377028557,137702855.7,8,65064,2865,991,1296,305,991,65064,305,1296,49.82724719,1.293539326,1.703651685,47242.54354,440.7457865,3.092696629,98967.26404,0.476651379,0.004432179,3.22866E-05,0.235339506,0.019918849,102,15
D:1| T0: 0.10| T1: 515.00| I0: 300.0| I1: 100.0| WTP: 300000,1,0.096153846,515,300000,1,0.2,300,100,-1810782143,1696510588,8680.208407,1376771723,137677172.3,8,66742,2845,1124,1442,318,1124,66742,318,1442,37.57234727,1.082529475,1.411575563,45265.28296,336.8263666,2.607717042,98833.71704,0.457192021,0.003391096,2.76751E-05,0.220527046,0.021605586,134,15
D:1| T0: 0.10| T1: 515.00| I0: 300.0| I1: 100.0| WTP: 300000,1,0.096153846,515,300000,1,0.2,300,100,-1546791553,895039877,11731.87867,960197619.3,96019761.93,6,88845,3763,683,1949,1266,683,88845,1266,1949,236.6305419,3.261083744,9.45320197,46669.00493,2306.172414,12.79802956,98949.06404,0.468630885,0.023163417,0.000130271,0.649563879,0.021937081,29,10
D:1| T0: 0.10| T1: 515.00| I0: 300.0| I1: 100.0| WTP: 300000,1,0.096153846,515,300000,1,0.2,300,100,-2265430852,129565953,9004.636664,1815199019,181519901.9,10,66524,2823,1253,1496,243,1253,66524,243,1496,38.05452563,1.264994547,1.521264995,45386.32279,512.2104689,2.895310796,98797.23119,0.458453647,0.005156351,3.01702E-05,0.162433155,0.022488125,130,20
D:1| T0: 0.10| T1: 515.00| I0: 300.0| I1: 100.0| WTP: 300000,1,0.096153846,515,300000,1,0.2,300,100,-2082384895,1902565669,7124.353753,1726167208,172616720.8,10,62764,2790,1061,1183,122,1061,62764,122,1183,28.43556281,0.728384992,0.823001631,48484.5571,197.0464927,1.686786297,99035.59054,0.489086351,0.001982965,1.8397E-05,0.103127642,0.018848384,176,19
D:1| T0: 0.10| T1: 515.00| I0: 300.0| I1: 100.0| WTP: 300000,1,0.096153846,515,300000,1,0.2,300,100,-4946299465,1984179288,8342.819685,4529158481,452915848.1,28,63498,2670,1385,1386,1,1385,63498,1,1386,17.81073897,0.545986178,0.545986178,57717.76502,254.5156831,1.27698033,99081.61988,0.581866541,0.002564125,1.48264E-05,0.000721501,0.021827803,269,51
D:1| T0: 0.10| T1: 515.00| I0: 300.0| I1: 100.0| WTP: 300000,1,0.096153846,515,300000,1,0.2,300,100,-1672883771,677377223,10776.64854,1134051344,113405134.4,6,84378,3760,982,1790,808,982,84378,808,1790,137.5146199,2.754385965,5.076023392,44094.5,2006.149123,7.964912281,98893.07018,0.443490911,0.020177447,8.15647E-05,0.451396648,0.021214061,48,12
D:1| T0: 0.10| T1: 515.00| I0: 300.0| I1: 100.0| WTP: 300000,1,0.096153846,515,300000,1,0.2,300,100,-1636446099,973583301,10114.98174,1130697012,113069701.2,6,83161,3652,1049,1680,631,1049,83161,631,1680,116.6813472,2.593264249,4.191709845,43396.62953,1753.088083,6.904145078,98924.07772,0.436575097,0.017627865,7.11207E-05,0.375595238,0.020201777,56,12
D:1| T0: 0.10| T1: 515.00| I0: 300.0| I1: 100.0| WTP: 300000,1,0.096153846,515,300000,1,0.2,300,100,-1856171829,781062938,7679.789883,1472182335,147218233.5,8,67209,3246,1026,1275,249,1026,67209,249,1275,49.92288557,1.143034826,1.446517413,45508.20274,385.210199,2.715174129,98990.48507,0.459033208,0.003873499,2.87656E-05,0.195294118,0.018970674,115,16
D:1| T0: 0.10| T1: 515.00| I0: 300.0| I1: 100.0| WTP: 300000,1,0.096153846,515,300000,1,0.2,300,100,-1955668869,338783425,9537.685585,1478784589,147878458.9,8,78335,3480,1117,1584,467,1117,78335,467,1584,112.8989637,2.764248705,3.917098446,51237.18135,1650.994819,6.821243523,99078.8057,0.515062453,0.016597431,7.03429E-05,0.294823232,0.020220846,56,16
D:1| T0: 0.10| T1: 515.00| I0: 300.0| I1: 100.0| WTP: 300000,1,0.096153846,515,300000,1,0.2,300,100,-6130242754,1027579040,7495.694169,5755458046,575545804.6,34,60507,2738,1245,1245,0,1245,60507,0,1245,15.42632794,0.395381062,0.395381062,60299.51732,210.6623557,0.974133949,99185.90577,0.60735333,0.002121412,1.15678E-05,0,0.020576132,309,65
D:1| T0: 0.10| T1: 515.00| I0: 300.0| I1: 100.0| WTP: 300000,1,0.096153846,515,300000,1,0.2,300,100,-1929482539,764973813,9103.822861,1474291396,147429139.6,8,73054,3240,1051,1512,461,1051,73054,461,1512,84.37654321,2.047325103,2.979423868,48412.15638,1025.329218,5.148148148,98978.14198,0.487535729,0.010308046,5.30212E-05,0.30489418,0.020697302,69,16
D:1| T0: 0.10| T1: 515.00| I0: 300.0| I1: 100.0| WTP: 300000,1,0.096153846,515,300000,1,0.2,300,100,-1636982850,1245753446,10126.8896,1130638370,113063837,6,82957,3589,791,1682,891,791,82957,891,1682,146.1483871,2.432258065,5.270967742,44432.0129,1834.8,7.822580645,98945.21935,0.446895393,0.018438291,8.02072E-05,0.529726516,0.020275809,45,12
D:1| T0: 0.10| T1: 515.00| I0: 300.0| I1: 100.0| WTP: 300000,1,0.096153846,515,300000,1,0.2,300,100,-1558974130,1013177794,8890.602571,1114444001,111444400.1,6,67359,2884,1090,1477,387,1090,67359,387,1477,54.01221374,1.523664122,2.097709924,46385.86107,428.5923664,3.766412214,98854.17252,0.468359867,0.004312399,3.94282E-05,0.262017603,0.021927285,94,12
D:1| T0: 0.10| T1: 515.00| I0: 300.0| I1: 100.0| WTP: 300000,1,0.096153846,515,300000,1,0.2,300,100,-5016167618,1395089249,6494.829694,4691426133,469142613.3,28,49195,2075,1079,1079,0,1079,49195,0,1079,14.64787946,0.409598214,0.409598214,71265.60324,143.3878348,1.01953125,99370.08259,0.716676661,0.00144338,1.21009E-05,0,0.021933123,256,53
D:1| T0: 0.10| T1: 515.00| I0: 300.0| I1: 100.0| WTP: 300000,1,0.096153846,515,300000,1,0.2,300,100,-5393637869,1339545835,5393.800888,5123947825,512394782.5,30,43657,1937,896,896,0,896,43657,0,896,8.62689324,0.169560399,0.169560399,74198.75914,122.8651644,0.51052826,99474.60251,0.745515658,0.001236257,6.64719E-06,0,0.020523627,387,58
D:1| T0: 0.10| T1: 515.00| I0: 300.0| I1: 100.0| WTP: 300000,1,0.096153846,515,300000,1,0.2,300,100,-1332052832,219139554,10832.89656,790408004.2,79040800.42,4,90154,4019,758,1799,1041,758,90154,1041,1799,289.5,4.191011236,9.938202247,41275.98315,1331.713483,14.19101124,98921.76404,0.415222809,0.01335809,0.000144089,0.578654808,0.019954744,26,8
D:1| T0: 0.10| T1: 515.00| I0: 300.0| I1: 100.0| WTP: 300000,1,0.096153846,515,300000,1,0.2,300,100,-2534329055,1336508942,7524.693551,2158094377,215809437.7,14,57963,2503,1226,1250,24,1226,57963,24,1250,28.72735761,0.948646125,0.971055089,58214.21662,217.5154062,2.124183007,99116.95145,0.586749011,0.002188871,2.3242E-05,0.0192,0.021565481,153,24
D:1| T0: 0.10| T1: 515.00| I0: 300.0| I1: 100.0| WTP: 300000,1,0.096153846,515,300000,1,0.2,300,100,-5244032812,448559423,6022.698943,4942897865,494289786.5,28,39291,1583,1001,1001,0,1001,39291,0,1001,11.16463768,0.411594203,0.411594203,74423.32348,176.9872464,0.991304348,99346.53217,0.748738381,0.001780433,1.16573E-05,0,0.025477221,247,56
D:1| T0: 0.10| T1: 515.00| I0: 300.0| I1: 100.0| WTP: 300000,1,0.096153846,515,300000,1,0.2,300,100,-1911483973,2110028840,8879.417722,1467513087,146751308.7,8,69517,3061,1230,1475,245,1230,69517,245,1475,51.83779972,1.576868829,1.902679831,47762.10014,479.5430183,3.631875882,98924.52186,0.481801812,0.004825597,3.83819E-05,0.166101695,0.021217832,102,16
D:1| T0: 0.10| T1: 515.00| I0: 300.0| I1: 100.0| WTP: 300000,1,0.096153846,515,300000,1,0.2,300,100,-1967411288,1982030155,9996.479795,1467587298,146758729.8,8,71617,2963,1139,1661,522,1139,71617,522,1661,88.08192771,2.621686747,3.848192771,52236.53012,1148.144578,6.590361446,98944.50602,0.526119546,0.01155041,6.78709E-05,0.314268513,0.023192817,60,16
D:1| T0: 0.10| T1: 515.00| I0: 300.0| I1: 100.0| WTP: 300000,1,0.096153846,515,300000,1,0.2,300,100,-1409392462,696219407,9306.462171,944069353.5,94406935.35,6,70618,3115,722,1546,824,722,70618,824,1546,120.0093168,2.105590062,4.639751553,52791.51553,731.7670807,6.863354037,99014.2205,0.531473813,0.007349119,7.07552E-05,0.532988357,0.021892435,46,10
D:1| T0: 0.10| T1: 515.00| I0: 300.0| I1: 100.0| WTP: 300000,1,0.096153846,515,300000,1,0.2,300,100,-1324873222,1402539442,10665.09851,791618296.9,79161829.69,4,93537,4147,701,1771,1070,701,93537,1070,1771,257.9359606,3.359605911,8.586206897,42599.54187,2112.738916,12.03448276,99011.71921,0.427492934,0.021198924,0.000122191,0.60417843,0.018933684,29,8
D:1| T0: 0.10| T1: 515.00| I0: 300.0| I1: 100.0| WTP: 300000,1,0.096153846,515,300000,1,0.2,300,100,-1616951961,1319833493,11312.62624,1051320650,105132065,6,88806,3972,720,1879,1159,720,88806,1159,1879,214.6410256,2.948717949,7.858974359,43348.15812,2568.15812,10.91452991,98904.40598,0.435550006,0.025803612,0.000111646,0.616817456,0.021158719,34,11
D:1| T0: 0.10| T1: 515.00| I0: 300.0| I1: 100.0| WTP: 300000,1,0.096153846,515,300000,1,0.2,300,100,-2462133129,663608076,7760.14677,2074125791,207412579.1,12,60852,2650,1168,1289,121,1168,60852,121,1289,30.06581353,0.945155393,1.052102377,50057.04753,335.6224863,2.111517367,98954.39945,0.505241563,0.003377162,2.25833E-05,0.093871218,0.021182541,157,23
D:1| T0: 0.10| T1: 515.00| I0: 300.0| I1: 100.0| WTP: 300000,1,0.096153846,515,300000,1,0.2,300,100,-2420765089,414696500,6978.65505,2071832336,207183233.6,12,57038,2482,1150,1159,9,1150,57038,9,1159,27.37661221,0.820292347,0.8288908,57901.30181,339.0567498,1.824591574,99162.38091,0.583267515,0.003409502,1.99518E-05,0.007772021,0.020302255,166,23
D:1| T0: 0.10| T1: 515.00| I0: 300.0| I1: 100.0| WTP: 300000,1,0.096153846,515,300000,1,0.2,300,100,-3976144421,1249738535,6794.140166,3636437413,363643741.3,22,46030,1914,1129,1129,0,1129,46030,0,1129,15.75688073,0.549803408,0.549803408,69518.33879,119.6769332,1.295543906,99258.82634,0.699862433,0.001205277,1.4871E-05,0,0.024527482,218,41
D:1| T0: 0.10| T1: 515.00| I0: 300.0| I1: 100.0| WTP: 300000,1,0.096153846,515,300000,1,0.2,300,100,-2430668475,614415382,7212.326972,2070052127,207005212.7,12,55643,2428,1158,1198,40,1158,55643,40,1198,26.44550173,0.870242215,0.907439446,55905.02941,303.7110727,1.906574394,99061.98702,0.563751224,0.003055351,2.04853E-05,0.033388982,0.021530112,166,23
D:1| T0: 0.10| T1: 515.00| I0: 300.0| I1: 100.0| WTP: 300000,1,0.096153846,515,300000,1,0.2,300,100,-4796810552,524899953,5517.457206,4520937692,452093769.2,26,50033,2345,916,916,0,916,50033,0,916,13.47015945,0.269248292,0.269248292,64989.99271,131.4004556,0.680182232,99364.99362,0.653657272,0.001321904,8.38077E-06,0,0.018308283,314,51
D:1| T0: 0.10| T1: 515.00| I0: 300.0| I1: 100.0| WTP: 300000,1,0.096153846,515,300000,1,0.2,300,100,-1298416506,1338977757,11848.84101,705974455.5,70597445.55,4,93037,4177,742,1968,1226,742,93037,1226,1968,246.6805556,3.384259259,9,30919.31944,1130.555556,12.43518519,98616.37963,0.311861299,0.011361959,0.000126125,0.62296748,0.021152875,31,7
D:1| T0: 0.10| T1: 515.00| I0: 300.0| I1: 100.0| WTP: 300000,1,0.096153846,515,300000,1,0.2,300,100,-1591392250,341384587,9462.256,1118279450,111827945,6,71935,3085,865,1572,707,865,71935,707,1572,64.07445008,1.304568528,2.485617597,41714.67174,415.0203046,3.947546531,98747.12521,0.421626689,0.004177007,4.15014E-05,0.449745547,0.021853366,85,12
D:1| T0: 0.10| T1: 515.00| I0: 300.0| I1: 100.0| WTP: 300000,1,0.096153846,515,300000,1,0.2,300,100,-1939928387,2032000160,9355.371822,1472159796,147215979.6,8,73150,3178,1100,1554,454,1100,73150,454,1554,92.42757009,2.453271028,3.478971963,48971.89019,1159.079439,6.039719626,98962.89019,0.493264602,0.011655925,6.23514E-05,0.292149292,0.021244019,62,16
D:1| T0: 0.10| T1: 515.00| I0: 300.0| I1: 100.0| WTP: 300000,1,0.096153846,515,300000,1,0.2,300,100,-1397049287,779488939,12224.57154,785820710.3,78582071.03,4,91732,3912,625,2031,1406,625,91732,1406,2031,228.8679245,2.844339623,9.438679245,44968.23113,1638.759434,12.38207547,98888.78302,0.451296361,0.016466312,0.000125932,0.692269818,0.022140583,31,8
D:1| T0: 0.10| T1: 515.00| I0: 300.0| I1: 100.0| WTP: 300000,1,0.096153846,515,300000,1,0.2,300,100,-2483281258,1449019578,8275.10685,2069525915,206952591.5,12,60327,2451,1272,1375,103,1272,60327,103,1375,19.28543814,0.699097938,0.762886598,49107.41366,241.1804124,1.575386598,98855.40657,0.496226808,0.00242889,1.71623E-05,0.074909091,0.022792448,221,23
D:1| T0: 0.10| T1: 515.00| I0: 300.0| I1: 100.0| WTP: 300000,1,0.096153846,515,300000,1,0.2,300,100,-4026726181,351952211,5895.767043,3731937829,373193782.9,24,51029,2393,979,979,0,979,51029,0,979,18.25498753,0.41084788,0.41084788,70167.03055,140.872818,1.032418953,99423.39214,0.705259178,0.001417492,1.22593E-05,0,0.019185169,230,42
D:1| T0: 0.10| T1: 515.00| I0: 300.0| I1: 100.0| WTP: 300000,1,0.096153846,515,300000,1,0.2,300,100,-3227602078,486595046,7368.510386,2859176558,285917655.8,16,56559,2479,1213,1224,11,1213,56559,11,1224,20.1704918,0.655081967,0.66295082,56220.52131,306.7259016,1.459016393,99059.28393,0.566906599,0.0030864,1.60678E-05,0.008986928,0.021641501,216,32
D:1| T0: 0.10| T1: 515.00| I0: 300.0| I1: 100.0| WTP: 300000,1,0.096153846,515,300000,1,0.2,300,100,-1825607656,296745624,8891.755235,1381019894,138101989.4,8,71097,3074,991,1477,486,991,71097,486,1477,69.36095764,1.703499079,2.572744015,44953.53591,642.8213628,4.405156538,98891.53223,0.45344578,0.006463983,4.57015E-05,0.329045362,0.020774435,78,15
D:1| T0: 0.10| T1: 515.00| I0: 300.0| I1: 100.0| WTP: 300000,1,0.096153846,515,300000,1,0.2,300,100,-3279516418,1671484194,6659.703686,2946531234,294653123.4,18,55340,2534,1103,1106,3,1103,55340,3,1106,24.0381323,0.677821012,0.679377432,60765.807,222.5307393,1.53307393,99226.05136,0.611927477,0.002238338,1.72726E-05,0.002712477,0.019985905,184,33
D:1| T0: 0.10| T1: 515.00| I0: 300.0| I1: 100.0| WTP: 300000,1,0.096153846,515,300000,1,0.2,300,100,-1400656959,422157396,12131.22765,794095577.1,79409557.71,4,96591,4263,730,2015,1285,730,96591,1285,2015,303.9602273,4.085227273,11.3125,36754.43182,2040.965909,15.46022727,98801.69318,0.369351593,0.02049057,0.000156608,0.637717122,0.020861157,26,8
D:1| T0: 0.10| T1: 515.00| I0: 300.0| I1: 100.0| WTP: 300000,1,0.096153846,515,300000,1,0.2,300,100,-1402373523,1916599091,12202.70418,792238313.8,79223831.38,4,94779,4116,740,2027,1287,740,94779,1287,2027,278.4787234,3.877659574,10.63297872,35077.48936,1759.478723,14.56382979,98720.57979,0.353014342,0.017671537,0.000147862,0.634928466,0.021386594,27,8
D:1| T0: 0.10| T1: 515.00| I0: 300.0| I1: 100.0| WTP: 300000,1,0.096153846,515,300000,1,0.2,300,100,-1394522098,1005953941,12016.98896,793672650.1,79367265.01,4,96439,4253,739,1996,1257,739,96439,1257,1996,300.8587571,4.107344633,11.1299435,35529.49153,2208.711864,15.31638418,98792.36723,0.357169885,0.022171188,0.000155156,0.629759519,0.020697021,26,8
D:1| T0: 0.10| T1: 515.00| I0: 300.0| I1: 100.0| WTP: 300000,1,0.096153846,515,300000,1,0.2,300,100,-1351808627,1422765615,11418.30215,780893519.3,78089351.93,4,84828,3612,733,1897,1164,733,84828,1164,1897,138.1939394,2.115151515,5.615151515,35722.34242,890.2272727,7.851515152,98624.77576,0.360262854,0.008957915,8.01868E-05,0.613600422,0.022362899,48,8
D:1| T0: 0.10| T1: 515.00| I0: 300.0| I1: 100.0| WTP: 300000,1,0.096153846,515,300000,1,0.2,300,100,-4739477360,699740192,6289.498102,4425002455,442500245.5,26,45782,1906,1045,1045,0,1045,45782,0,1045,11.17573801,0.317804428,0.317804428,70255.80581,125.9677122,0.803505535,99335.00046,0.706775185,0.001268078,9.68635E-06,0,0.022825565,310,50
D:1| T0: 0.10| T1: 515.00| I0: 300.0| I1: 100.0| WTP: 300000,1,0.096153846,515,300000,1,0.2,300,100,-5161093160,240885764,5864.533782,4867866471,486786647.1,28,49363,2230,974,974,0,974,49363,0,974,12.93643264,0.279411765,0.279411765,70353.037,143.4966793,0.741935484,99420.00901,0.707183365,0.001443741,9.28177E-06,0,0.019731378,302,55
D:1| T0: 0.10| T1: 515.00| I0: 300.0| I1: 100.0| WTP: 300000,1,0.096153846,515,300000,1,0.2,300,100,-1584343244,2023806564,9152.798641,1126703312,112670331.2,6,75258,3396,960,1520,560,960,75258,560,1520,95.45777778,2.011111111,3.222222222,42319.47111,696.26,5.357777778,98873.16889,0.426830896,0.007001431,5.5422E-05,0.368421053,0.020197188,65,12
D:1| T0: 0.10| T1: 515.00| I0: 300.0| I1: 100.0| WTP: 300000,1,0.096153846,515,300000,1,0.2,300,100,-3474717228,1907493879,7132.930137,3118070721,311807072.1,18,53789,2286,1185,1185,0,1185,53789,0,1185,17.19637462,0.558308157,0.558308157,60734.15106,202.21571,1.271299094,99143.93172,0.61204946,0.002035327,1.43967E-05,0,0.022030527,236,35
D:1| T0: 0.10| T1: 515.00| I0: 300.0| I1: 100.0| WTP: 300000,1,0.096153846,515,300000,1,0.2,300,100,-2006116322,1565815291,10623.41755,1474945445,147494544.5,8,76751,3304,1108,1765,657,1108,76751,657,1765,121.8869048,3.175595238,5.077380952,53762.17857,1840.910714,8.375,99013.96131,0.540680734,0.018513514,8.60053E-05,0.37223796,0.022996443,48,16
D:1| T0: 0.10| T1: 515.00| I0: 300.0| I1: 100.0| WTP: 300000,1,0.096153846,515,300000,1,0.2,300,100,-4604034466,784442364,5334.612168,4337303858,433730385.8,26,44235,1946,886,886,0,886,44235,0,886,14.63794135,0.353680431,0.353680431,70641.79174,139.8007181,0.875523639,99424.5757,0.710155332,0.001405829,1.06452E-05,0,0.020029388,238,49
D:1| T0: 0.10| T1: 515.00| I0: 300.0| I1: 100.0| WTP: 300000,1,0.096153846,515,300000,1,0.2,300,100,-1328696419,206369745,10808.1209,788290373.8,78829037.38,4,89831,3978,651,1795,1144,651,89831,1144,1795,221.8854626,2.748898678,7.735682819,43566.67401,1652.828194,10.59911894,98966.01322,0.437483646,0.016592473,0.000108216,0.637325905,0.019981966,33,8
D:1| T0: 0.10| T1: 515.00| I0: 300.0| I1: 100.0| WTP: 300000,1,0.096153846,515,300000,1,0.2,300,100,-1399854953,2087235992,12154.60119,792124894.1,79212489.41,4,96085,4163,716,2019,1303,716,96085,1303,2019,244.4439252,3.271028037,9.299065421,35212.33178,1958.341121,12.64485981,98751.13084,0.353717758,0.019681409,0.000128441,0.645368995,0.021012645,31,8
D:1| T0: 0.10| T1: 515.00| I0: 300.0| I1: 100.0| WTP: 300000,1,0.096153846,515,300000,1,0.2,300,100,-1888918648,1019092536,8428.974663,1467469915,146746991.5,8,68486,3012,1175,1400,225,1175,68486,225,1400,47.73514212,1.351421189,1.630490956,47432.21189,489.2596899,3.147286822,98953.3553,0.478391663,0.004922074,3.34598E-05,0.160714286,0.020442433,111,16
D:1| T0: 0.10| T1: 515.00| I0: 300.0| I1: 100.0| WTP: 300000,1,0.096153846,515,300000,1,0.2,300,100,-1516146340,1885906113,8126.405233,1109826079,110982607.9,6,62004,2636,1026,1350,324,1026,62004,324,1350,66.26868687,1.884848485,2.525252525,53878.5596,383.0848485,4.612121212,99027.85657,0.543218206,0.00385044,4.82333E-05,0.24,0.021774545,71,12
D:1| T0: 0.10| T1: 515.00| I0: 300.0| I1: 100.0| WTP: 300000,1,0.096153846,515,300000,1,0.2,300,100,-3856377080,2028637200,7509.250694,3480914546,348091454.6,24,62680,2827,1246,1247,1,1246,62680,1,1247,26.43257185,0.715549005,0.716285925,57968.80251,177.5482682,1.638172439,99171.83198,0.583904641,0.001787703,1.84728E-05,0.000801925,0.019895021,194,39
D:1| T0: 0.10| T1: 515.00| I0: 300.0| I1: 100.0| WTP: 300000,1,0.096153846,515,300000,1,0.2,300,100,-1348419305,181476086,11216.21996,787608306.9,78760830.69,4,90943,4062,602,1863,1261,602,90943,1261,1863,222.6339286,2.558035714,8.147321429,41150.10714,1895.102679,10.85267857,98895.33036,0.413318973,0.019025792,0.000110546,0.676865271,0.020485359,32,8
D:1| T0: 0.10| T1: 515.00| I0: 300.0| I1: 100.0| WTP: 300000,1,0.096153846,515,300000,1,0.2,300,100,-1373254053,2097578470,11685.14698,788996704.4,78899670.44,4,89677,4071,709,1941,1232,709,89677,1232,1941,204.465587,2.761133603,7.71659919,39028.49798,1979.57085,10.57894737,98772.87449,0.392509754,0.019896899,0.00010786,0.634724369,0.021644346,36,8
D:1| T0: 0.10| T1: 515.00| I0: 300.0| I1: 100.0| WTP: 300000,1,0.096153846,515,300000,1,0.2,300,100,-1918339302,119646392,9058.946356,1465391984,146539198.4,8,66491,2790,1175,1505,330,1175,66491,330,1505,68.68023256,2.147286822,2.763565891,53410.46705,806.5620155,5.044573643,98979.2345,0.538191609,0.008112949,5.22235E-05,0.219269103,0.022634642,74,16
D:1| T0: 0.10| T1: 515.00| I0: 300.0| I1: 100.0| WTP: 300000,1,0.096153846,515,300000,1,0.2,300,100,-1370247682,1298895859,11601.48818,790173272.4,79017327.24,4,93306,4115,776,1927,1151,776,93306,1151,1927,241.3113208,3.566037736,8.938679245,37637.36321,1834.410377,12.61320755,98806.64151,0.378343302,0.018428409,0.000128055,0.597301505,0.020652477,31,8
D:1| T0: 0.10| T1: 515.00| I0: 300.0| I1: 100.0| WTP: 300000,1,0.096153846,515,300000,1,0.2,300,100,-1281086956,1489316290,10024.69192,779852360.3,77985236.03,4,79345,3565,660,1665,1005,660,79345,1005,1665,180.0277778,2.492063492,6.44047619,46518.76587,1094.714286,9.075396825,98935.94841,0.468242795,0.010993592,9.26423E-05,0.603603604,0.020984309,36,8
D:1| T0: 0.10| T1: 515.00| I0: 300.0| I1: 100.0| WTP: 300000,1,0.096153846,515,300000,1,0.2,300,100,-1452302520,855602142,13311.86476,786709281.5,78670928.15,4,96804,3861,655,2212,1557,655,96804,1557,2212,211.2857143,2.761904762,9.454545455,32627.65368,1496.593074,12.29004329,98553.32468,0.327857515,0.015056015,0.000124876,0.703887884,0.022850295,33,8
D:1| T0: 0.10| T1: 515.00| I0: 300.0| I1: 100.0| WTP: 300000,1,0.096153846,515,300000,1,0.2,300,100,-1814548709,1438649896,8640.058816,1382545768,138254576.8,8,69989,3087,1053,1435,382,1053,69989,382,1435,62.58995138,1.585089141,2.196110211,45529.67585,577.2155592,3.904376013,98911.89465,0.459269985,0.00580605,4.0552E-05,0.266202091,0.020503222,88,15
D:1| T0: 0.10| T1: 515.00| I0: 300.0| I1: 100.0| WTP: 300000,1,0.096153846,515,300000,1,0.2,300,100,-5933650464,952489126,7323.417812,5567479573,556747957.3,32,52080,2142,1217,1217,0,1217,52080,0,1217,10.94122658,0.350511073,0.350511073,62992.73339,170.5549404,0.865843271,99147.67504,0.634840673,0.001717609,1.04253E-05,0,0.023367896,336,63
D:1| T0: 0.10| T1: 515.00| I0: 300.0| I1: 100.0| WTP: 300000,1,0.096153846,515,300000,1,0.2,300,100,-1139908859,1550779155,10709.2349,604447113.9,60444711.39,4,84344,3554,549,1779,1230,549,84344,1230,1779,228.5606061,2.666666667,8.833333333,31327.41919,1191.515152,11.61616162,98631.5101,0.317057843,0.011953381,0.00011807,0.691399663,0.021092194,29,6
D:1| T0: 0.10| T1: 515.00| I0: 300.0| I1: 100.0| WTP: 300000,1,0.096153846,515,300000,1,0.2,300,100,-5049546834,607323321,7043.279146,4697382876,469738287.6,30,55296,2397,1170,1170,0,1170,55296,0,1170,16.17894163,0.450627387,0.450627387,68212.73377,145.2509547,1.085651937,99330.018,0.686105526,0.001462892,1.2834E-05,0,0.021159237,262,53
D:1| T0: 0.10| T1: 515.00| I0: 300.0| I1: 100.0| WTP: 300000,1,0.096153846,515,300000,1,0.2,300,100,-1508441244,2103646485,7946.611489,1111110670,111111067,6,62287,2719,864,1320,456,864,62287,456,1320,63.35084428,1.491557223,2.335834897,50390.0863,351.3320826,3.943714822,98970.16135,0.508481349,0.003531716,4.11747E-05,0.345454545,0.021192223,77,12
D:1| T0: 0.10| T1: 515.00| I0: 300.0| I1: 100.0| WTP: 300000,1,0.096153846,515,300000,1,0.2,300,100,-1187916302,258120157,9816.134032,697109600.8,69710960.08,4,86490,3877,765,1630,865,765,86490,865,1630,274.125,4.25,9.079545455,37882.96023,1249.409091,13.42045455,98913.35227,0.38198227,0.012523214,0.000136465,0.530674847,0.018846109,26,7
D:1| T0: 0.10| T1: 515.00| I0: 300.0| I1: 100.0| WTP: 300000,1,0.096153846,515,300000,1,0.2,300,100,-2818084094,1068951401,7803.1833,2427924929,242792492.9,16,64520,2863,1261,1296,35,1261,64520,35,1296,33.04454976,1.001895735,1.03507109,54681.76777,238.4417062,2.22464455,99106.52227,0.551103368,0.002399968,2.43721E-05,0.027006173,0.020087729,151,27
D:1| T0: 0.10| T1: 515.00| I0: 300.0| I1: 100.0| WTP: 300000,1,0.096153846,515,300000,1,0.2,300,100,-2226758050,635956235,8330.404531,1810237823,181023782.3,10,61109,2663,1278,1384,106,1278,61109,106,1384,28.23300971,1.028243601,1.114739629,49927.49426,410.3654016,2.240953222,98888.60724,0.504073485,0.004129585,2.3637E-05,0.076589595,0.022648426,161,20
D:1| T0: 0.10| T1: 515.00| I0: 300.0| I1: 100.0| WTP: 300000,1,0.096153846,515,300000,1,0.2,300,100,-4454613315,1346693470,5856.961504,4161765239,416176523.9,26,45765,1995,973,973,0,973,45765,0,973,11.45458846,0.288552507,0.288552507,69747.535,110.8320719,0.749763482,99368.9281,0.701505422,0.001115668,9.24588E-06,0,0.021260789,302,47
D:1| T0: 0.10| T1: 515.00| I0: 300.0| I1: 100.0| WTP: 300000,1,0.096153846,515,300000,1,0.2,300,100,-1436811384,847102011,12905.10747,791556010.2,79155601.02,4,96205,4107,751,2144,1393,751,96205,1393,2144,273.8465608,3.899470899,11.17989418,35680.60317,1746.306878,15.15873016,98687.22751,0.35874908,0.017551088,0.000153949,0.649720149,0.022285744,27,8
D:1| T0: 0.10| T1: 515.00| I0: 300.0| I1: 100.0| WTP: 300000,1,0.096153846,515,300000,1,0.2,300,100,-1714735427,812083272,11705.96907,1129436974,112943697.4,6,83229,3514,929,1945,1016,929,83229,1016,1945,144.9046053,2.927631579,6.226973684,47286.86513,1685.930921,9.289473684,98850.78289,0.475603073,0.016966441,9.51709E-05,0.522365039,0.023369258,44,12
D:1| T0: 0.10| T1: 515.00| I0: 300.0| I1: 100.0| WTP: 300000,1,0.096153846,515,300000,1,0.2,300,100,-1329200586,2146825809,10784.68261,789966455.8,78996645.58,4,92017,4213,791,1791,1000,791,92017,1000,1791,304.4285714,4.642857143,10.5,37555.85714,1728.714286,15.19642857,98890.13095,0.378191999,0.017334485,0.000154162,0.558347292,0.019463795,24,8
D:1| T0: 0.10| T1: 515.00| I0: 300.0| I1: 100.0| WTP: 300000,1,0.096153846,515,300000,1,0.2,300,100,-1422160518,226186520,12664.04666,788958184.6,78895818.46,4,95343,4023,741,2104,1363,741,95343,1363,2104,260.0829016,3.797927461,10.79274611,37185.46114,1436.834197,14.62176166,98720.09845,0.373754352,0.014436702,0.00014812,0.647813688,0.022067692,28,8
D:1| T0: 0.10| T1: 515.00| I0: 300.0| I1: 100.0| WTP: 300000,1,0.096153846,515,300000,1,0.2,300,100,-1671403457,1110225441,10793.9403,1131706442,113170644.2,6,83782,3620,1052,1793,741,1052,83782,741,1793,109.9299517,2.446859903,4.200483092,41402.09903,1563.417874,6.734299517,98811.07971,0.416752734,0.015736354,6.91861E-05,0.413273843,0.021400778,60,12
D:1| T0: 0.10| T1: 515.00| I0: 300.0| I1: 100.0| WTP: 300000,1,0.096153846,515,300000,1,0.2,300,100,-1549218757,1190767082,8438.31671,1127302922,112730292.2,6,76949,3602,948,1401,453,948,76949,453,1401,118.9835616,2.449315068,3.660273973,47656.75068,1125.112329,6.265753425,99097.87671,0.479408559,0.011297258,6.46439E-05,0.323340471,0.018206864,53,12
D:1| T0: 0.10| T1: 515.00| I0: 300.0| I1: 100.0| WTP: 300000,1,0.096153846,515,300000,1,0.2,300,100,-2450069688,2108234095,7667.623861,2066688495,206668849.5,12,56196,2325,1216,1274,58,1216,56196,58,1274,30.03597884,1.092063492,1.15026455,57759.19048,363.1164021,2.455026455,99069.84974,0.58236799,0.003651818,2.64903E-05,0.045525903,0.022670653,135,23
D:1| T0: 0.10| T1: 515.00| I0: 300.0| I1: 100.0| WTP: 300000,1,0.096153846,515,300000,1,0.2,300,100,-1427185703,465621985,12659.72959,794199223.5,79419922.35,4,95321,4277,739,2103,1364,739,95321,1364,2103,254.4666667,3.428571429,9.880952381,29536.09524,1563.871429,13.39047619,98550.21429,0.297670185,0.015724434,0.000136115,0.648597242,0.022062295,30,8
D:1| T0: 0.10| T1: 515.00| I0: 300.0| I1: 100.0| WTP: 300000,1,0.096153846,515,300000,1,0.2,300,100,-2118711244,1487072553,7809.705154,1728225986,172822598.6,12,63602,2897,1192,1297,105,1192,63602,105,1297,41.3912037,1.208333333,1.325231481,52719.62384,263.7349537,2.701388889,99038.29051,0.531664709,0.002654092,2.89638E-05,0.080956052,0.02039244,124,19
D:1| T0: 0.10| T1: 515.00| I0: 300.0| I1: 100.0| WTP: 300000,1,0.096153846,515,300000,1,0.2,300,100,-1585188215,1213733847,9300.804262,1120148002,112014800.2,6,70532,3040,894,1545,651,894,70532,651,1545,119.8707692,2.618461538,4.593846154,51998.73538,921.44,7.335384615,99000.21846,0.523719141,0.009257401,7.54013E-05,0.421359223,0.021904951,47,12
D:1| T0: 0.10| T1: 515.00| I0: 300.0| I1: 100.0| WTP: 300000,1,0.096153846,515,300000,1,0.2,300,100,-1450304295,2003658337,10022.77439,949165575.6,94916557.56,6,77421,3295,720,1665,945,720,77421,945,1665,143.9792388,2.380622837,5.619377163,48371.38062,1095.865052,8.103806228,98950.68166,0.486844863,0.011008874,8.29139E-05,0.567567568,0.021505793,42,10
D:1| T0: 0.10| T1: 515.00| I0: 300.0| I1: 100.0| WTP: 300000,1,0.096153846,515,300000,1,0.2,300,100,-5919973659,1170868072,6928.983896,5573524464,557352446.4,36,54029,2429,1151,1151,0,1151,54029,0,1151,14.22441134,0.358000961,0.358000961,68743.95531,151.4392119,0.903892359,99353.95483,0.691303922,0.00152465,1.11207E-05,0,0.021303374,298,63
D:1| T0: 0.10| T1: 515.00| I0: 300.0| I1: 100.0| WTP: 300000,1,0.096153846,515,300000,1,0.2,300,100,-1248387758,569919592,10946.42582,701066467.4,70106646.74,4,90927,4036,754,1818,1064,754,90927,1064,1818,253.4723618,3.698492462,8.979899497,30524.05528,1191.648241,12.79396985,98700.54774,0.30818856,0.011961138,0.000129833,0.585258526,0.019994061,29,7
D:1| T0: 0.10| T1: 515.00| I0: 300.0| I1: 100.0| WTP: 300000,1,0.096153846,515,300000,1,0.2,300,100,-1536052886,1833180623,8233.200098,1124392881,112439288.1,6,73609,3467,1010,1367,357,1010,73609,357,1367,94.02031603,2.119638826,2.898419865,46665.58916,775.4740406,5.162528217,99053.39278,0.469996077,0.007789716,5.39094E-05,0.261155816,0.018571099,64,12
D:1| T0: 0.10| T1: 515.00| I0: 300.0| I1: 100.0| WTP: 300000,1,0.096153846,515,300000,1,0.2,300,100,-1449906411,1123666637,13169.32017,791440402.2,79144040.22,4,93680,4045,755,2188,1433,755,93680,1433,2188,305.5621302,4.384615385,12.77514793,40612.14201,1667.100592,17.24260355,98739.3432,0.408409567,0.01674863,0.000174963,0.654936015,0.023356106,25,8
D:1| T0: 0.10| T1: 515.00| I0: 300.0| I1: 100.0| WTP: 300000,1,0.096153846,515,300000,1,0.2,300,100,-1704109548,1682024981,11412.92154,1133463471,113346347.1,6,89643,3842,764,1896,1132,764,89643,1132,1896,188.3951613,2.943548387,7.475806452,45053.7621,2954.197581,10.55241935,98945.47581,0.452364142,0.029691437,0.000107839,0.597046414,0.021150564,35,12
D:1| T0: 0.10| T1: 515.00| I0: 300.0| I1: 100.0| WTP: 300000,1,0.096153846,515,300000,1,0.2,300,100,-1614347386,1687523543,9853.780441,1121658364,112165836.4,6,73916,3191,910,1637,727,910,73916,727,1637,121.412844,2.660550459,4.856269113,51852.32722,863.6544343,7.617737003,98992.85015,0.521887287,0.008680329,7.82927E-05,0.44410507,0.02214736,47,12
D:1| T0: 0.10| T1: 515.00| I0: 300.0| I1: 100.0| WTP: 300000,1,0.096153846,515,300000,1,0.2,300,100,-1345635842,178034412,11156.26963,787822360.1,78782236.01,4,88629,4029,653,1853,1200,653,88629,1200,1853,261.5811518,3.287958115,9.523560209,46469.73822,1635.806283,12.93717277,98981.01571,0.466733283,0.016413064,0.000131658,0.647598489,0.020907378,28,8
D:1| T0: 0.10| T1: 515.00| I0: 300.0| I1: 100.0| WTP: 300000,1,0.096153846,515,300000,1,0.2,300,100,-1343632261,739490003,11055.20661,790871930.9,79087193.09,4,91593,4084,689,1836,1147,689,91593,1147,1836,260.4773869,3.376884422,9.085427136,41796.68844,1289.628141,12.54271357,98924.0804,0.419874794,0.012941805,0.00012734,0.624727669,0.0200452,29,8
D:1| T0: 0.10| T1: 515.00| I0: 300.0| I1: 100.0| WTP: 300000,1,0.096153846,515,300000,1,0.2,300,100,-1553233087,178482706,10405.85626,1032940274,103294027.4,6,74832,3109,748,1729,981,748,74832,981,1729,105.8054054,1.886486486,4.510810811,44486.69189,865.7702703,6.52972973,98771.49189,0.44878558,0.008704529,6.73512E-05,0.567379988,0.023105397,53,11
D:1| T0: 0.10| T1: 515.00| I0: 300.0| I1: 100.0| WTP: 300000,1,0.096153846,515,300000,1,0.2,300,100,-1600293509,1919366370,9565.681338,1122009442,112200944.2,6,72536,3120,1061,1589,528,1061,72536,528,1589,79.68263473,1.966067864,2.992015968,46096.87226,498.7105788,5.119760479,98854.37126,0.464988624,0.005017954,5.3222E-05,0.332284456,0.021906666,72,12
D:1| T0: 0.10| T1: 515.00| I0: 300.0| I1: 100.0| WTP: 300000,1,0.096153846,515,300000,1,0.2,300,100,-1350194507,1819796913,11110.46298,794671358.1,79467135.81,4,96556,4424,693,1845,1152,693,96556,1152,1845,305.4971751,3.858757062,10.31638418,39525.46893,2242.305085,14.22033898,98959.40113,0.396708982,0.022489033,0.000143838,0.624390244,0.019108082,26,8
D:1| T0: 0.10| T1: 515.00| I0: 300.0| I1: 100.0| WTP: 300000,1,0.096153846,515,300000,1,0.2,300,100,-2010765753,1866591913,10583.52646,1481589430,148158943,8,83928,3660,1083,1758,675,1083,83928,675,1758,134.4268657,3.140298507,5.11641791,53016.58806,2060.208955,8.328358209,99104.49552,0.532233364,0.020715747,8.52932E-05,0.383959044,0.020946526,48,16
D:1| T0: 0.10| T1: 515.00| I0: 300.0| I1: 100.0| WTP: 300000,1,0.096153846,515,300000,1,0.2,300,100,-1283167706,1219425989,11643.03443,701015984.6,70101598.46,4,90737,4104,792,1934,1142,792,90737,1142,1934,271.2054054,4.194594595,10.29189189,32771.8973,1265.313514,14.56216216,98674.60541,0.330799664,0.012702179,0.000148043,0.590486039,0.021314348,27,7
D:1| T0: 0.10| T1: 515.00| I0: 300.0| I1: 100.0| WTP: 300000,1,0.096153846,515,300000,1,0.2,300,100,-1375186767,502409586,11691.69309,790602112.6,79060211.26,4,94589,4132,740,1942,1202,740,94589,1202,1942,234.9086758,3.292237443,8.716894977,35365.22374,1740.424658,12.12328767,98775.38813,0.355504956,0.017480772,0.000123025,0.618949537,0.020530929,32,8
D:1| T0: 0.10| T1: 515.00| I0: 300.0| I1: 100.0| WTP: 300000,1,0.096153846,515,300000,1,0.2,300,100,-1298231005,1405887957,10390.66199,778697905.8,77869790.58,4,81475,3596,731,1726,995,731,81475,995,1726,190.7467811,3.017167382,7.253218884,47510.91416,1061.261803,10.39484979,98959.02575,0.477923174,0.010656147,0.000105861,0.576477404,0.021184412,34,8
D:1| T0: 0.10| T1: 515.00| I0: 300.0| I1: 100.0| WTP: 300000,1,0.096153846,515,300000,1,0.2,300,100,-1310750888,283033753,10772.86618,772107578.5,77210757.85,4,78441,3243,736,1790,1054,736,78441,1054,1790,159.4703557,2.754940711,6.865612648,46613.99605,821.6679842,9.794466403,98849.01581,0.469582242,0.008255853,0.000100309,0.588826816,0.022819699,37,8
D:1| T0: 0.10| T1: 515.00| I0: 300.0| I1: 100.0| WTP: 300000,1,0.096153846,515,300000,1,0.2,300,100,-1631707308,1083157068,10178.47526,1122783545,112278354.5,6,75552,3236,1104,1691,587,1104,75552,587,1691,82.34836066,2.096311475,3.266393443,42607.33607,785.3504098,5.540983607,98773.31967,0.429969257,0.007901423,5.76564E-05,0.347131875,0.022381936,70,12
D:1| T0: 0.10| T1: 515.00| I0: 300.0| I1: 100.0| WTP: 300000,1,0.096153846,515,300000,1,0.2,300,100,-1564332210,1988704626,9034.193081,1112622556,111262255.6,6,67100,2768,1203,1501,298,1203,67100,298,1501,64.71537002,2.102466793,2.652751423,51775.22201,327.0910816,4.935483871,98950.97154,0.522184476,0.003291057,5.16087E-05,0.19853431,0.022369598,76,12
D:1| T0: 0.10| T1: 515.00| I0: 300.0| I1: 100.0| WTP: 300000,1,0.096153846,515,300000,1,0.2,300,100,-1235553535,884761309,10818.19661,694643704,69464370.4,4,83967,3749,680,1797,1117,680,83967,1117,1797,191.8065844,2.703703704,7.279835391,29886.15226,898.345679,10.08230453,98566.96708,0.302686556,0.009023984,0.000102489,0.621591541,0.02140152,35,7
D:1| T0: 0.10| T1: 515.00| I0: 300.0| I1: 100.0| WTP: 300000,1,0.096153846,515,300000,1,0.2,300,100,-2539396403,533485933,7408.15832,2168988487,216898848.7,14,63275,2967,1216,1230,14,1216,63275,14,1230,39.74416136,1.107218684,1.122080679,56944.19745,183.0138004,2.399150743,99178.86412,0.573513611,0.001841694,2.60987E-05,0.011382114,0.019438957,135,24
D:1| T0: 0.10| T1: 515.00| I0: 300.0| I1: 100.0| WTP: 300000,1,0.096153846,515,300000,1,0.2,300,100,-2141587106,632196071,8307.539199,1726210146,172621014.6,12,64027,2764,1295,1380,85,1295,64027,85,1380,43.16855346,1.431446541,1.533333333,55712.23019,208.0025157,3.161006289,99053.26667,0.561715608,0.002094329,3.38411E-05,0.061594203,0.021553407,114,19
D:1| T0: 0.10| T1: 515.00| I0: 300.0| I1: 100.0| WTP: 300000,1,0.096153846,515,300000,1,0.2,300,100,-1367451527,393400457,11482.34108,793334472.9,79333447.29,4,94442,4189,581,1907,1326,581,94442,1326,1907,266.935,2.815,9.385,40691.735,1473.695,12.275,98891.985,0.408448052,0.014792933,0.000124897,0.695332984,0.020192287,29,8
D:1| T0: 0.10| T1: 515.00| I0: 300.0| I1: 100.0| WTP: 300000,1,0.096153846,515,300000,1,0.2,300,100,-1308958325,398973227,10671.83767,775366441.6,77536644.16,4,79252,3307,687,1773,1086,687,79252,1086,1773,156.6273063,2.420664207,6.383763838,44968.54613,876.2804428,8.915129151,98833.99631,0.453017302,0.00880499,9.123E-05,0.612521151,0.02237224,39,8
D:1| T0: 0.10| T1: 515.00| I0: 300.0| I1: 100.0| WTP: 300000,1,0.096153846,515,300000,1,0.2,300,100,-1625618266,1402256491,9910.577449,1130089394,113008939.4,6,80612,3629,974,1646,672,974,80612,672,1646,151.8067797,3.166101695,5.396610169,50178.82712,1719.433898,8.708474576,99058.63729,0.504385303,0.017273538,8.92648E-05,0.408262454,0.020418796,43,12
D:1| T0: 0.10| T1: 515.00| I0: 300.0| I1: 100.0| WTP: 300000,1,0.096153846,515,300000,1,0.2,300,100,-1417702314,2102527413,12585.78621,788413003.6,78841300.36,4,91625,3900,698,2091,1393,698,91625,1393,2091,198.4365079,2.662698413,8.154761905,39848.72619,2102.353175,10.92063492,98734.33333,0.400390378,0.021147796,0.000111369,0.666188427,0.022821282,36,8
D:1| T0: 0.10| T1: 515.00| I0: 300.0| I1: 100.0| WTP: 300000,1,0.096153846,515,300000,1,0.2,300,100,-1376646080,1748031099,11822.1405,785539054.7,78553905.47,4,91504,3881,672,1964,1292,672,91504,1292,1964,205.0805085,2.737288136,8.177966102,38983.5339,2100.516949,11.00847458,98797.72458,0.39176593,0.021109395,0.000112304,0.657841141,0.021464012,34,8
D:1| T0: 0.10| T1: 515.00| I0: 300.0| I1: 100.0| WTP: 300000,1,0.096153846,515,300000,1,0.2,300,100,-1893686662,1946754629,8578.23922,1464774701,146477470.1,8,65190,2894,1192,1425,233,1192,65190,233,1425,45.28791774,1.367609254,1.650385604,50899.08098,322.033419,3.176092545,98944.10283,0.513580407,0.003241133,3.38349E-05,0.163508772,0.021859181,112,16
D:1| T0: 0.10| T1: 515.00| I0: 300.0| I1: 100.0| WTP: 300000,1,0.096153846,515,300000,1,0.2,300,100,-1513576986,2097712204,8013.258541,1112914059,111291405.9,6,64921,2912,1013,1331,318,1013,64921,318,1331,62.7920434,1.638336347,2.198915009,51456.95118,366.3562387,4.048824593,99031.05606,0.518807863,0.003683309,4.25992E-05,0.238918107,0.020501841,79,12
D:1| T0: 0.10| T1: 515.00| I0: 300.0| I1: 100.0| WTP: 300000,1,0.096153846,515,300000,1,0.2,300,100,-1885383761,1198827119,8427.924174,1463987552,146398755.2,8,61458,2695,1235,1400,165,1235,61458,165,1400,46.82479784,1.517520216,1.735849057,54867.54582,532.3989218,3.396226415,98998.42453,0.553175636,0.005355092,3.57125E-05,0.117857143,0.022779785,106,16
D:1| T0: 0.10| T1: 515.00| I0: 300.0| I1: 100.0| WTP: 300000,1,0.096153846,515,300000,1,0.2,300,100,-5047042046,109253198,5483.831094,4772850491,477285049.1,28,42184,1818,911,911,0,911,42184,0,911,11.72895277,0.289527721,0.289527721,75743.86037,151.3495893,0.755646817,99482.30493,0.761002901,0.001522193,9.39112E-06,0,0.021595866,278,54
D:1| T0: 0.10| T1: 515.00| I0: 300.0| I1: 100.0| WTP: 300000,1,0.096153846,515,300000,1,0.2,300,100,-3132372820,314481292,7212.410673,2771752286,277175228.6,20,57567,2520,1193,1198,5,1193,57567,5,1198,25.38165438,0.786240786,0.78951679,59835.97543,140.7289107,1.766584767,99166.20721,0.602837086,0.001417299,1.9684E-05,0.004177109,0.020793163,175,31
D:1| T0: 0.10| T1: 515.00| I0: 300.0| I1: 125.0| WTP: 350000,1,0.096153846,515,350000,1,0.2,300,125,-4136436414,1178568022,7999.293354,3736471746,373647174.6,24,59223,2485,1329,1329,0,1329,59223,0,1329,18.82257091,0.614363307,0.614363307,60297.64937,184.5340978,1.417018709,99113.01871,0.607685346,0.001859208,1.61385E-05,0,0.022440985,236,42
D:1| T0: 0.10| T1: 515.00| I0: 300.0| I1: 125.0| WTP: 350000,1,0.096153846,515,350000,1,0.2,300,125,-1383520751,2029998696,11830.2407,792008715.4,79200871.54,4,94945,4164,648,1965,1317,648,94945,1317,1965,230.8502203,2.753303965,8.524229075,35657.04846,1414.511013,11.37444934,98757.2467,0.358235323,0.014213002,0.00011567,0.670229008,0.020696193,33,8
D:1| T0: 0.10| T1: 515.00| I0: 300.0| I1: 125.0| WTP: 350000,1,0.096153846,515,350000,1,0.2,300,125,-1413972414,776062361,12590.52504,784446162.6,78444616.26,4,92374,3822,796,2092,1296,796,92374,1296,2092,176.2304833,2.862453532,7.643122677,39223.80669,2136.762082,10.60594796,98727.87361,0.394065151,0.021505698,0.000108069,0.619502868,0.022647065,38,8
D:1| T0: 0.10| T1: 515.00| I0: 300.0| I1: 125.0| WTP: 350000,1,0.096153846,515,350000,1,0.2,300,125,-3775046235,1813046880,7747.62516,3387664977,338766497.7,22,58907,2598,1281,1287,6,1281,58907,6,1287,18.93220339,0.568088837,0.571011105,56999.57919,217.5663355,1.331969608,99058.45178,0.574819567,0.002191267,1.5097E-05,0.004662005,0.021848369,245,38
D:1| T0: 0.10| T1: 515.00| I0: 300.0| I1: 125.0| WTP: 350000,1,0.096153846,515,350000,1,0.2,300,125,-2087279734,2032407216,7250.045821,1724777443,172477744.3,12,61539,2737,1099,1204,105,1099,61539,105,1204,38.68721461,1.082191781,1.196347032,52628.17352,245.0821918,2.445205479,99094.44863,0.530508471,0.002464655,2.64193E-05,0.087209302,0.019564829,126,19
D:1| T0: 0.10| T1: 515.00| I0: 300.0| I1: 125.0| WTP: 350000,1,0.096153846,515,350000,1,0.2,300,125,-6140551408,1507873352,6289.002613,5826101278,582610127.8,38,45643,1918,1045,1045,0,1045,45643,0,1045,9.85056509,0.262871494,0.262871494,72934.66555,139.0556718,0.703223106,99392.69694,0.733277461,0.001399597,8.79068E-06,0,0.022895077,341,66
D:1| T0: 0.10| T1: 515.00| I0: 300.0| I1: 125.0| WTP: 350000,1,0.096153846,515,350000,1,0.2,300,125,-2912987189,1855899401,6424.133255,2591780526,259178052.6,18,51866,2314,1067,1067,0,1067,51866,0,1067,24.45017182,0.711340206,0.711340206,67980.39261,165.4037801,1.620274914,99349.98969,0.683732326,0.001663848,1.84157E-05,0,0.020573037,167,29
D:1| T0: 0.10| T1: 515.00| I0: 300.0| I1: 125.0| WTP: 350000,1,0.096153846,515,350000,1,0.2,300,125,-1447033641,1819459251,9986.269449,947720168.5,94772016.85,6,74903,3238,711,1659,948,711,74903,948,1659,166.9344262,2.795081967,6.635245902,52835.87705,1101.565574,9.532786885,99029.59836,0.53152131,0.011056307,9.75295E-05,0.571428571,0.022148646,35,10
D:1| T0: 0.10| T1: 515.00| I0: 300.0| I1: 125.0| WTP: 350000,1,0.096153846,515,350000,1,0.2,300,125,-2764500844,909791748,6858.230655,2421589312,242158931.2,22,54624,2455,1139,1139,0,1139,54624,0,1139,26.82679181,0.7721843,0.7721843,67005.92321,151.2244027,1.738054608,99320.89164,0.674011527,0.001522106,1.95313E-05,0,0.02085164,168,27
D:1| T0: 0.10| T1: 515.00| I0: 300.0| I1: 125.0| WTP: 350000,1,0.096153846,515,350000,1,0.2,300,125,-1476838419,1339092841,9063.685199,1023654159,102365415.9,6,65749,2721,812,1506,694,812,65749,694,1506,89.15915119,2.068965517,3.888594164,51412.98674,627.1883289,6.031830239,98925.66048,0.518515701,0.006302596,6.17803E-05,0.460823373,0.02290564,54,11
D:1| T0: 0.10| T1: 515.00| I0: 300.0| I1: 125.0| WTP: 350000,1,0.096153846,515,350000,1,0.2,300,125,-1403507233,1365866345,12208.93929,793060268.4,79306026.84,4,95855,4267,715,2028,1313,715,95855,1313,2028,219.3112033,2.887966805,8.298755187,32980.77593,1247.344398,11.24481328,98667.9917,0.331489792,0.0125414,0.000114431,0.647435897,0.021156956,35,8
D:1| T0: 0.10| T1: 515.00| I0: 300.0| I1: 125.0| WTP: 350000,1,0.096153846,515,350000,1,0.2,300,125,-1572425539,825453433,8912.60515,1126795282,112679528.2,6,75128,3348,899,1480,581,899,75128,581,1480,106.8044554,2.094059406,3.514851485,45192.02475,946.3836634,5.747524752,98971.0198,0.455215944,0.009507945,5.91903E-05,0.392567568,0.019699712,58,12
D:1| T0: 0.10| T1: 515.00| I0: 300.0| I1: 125.0| WTP: 350000,1,0.096153846,515,350000,1,0.2,300,125,-1392680308,939711378,11974.9893,793930842.6,79393084.26,4,96951,4287,640,1989,1349,640,96951,1349,1989,232.7434783,2.726086957,8.539130435,32911.42174,1656.417391,11.30434783,98717.07391,0.330585224,0.016642516,0.000114881,0.678230266,0.020515518,33,8
D:1| T0: 0.10| T1: 515.00| I0: 300.0| I1: 125.0| WTP: 350000,1,0.096153846,515,350000,1,0.2,300,125,-1894952660,638950699,8430.951515,1473405084,147340508.4,8,70609,3151,1087,1400,313,1087,70609,313,1400,69.30204778,1.747440273,2.262798635,45785.31399,760.7542662,4.126279863,98958.57167,0.461567767,0.007648648,4.26643E-05,0.223571429,0.019827501,84,16
D:1| T0: 0.10| T1: 515.00| I0: 300.0| I1: 125.0| WTP: 350000,1,0.096153846,515,350000,1,0.2,300,125,-2295228574,938699148,7869.18058,1901769545,190176954.5,12,64058,2860,1225,1307,82,1225,64058,82,1307,42.82076638,1.313967862,1.410383189,55313.21261,266.9295426,2.907292954,99103.41286,0.557381921,0.002685697,3.14657E-05,0.062787136,0.020388092,116,21
D:1| T0: 0.10| T1: 515.00| I0: 300.0| I1: 125.0| WTP: 350000,1,0.096153846,515,350000,1,0.2,300,125,-4171057385,121790188,6877.208223,3827196974,382719697.4,24,58202,2694,1142,1142,0,1142,58202,0,1142,18.41153846,0.463736264,0.463736264,60126.89945,230.4604396,1.087362637,99226.55934,0.605369822,0.002318918,1.26145E-05,0,0.019621319,259,43
D:1| T0: 0.10| T1: 515.00| I0: 300.0| I1: 125.0| WTP: 350000,1,0.096153846,515,350000,1,0.2,300,125,-1532557605,1331335240,11366.86569,964214320.1,96421432.01,6,90780,3925,725,1888,1163,725,90780,1163,1888,215.2085106,2.953191489,7.85106383,42999.01702,2546.085106,10.92765957,98927.48085,0.43176248,0.025577976,0.000111758,0.615995763,0.020797532,34,10
D:1| T0: 0.10| T1: 515.00| I0: 300.0| I1: 125.0| WTP: 350000,1,0.096153846,515,350000,1,0.2,300,125,-1344883793,470935411,12850.55476,702356055.6,70235605.56,4,93723,3995,728,2135,1407,728,93723,1407,2135,299.1823529,4.194117647,12.37647059,34795.56471,1426.711765,16.67058824,98640.10588,0.350554058,0.014330058,0.000169245,0.659016393,0.022779894,25,7
D:1| T0: 0.10| T1: 515.00| I0: 300.0| I1: 125.0| WTP: 350000,1,0.096153846,515,350000,1,0.2,300,125,-1854942673,823434397,9509.846772,1379450334,137945033.4,8,67555,2880,1096,1580,484,1096,67555,484,1580,48.31084656,1.335978836,1.953703704,45492.4828,458.026455,3.41005291,98755.21296,0.459606786,0.004612437,3.56305E-05,0.306329114,0.02338835,108,15
D:1| T0: 0.10| T1: 515.00| I0: 300.0| I1: 125.0| WTP: 350000,1,0.096153846,515,350000,1,0.2,300,125,-2577996051,493045351,6671.479823,2244422060,224442206,18,53985,2425,1108,1108,0,1108,53985,0,1108,31.02153846,0.945641026,0.945641026,65202.95897,141.1046154,2.071794872,99307.8359,0.655982048,0.001419712,2.28311E-05,0,0.02052422,140,25
D:1| T0: 0.10| T1: 515.00| I0: 300.0| I1: 125.0| WTP: 350000,1,0.096153846,515,350000,1,0.2,300,125,-1755128038,1700216563,7439.205727,1383167752,138316775.2,8,65454,3003,988,1235,247,988,65454,247,1235,94.81204819,2.262650602,2.83373494,57538.34458,847.0433735,5.207228916,99240.98795,0.578572346,0.008501784,5.37672E-05,0.2,0.018868213,60,15
D:1| T0: 0.10| T1: 515.00| I0: 300.0| I1: 125.0| WTP: 350000,1,0.096153846,515,350000,1,0.2,300,125,-1666401474,1744119059,7515.62985,1290619981,129061998.1,8,63484,2929,1104,1248,144,1104,63484,144,1248,57.51980983,1.54199683,1.762282092,53094.49287,277.1838352,3.527733756,99098.68621,0.535165969,0.002786896,3.74521E-05,0.115384615,0.019658497,91,14
D:1| T0: 0.10| T1: 515.00| I0: 300.0| I1: 125.0| WTP: 350000,1,0.096153846,515,350000,1,0.2,300,125,-2813811233,2036906360,7866.789261,2420471770,242047177,14,59766,2586,1285,1307,22,1285,59766,22,1307,21.92903693,0.758146271,0.774076756,54117.34975,300.4467777,1.710354815,99014.40188,0.54587453,0.003024395,1.88784E-05,0.016832441,0.021868621,197,27
D:1| T0: 0.10| T1: 515.00| I0: 300.0| I1: 125.0| WTP: 350000,1,0.096153846,515,350000,1,0.2,300,125,-1877769364,809704121,8171.308232,1469203953,146920395.3,8,67694,3069,1009,1357,348,1009,67694,348,1357,91.42925659,2.278177458,3.09352518,55503.19664,838.7889688,5.51558753,99149.98561,0.558406623,0.008424791,5.69833E-05,0.256448047,0.02004609,59,16
D:1| T0: 0.10| T1: 515.00| I0: 300.0| I1: 125.0| WTP: 350000,1,0.096153846,515,350000,1,0.2,300,125,-1684505053,1219866412,10945.81042,1137214532,113721453.2,6,87994,3874,920,1818,898,920,87994,898,1818,155.5904762,2.80952381,5.619047619,38110.63492,2295.539683,8.53015873,98804.75238,0.383511001,0.02308472,8.74619E-05,0.493949395,0.0206605,45,12
D:1| T0: 0.10| T1: 515.00| I0: 300.0| I1: 125.0| WTP: 350000,1,0.096153846,515,350000,1,0.2,300,125,-4499210565,843498920,6604.061749,4169007478,416900747.8,32,52821,2276,1097,1097,0,1097,52821,0,1097,16.53796729,0.443341121,0.443341121,68639.05841,147.8224299,1.08703271,99341.22664,0.690380102,0.00148831,1.28785E-05,0,0.020768255,245,47
D:1| T0: 0.10| T1: 515.00| I0: 300.0| I1: 125.0| WTP: 350000,1,0.096153846,515,350000,1,0.2,300,125,-1981660987,107351963,10326.07949,1465357012,146535701.2,8,71840,2807,1295,1716,421,1295,71840,421,1716,48.4813278,1.64868603,2.215767635,44824.26694,690.9377593,3.987551867,98718.40387,0.452727074,0.006959652,4.19493E-05,0.245337995,0.023886414,104,16
D:1| T0: 0.10| T1: 515.00| I0: 300.0| I1: 125.0| WTP: 350000,1,0.096153846,515,350000,1,0.2,300,125,-1938570457,773789021,9313.572893,1472891812,147289181.2,8,69960,3174,1120,1547,427,1120,69960,427,1547,80.8989899,2.125252525,2.965656566,51247.27879,958.0060606,5.22020202,98966.28485,0.516321658,0.009635197,5.41865E-05,0.2760181,0.022112636,71,16
D:1| T0: 0.10| T1: 515.00| I0: 300.0| I1: 125.0| WTP: 350000,1,0.096153846,515,350000,1,0.2,300,125,-1618199969,850936611,10020.55179,1117172380,111717238,6,69867,2894,1127,1665,538,1127,69867,538,1665,57.07142857,1.641304348,2.448757764,44639.63509,575.613354,4.187888199,98709.67081,0.451028243,0.005796502,4.36564E-05,0.323123123,0.023830993,92,12
D:1| T0: 0.10| T1: 515.00| I0: 300.0| I1: 125.0| WTP: 350000,1,0.096153846,515,350000,1,0.2,300,125,-1568445633,1701318364,8982.293752,1119330945,111933094.5,6,70496,3025,1075,1492,417,1075,70496,417,1492,60.82250396,1.580031696,2.228209192,42821.13154,470.340729,3.93977813,98808.25674,0.43253079,0.004732987,4.09292E-05,0.279490617,0.021164321,91,12
D:1| T0: 0.10| T1: 515.00| I0: 300.0| I1: 125.0| WTP: 350000,1,0.096153846,515,350000,1,0.2,300,125,-4074920055,778708269,6892.235166,3730308297,373030829.7,22,52460,2266,1145,1145,0,1145,52460,0,1145,12.54307623,0.384754172,0.384754172,59747.25485,181.3423545,0.893549842,99136.32206,0.602186507,0.001825235,1.03839E-05,0,0.021826985,317,42
D:1| T0: 0.10| T1: 515.00| I0: 300.0| I1: 125.0| WTP: 350000,1,0.096153846,515,350000,1,0.2,300,125,-2945153112,1391938506,8672.698854,2511518170,251151817,18,62021,2587,1395,1441,46,1395,62021,46,1441,31.42703232,1.145935357,1.190009794,59009.10382,217.222331,2.554358472,99053.19882,0.595013303,0.002188541,2.79518E-05,0.031922276,0.023234066,146,28
D:1| T0: 0.10| T1: 515.00| I0: 300.0| I1: 125.0| WTP: 350000,1,0.096153846,515,350000,1,0.2,300,125,-4577252929,43418681,6524.130763,4251046391,425104639.1,28,48956,2068,1084,1084,0,1084,48956,0,1084,13.22163309,0.381230117,0.381230117,70408.18346,147.4135737,0.950159067,99348.64104,0.708178844,0.001483875,1.15517E-05,0,0.022142332,270,48
D:1| T0: 0.10| T1: 515.00| I0: 300.0| I1: 125.0| WTP: 350000,1,0.096153846,515,350000,1,0.2,300,125,-1417547193,817384966,12692.12962,782940711.9,78294071.19,4,90602,3756,789,2109,1320,789,90602,1320,2109,252.4456522,4.195652174,11.2826087,40878.88587,1341.407609,15.5923913,98743.14674,0.411496812,0.013472938,0.000158227,0.625889047,0.023277632,27,8
D:1| T0: 0.10| T1: 515.00| I0: 300.0| I1: 125.0| WTP: 350000,1,0.096153846,515,350000,1,0.2,300,125,-1329680087,762053968,10908.90403,784234885.7,78423488.57,4,89409,3903,706,1812,1106,706,89409,1106,1812,233.9460784,3.362745098,8.730392157,42878.75,1366.02451,12.18627451,98936.04902,0.430944848,0.013709946,0.000123882,0.610375276,0.020266416,30,8
D:1| T0: 0.10| T1: 515.00| I0: 300.0| I1: 125.0| WTP: 350000,1,0.096153846,515,350000,1,0.2,300,125,-2203774780,1692506311,7726.122047,1817468677,181746867.7,10,67031,3056,1176,1283,107,1176,67031,107,1283,37.49795918,1.047959184,1.154081633,47771.57347,453.5826531,2.357142857,99020.71122,0.481665051,0.004562278,2.5228E-05,0.083398285,0.019140398,139,20
D:1| T0: 0.10| T1: 515.00| I0: 300.0| I1: 125.0| WTP: 350000,1,0.096153846,515,350000,1,0.2,300,125,-3332903709,1037620300,6193.663915,3023220513,302322051.3,22,48418,2055,1029,1029,0,1029,48418,0,1029,17.07482517,0.530769231,0.530769231,68308.54336,141.6888112,1.258041958,99337.66434,0.687156464,0.001425513,1.44558E-05,0,0.021252427,205,34
D:1| T0: 0.10| T1: 515.00| I0: 300.0| I1: 125.0| WTP: 350000,1,0.096153846,515,350000,1,0.2,300,125,-3154365154,301400999,7597.677721,2774481268,277448126.8,18,59630,2540,1243,1262,19,1243,59630,19,1262,29.82600733,0.921245421,0.937728938,60226.82967,226.4001832,2.085164835,99180.7033,0.606625258,0.002278369,2.30643E-05,0.015055468,0.021163844,156,31
D:1| T0: 0.10| T1: 515.00| I0: 300.0| I1: 125.0| WTP: 350000,1,0.096153846,515,350000,1,0.2,300,125,-1333353780,1868336855,11034.19698,781643931.1,78164393.11,4,85024,3691,738,1833,1095,738,85024,1095,1833,181.6062992,2.767716535,7.05511811,45113.5,1305.53937,9.94488189,98904.12598,0.453593972,0.013117366,0.000101749,0.597381342,0.021558619,37,8
D:1| T0: 0.10| T1: 515.00| I0: 300.0| I1: 125.0| WTP: 350000,1,0.096153846,515,350000,1,0.2,300,125,-1495969066,1868498144,10876.47521,952145305.9,95214530.59,6,82271,3532,714,1807,1093,714,82271,1093,1807,143.1258278,2.245033113,5.831125828,42091,1136.758278,8.215231788,98794.66556,0.42389333,0.011430018,8.39388E-05,0.60486995,0.021963997,44,10
D:1| T0: 0.10| T1: 515.00| I0: 300.0| I1: 125.0| WTP: 350000,1,0.096153846,515,350000,1,0.2,300,125,-2712421116,2101566889,7519.674982,2336437367,233643736.7,14,57734,2558,1243,1249,6,1243,57734,6,1249,25.14142967,0.774019985,0.778631822,57531.17986,251.6441199,1.732513451,99087.84935,0.580031343,0.002532682,1.92598E-05,0.004803843,0.021634824,186,26
D:1| T0: 0.10| T1: 515.00| I0: 300.0| I1: 125.0| WTP: 350000,1,0.096153846,515,350000,1,0.2,300,125,-1326607715,1665097450,12466.49921,703282753.9,70328275.39,4,95376,4092,712,2071,1359,712,95376,1359,2071,268.265625,3.651041667,10.65625,33922.08333,1700.838542,14.359375,98663.69271,0.341408236,0.017091824,0.000145674,0.656204732,0.021714058,28,7
D:1| T0: 0.10| T1: 515.00| I0: 300.0| I1: 125.0| WTP: 350000,1,0.096153846,515,350000,1,0.2,300,125,-1337506518,1716179948,10775.50476,798731279.7,79873127.97,4,97436,4498,713,1789,1076,713,97436,1076,1789,304.7365591,3.747311828,9.478494624,36982.23118,1808.892473,13.31182796,98946.6129,0.371245615,0.018147954,0.000134933,0.601453326,0.01836077,27,8
D:1| T0: 0.10| T1: 515.00| I0: 300.0| I1: 125.0| WTP: 350000,1,0.096153846,515,350000,1,0.2,300,125,-2833973792,1560278715,8346.087891,2416669397,241666939.7,16,54685,2254,1387,1387,0,1387,54685,0,1387,25.89439252,1.101869159,1.101869159,64761.42804,173.8850467,2.396261682,99122.94579,0.652592398,0.001751712,2.60816E-05,0,0.025364373,152,27
D:1| T0: 0.10| T1: 515.00| I0: 300.0| I1: 125.0| WTP: 350000,1,0.096153846,515,350000,1,0.2,300,125,-1400544680,991019385,12343.8999,783349685.4,78334968.54,4,90105,3827,713,2051,1338,713,90105,1338,2051,176.2255639,2.560150376,7.567669173,38985.35338,2004.496241,10.26691729,98708.37218,0.392013411,0.020164468,0.000104562,0.6523647,0.022762333,38,8
D:1| T0: 0.10| T1: 515.00| I0: 300.0| I1: 125.0| WTP: 350000,1,0.096153846,515,350000,1,0.2,300,125,-1350120201,118052103,11293.66053,785437174.6,78543717.46,4,87357,3891,765,1876,1111,765,87357,1111,1876,180.4701493,2.720149254,6.824626866,45449.93657,1649.537313,9.701492537,98919.63433,0.456590564,0.016581293,9.90906E-05,0.592217484,0.021475096,39,8
D:1| T0: 0.10| T1: 515.00| I0: 300.0| I1: 125.0| WTP: 350000,1,0.096153846,515,350000,1,0.2,300,125,-1405055439,1209758844,12434.00238,783355320.1,78335532.01,4,89402,3728,691,2066,1375,691,89402,1375,2066,240.5179487,3.441025641,10.44102564,45146.83077,1345.369231,13.96410256,98835.05128,0.45362038,0.013515966,0.000142049,0.66553727,0.023109103,28,8
D:1| T0: 0.10| T1: 515.00| I0: 300.0| I1: 125.0| WTP: 350000,1,0.096153846,515,350000,1,0.2,300,125,-5957983743,70671723,7656.217292,5575172878,557517287.8,36,57240,2444,1272,1272,0,1272,57240,0,1272,15.19319319,0.426426426,0.426426426,65792.87988,176.5495495,1.08008008,99251.05806,0.662240084,0.001778361,1.28078E-05,0,0.022222222,286,63
D:1| T0: 0.10| T1: 515.00| I0: 300.0| I1: 125.0| WTP: 350000,1,0.096153846,515,350000,1,0.2,300,125,-3349024605,1722612191,6299.290956,3034060057,303406005.7,18,53439,2505,1046,1046,0,1046,53439,0,1046,20.00708763,0.50193299,0.50193299,63488.59601,189.7094072,1.177190722,99289.45361,0.638880339,0.001908299,1.35414E-05,0,0.019574086,221,34
D:1| T0: 0.10| T1: 515.00| I0: 300.0| I1: 125.0| WTP: 350000,1,0.096153846,515,350000,1,0.2,300,125,-3152124720,1968291596,5985.089551,2852870242,285287024.2,18,49820,2215,994,994,0,994,49820,0,994,19.32538569,0.514025245,0.514025245,65859.48948,139.6802244,1.213183731,99330.69565,0.662580663,0.001405057,1.40008E-05,0,0.019952227,204,32
D:1| T0: 0.10| T1: 515.00| I0: 300.0| I1: 125.0| WTP: 350000,1,0.096153846,515,350000,1,0.2,300,125,-1449474365,1877569084,13169.17406,791015662.1,79101566.21,4,96488,4069,745,2188,1443,745,96488,1443,2188,266.1295337,3.813471503,11.21243523,35133.56995,1600.093264,15.05181347,98644.61658,0.353250926,0.016087307,0.00015278,0.659506399,0.022676395,28,8
D:1| T0: 0.10| T1: 515.00| I0: 300.0| I1: 125.0| WTP: 350000,1,0.096153846,515,350000,1,0.2,300,125,-1400909269,1726322189,12190.40189,791389174.1,79138917.41,4,95421,4151,742,2025,1283,742,95421,1283,2025,268.4352332,3.777202073,10.33678756,36894.84456,1673.772021,14.19170984,98778.33161,0.370759373,0.0168105,0.000144015,0.633580247,0.021221744,28,8
D:1| T0: 0.10| T1: 515.00| I0: 300.0| I1: 125.0| WTP: 350000,1,0.096153846,515,350000,1,0.2,300,125,-1390977632,307848836,12063.07059,787824102.3,78782410.23,4,91431,4027,613,2004,1391,613,91431,1391,2004,231.5627907,2.772093023,9.195348837,41100.16744,1495.390698,12.03255814,98811.69767,0.412902006,0.015021828,0.000122332,0.694111776,0.021918168,31,8
D:1| T0: 0.10| T1: 515.00| I0: 300.0| I1: 125.0| WTP: 350000,1,0.096153846,515,350000,1,0.2,300,125,-1256273041,1154000220,11067.13265,702916408,70291640.8,4,91009,4125,749,1838,1089,749,91009,1089,1838,280.1630435,3.983695652,9.836956522,33230.30978,1286.51087,13.89673913,98752.70652,0.335189924,0.012907515,0.000141173,0.592491839,0.020195805,27,7
D:1| T0: 0.10| T1: 515.00| I0: 300.0| I1: 125.0| WTP: 350000,1,0.096153846,515,350000,1,0.2,300,125,-5018127323,2028661055,6483.632909,4693945678,469394567.8,32,51879,2268,1077,1077,0,1077,51879,0,1077,16.12027891,0.433468913,0.433468913,68574.82394,157.7007554,1.065078443,99351.31203,0.689698596,0.001587206,1.25764E-05,0,0.020760245,246,53
D:1| T0: 0.10| T1: 515.00| I0: 300.0| I1: 125.0| WTP: 350000,1,0.096153846,515,350000,1,0.2,300,125,-1881607245,1629114640,9872.933435,1387960573,138796057.3,8,77706,3400,1070,1640,570,1070,77706,570,1640,121.5146199,3.005847953,4.622807018,50148.26608,1410.076023,7.748538012,99020.85965,0.504481775,0.014172465,7.96657E-05,0.347560976,0.021105463,49,15
D:1| T0: 0.10| T1: 515.00| I0: 300.0| I1: 125.0| WTP: 350000,1,0.096153846,515,350000,1,0.2,300,125,-1448079271,1439048174,13026.9009,796734226.2,79673422.62,4,96599,4308,746,2164,1418,746,96599,1418,2164,300.1748634,4,11.66666667,38851.43169,2247.836066,15.75956284,98756.08743,0.390137629,0.022590817,0.000159786,0.655268022,0.022401888,27,8
D:1| T0: 0.10| T1: 515.00| I0: 300.0| I1: 125.0| WTP: 350000,1,0.096153846,515,350000,1,0.2,300,125,-1292416835,865227006,11976.89732,693571969.4,69357196.94,4,88440,3679,705,1990,1285,705,88440,1285,1990,275.0722892,4.120481928,11.79518072,34329.10843,1429.783133,16.08433735,98636.85542,0.346731923,0.014345885,0.000163076,0.645728643,0.02250164,24,7
D:1| T0: 0.10| T1: 515.00| I0: 300.0| I1: 125.0| WTP: 350000,1,0.096153846,515,350000,1,0.2,300,125,-1691078570,890479738,11095.6054,1136298300,113629830,6,88008,3838,815,1843,1028,815,88008,1028,1843,149.7808642,2.416666667,5.552469136,37508.04012,1938.632716,8.074074074,98771.28395,0.377419917,0.019499109,8.25542E-05,0.557786218,0.020941278,47,12
D:1| T0: 0.10| T1: 515.00| I0: 300.0| I1: 125.0| WTP: 350000,1,0.096153846,515,350000,1,0.2,300,125,-3306166255,1017049163,7135.078464,2949412332,294941233.2,24,60092,2680,1184,1185,1,1184,60092,1,1185,26.88990066,0.774834437,0.775662252,60337.89156,177.7971854,1.762417219,99228.56788,0.607476289,0.001789489,1.97113E-05,0.000843882,0.019719763,173,33
D:1| T0: 0.10| T1: 515.00| I0: 300.0| I1: 125.0| WTP: 350000,1,0.096153846,515,350000,1,0.2,300,125,-3532442869,1707305064,6473.283442,3208778697,320877869.7,20,54980,2458,1075,1075,0,1075,54980,0,1075,21.41637509,0.572428272,0.572428272,65056.86984,201.1651505,1.321203639,99316.13926,0.654514084,0.002023761,1.51161E-05,0,0.019552565,205,36
D:1| T0: 0.10| T1: 515.00| I0: 300.0| I1: 125.0| WTP: 350000,1,0.096153846,515,350000,1,0.2,300,125,-1286251020,400145663,11803.58029,696072005.8,69607200.58,4,86942,3738,730,1961,1231,730,86942,1231,1961,245.9270833,3.723958333,10.078125,32762.4375,1214.723958,13.875,98577.98958,0.331264071,0.012196606,0.000140896,0.627740948,0.022555267,28,7
D:1| T0: 0.10| T1: 515.00| I0: 300.0| I1: 125.0| WTP: 350000,1,0.096153846,515,350000,1,0.2,300,125,-3590284332,1662654181,7472.794699,3216644597,321664459.7,24,63145,2827,1237,1241,4,1237,63145,4,1241,27.80460683,0.781572677,0.78395552,59808.32407,205.949166,1.77680699,99220.57188,0.602064262,0.002073106,1.97893E-05,0.003223207,0.019653179,180,36
D:1| T0: 0.10| T1: 515.00| I0: 300.0| I1: 125.0| WTP: 350000,1,0.096153846,515,350000,1,0.2,300,125,-1362182916,182136456,11380.26596,793169618,79316961.8,4,95282,4251,770,1890,1120,770,95282,1120,1890,282.1489362,4.037234043,9.909574468,37686.44149,1749.590426,14,98864.92021,0.378761919,0.017562797,0.000142007,0.592592593,0.019835856,27,8
D:1| T0: 0.10| T1: 515.00| I0: 300.0| I1: 125.0| WTP: 350000,1,0.096153846,515,350000,1,0.2,300,125,-4027489172,979575387,5972.869737,3728845685,372884568.5,22,48801,2212,992,992,0,992,48801,0,992,16.007034,0.407971864,0.407971864,67379.89449,190.6975381,0.984759672,99339.33294,0.677851563,0.001917934,1.16806E-05,0,0.020327452,244,42
D:1| T0: 0.10| T1: 515.00| I0: 300.0| I1: 125.0| WTP: 350000,1,0.096153846,515,350000,1,0.2,300,125,-1414555815,2142525414,12519.76766,788567431.6,78856743.16,4,93670,3990,711,2080,1369,711,93670,1369,2080,256.7384615,3.523076923,10.48717949,45475.51282,1895.589744,14.17435897,98908.51282,0.456217912,0.019047371,0.000143821,0.658173077,0.022205615,28,8
D:1| T0: 0.10| T1: 515.00| I0: 300.0| I1: 125.0| WTP: 350000,1,0.096153846,515,350000,1,0.2,300,125,-1308353211,1464057597,10553.45839,780680291.3,78068029.13,4,83440,3665,765,1753,988,765,83440,988,1753,168.3247232,2.6900369,6.287822878,47638.99262,1154.653137,9.103321033,98981.90406,0.478795989,0.011598857,9.33721E-05,0.563605248,0.021010116,39,8
D:1| T0: 0.10| T1: 515.00| I0: 300.0| I1: 125.0| WTP: 350000,1,0.096153846,515,350000,1,0.2,300,125,-1363136256,364562610,11575.53304,784359603.8,78435960.38,4,90373,3854,667,1923,1256,667,90373,1256,1923,239.7939698,3.246231156,9.497487437,43443.79899,1533.854271,12.86432161,98892.47739,0.436426742,0.015401995,0.000130688,0.653146126,0.021278479,29,8
D:1| T0: 0.10| T1: 515.00| I0: 300.0| I1: 125.0| WTP: 350000,1,0.096153846,515,350000,1,0.2,300,125,-1378858728,40350784,11893.77738,784169859.3,78416985.93,4,90261,3748,686,1976,1290,686,90261,1290,1976,227.5502392,3.148325359,9.267942584,45322.52632,1657.406699,12.54545455,98905.97608,0.455083565,0.016649277,0.000127961,0.652834008,0.021892069,30,8
D:1| T0: 0.10| T1: 515.00| I0: 300.0| I1: 125.0| WTP: 350000,1,0.096153846,515,350000,1,0.2,300,125,-1265754340,804064356,9606.088596,785449910.1,78544991.01,4,84018,3843,543,1595,1052,543,84018,1052,1595,237.9466019,2.524271845,7.59223301,49044.34466,1179.524272,10.21359223,99108.40291,0.492538805,0.011823978,0.00010408,0.659561129,0.018984253,30,8
D:1| T0: 0.10| T1: 515.00| I0: 300.0| I1: 125.0| WTP: 350000,1,0.096153846,515,350000,1,0.2,300,125,-2331947281,2125493986,8649.150374,1899489762,189948976.2,14,63932,2705,1240,1437,197,1240,63932,197,1437,32.58226601,1.058128079,1.24729064,49397.36453,199.6778325,2.462068966,98869.31921,0.498995427,0.002011811,2.65414E-05,0.137091162,0.022477007,145,21
D:1| T0: 0.10| T1: 515.00| I0: 300.0| I1: 125.0| WTP: 350000,1,0.096153846,515,350000,1,0.2,300,125,-1238899457,23154253,9166.195974,780589658.5,78058965.85,4,78757,3560,713,1522,809,713,78757,809,1522,180.2627451,2.670588235,5.815686275,47154.9451,824.9607843,8.62745098,99039.89804,0.474417196,0.0082769,8.79372E-05,0.531537451,0.019325266,37,8
D:1| T0: 0.10| T1: 515.00| I0: 300.0| I1: 125.0| WTP: 350000,1,0.096153846,515,350000,1,0.2,300,125,-2663819694,1391367689,6688.61149,2329389119,232938911.9,16,53335,2312,1111,1111,0,1111,53335,0,1111,31.44505495,1.001098901,1.001098901,66521.86374,198.4934066,2.235164835,99315.59341,0.669298777,0.001996145,2.45266E-05,0,0.020830599,130,26
D:1| T0: 0.10| T1: 515.00| I0: 300.0| I1: 125.0| WTP: 350000,1,0.096153846,515,350000,1,0.2,300,125,-1552896132,574142276,8711.360882,1117328088,111732808.8,6,68260,3027,1028,1447,419,1028,68260,419,1447,58.45525903,1.489795918,2.128728414,45664.82418,492.7974882,3.739403454,98876.81319,0.460916927,0.004956339,3.90818E-05,0.289564616,0.021198359,91,12
D:1| T0: 0.10| T1: 515.00| I0: 300.0| I1: 125.0| WTP: 350000,1,0.096153846,515,350000,1,0.2,300,125,-5274830640,898736779,6369.34067,4956363606,495636360.6,30,48528,2133,1058,1058,0,1058,48528,0,1058,13.41536965,0.337062257,0.337062257,67635.54134,175.2923152,0.857976654,99297.34582,0.680679426,0.001763829,1.03415E-05,0,0.021801846,294,56
D:1| T0: 0.10| T1: 515.00| I0: 300.0| I1: 125.0| WTP: 350000,1,0.096153846,515,350000,1,0.2,300,125,-1506516216,346473503,9138.095581,1049611437,104961143.7,6,83832,4006,710,1517,807,710,83832,807,1517,186.7067669,2.522556391,5.522556391,47172.19925,1789.176692,8.19924812,99116.6015,0.473840971,0.017954444,8.40425E-05,0.531970995,0.018095715,38,11
D:1| T0: 0.10| T1: 515.00| I0: 300.0| I1: 125.0| WTP: 350000,1,0.096153846,515,350000,1,0.2,300,125,-1614837646,445552282,9771.244653,1126275413,112627541.3,6,74932,3334,1023,1623,600,1023,74932,600,1623,92.79039301,2.100436681,3.390829694,44598.56332,935.5764192,5.626637555,98843.41703,0.449686464,0.009411044,5.81305E-05,0.369685767,0.021659638,65,12
D:1| T0: 0.10| T1: 515.00| I0: 300.0| I1: 125.0| WTP: 350000,1,0.096153846,515,350000,1,0.2,300,125,-1270786973,911758476,11284.51619,706561163.2,70656116.32,4,92449,4212,736,1874,1138,736,92449,1138,1874,252.5492958,3.384976526,8.638497653,28949.4554,1215.075117,12.10798122,98646.93427,0.292196282,0.012203292,0.000123144,0.607257204,0.020270636,31,7
D:1| T0: 0.10| T1: 515.00| I0: 300.0| I1: 125.0| WTP: 350000,1,0.096153846,515,350000,1,0.2,300,125,-1381815226,1464197940,11687.88935,797420758.4,79742075.84,4,96108,4386,679,1941,1262,679,96108,1262,1941,277.2636816,3.278606965,9.527363184,38605.37313,2774.383085,12.90547264,98875.17413,0.387457565,0.027857109,0.000130907,0.650180319,0.020196029,29,8
D:1| T0: 0.10| T1: 515.00| I0: 300.0| I1: 125.0| WTP: 350000,1,0.096153846,515,350000,1,0.2,300,125,-2228318130,500405854,8307.232314,1812956515,181295651.5,12,63302,2711,1256,1380,124,1256,63302,124,1380,41.03519417,1.336165049,1.47815534,53221.53155,310.9259709,3.007281553,98992.19903,0.536896129,0.003129623,3.21741E-05,0.089855072,0.021800603,118,20
D:1| T0: 0.10| T1: 515.00| I0: 300.0| I1: 125.0| WTP: 350000,1,0.096153846,515,350000,1,0.2,300,125,-1367557469,772037341,11777.84409,778665265.1,77866526.51,4,84909,3608,627,1957,1330,627,84909,1330,1957,214.6699029,2.917475728,9.32038835,47682.80583,1350.533981,12.36893204,98881.03398,0.47935571,0.013564432,0.000125993,0.67961165,0.023048205,30,8
D:1| T0: 0.10| T1: 515.00| I0: 300.0| I1: 125.0| WTP: 350000,1,0.096153846,515,350000,1,0.2,300,125,-3994344194,1543158763,5371.291229,3725779632,372577963.2,26,45253,2058,892,892,0,892,45253,0,892,14.41727426,0.329220415,0.329220415,70860.62984,122.262479,0.826696579,99421.09927,0.712328745,0.001229997,1.00447E-05,0,0.019711836,255,42
D:1| T0: 0.10| T1: 515.00| I0: 300.0| I1: 125.0| WTP: 350000,1,0.096153846,515,350000,1,0.2,300,125,-1367589056,1604932531,13312.83604,701947253.7,70194725.37,4,94923,4067,763,2212,1449,763,94923,1449,2212,277.0054945,4.131868132,12.01648352,36485.52747,1533.351648,16.18681319,98629.94505,0.367242845,0.015414737,0.000164333,0.655063291,0.023303098,26,7
D:1| T0: 0.10| T1: 515.00| I0: 300.0| I1: 125.0| WTP: 350000,1,0.096153846,515,350000,1,0.2,300,125,-1368832810,539051477,11601.00889,788782365.3,78878236.53,4,91936,4058,718,1927,1209,718,91936,1209,1927,224.8883929,3.107142857,8.446428571,42742.0625,2343.183036,11.64285714,98910.42857,0.429129865,0.02354521,0.000118658,0.627400104,0.020960233,32,8
D:1| T0: 0.10| T1: 515.00| I0: 300.0| I1: 125.0| WTP: 350000,1,0.096153846,515,350000,1,0.2,300,125,-2941158154,1743124675,6894.108473,2596452730,259645273,24,54337,2472,1145,1145,0,1145,54337,0,1145,25.14931396,0.728813559,0.728813559,67044.3406,148.4826473,1.650524617,99314.21792,0.674445254,0.001494586,1.85739E-05,0,0.021072198,177,29
D:1| T0: 0.10| T1: 515.00| I0: 300.0| I1: 125.0| WTP: 350000,1,0.096153846,515,350000,1,0.2,300,125,-1902714697,1965983789,8728.905623,1466269416,146626941.6,8,67867,2932,1120,1450,330,1120,67867,330,1450,55.7202473,1.647604328,2.142194745,47688.49304,610.4250386,3.874806801,98911.63524,0.480975201,0.006140139,3.99464E-05,0.227586207,0.021365632,93,16
D:1| T0: 0.10| T1: 515.00| I0: 300.0| I1: 125.0| WTP: 350000,1,0.096153846,515,350000,1,0.2,300,125,-3257032328,516774280,7880.189379,2863022859,286302285.9,18,62432,2682,1285,1309,24,1285,62432,24,1309,19.42647059,0.600588235,0.612941176,50194.50647,235.7294118,1.364705882,98966.01353,0.506649282,0.002373761,1.53504E-05,0.018334607,0.020966812,242,32
D:1| T0: 0.10| T1: 515.00| I0: 300.0| I1: 125.0| WTP: 350000,1,0.096153846,515,350000,1,0.2,300,125,-1167754674,86603142,11161.37223,609686062.4,60968606.24,4,87856,3773,609,1854,1245,609,87856,1245,1854,266.8232044,3.281767956,10.1160221,31717.18785,1258.834254,13.4640884,98647.71823,0.320517154,0.012628341,0.000136634,0.671521036,0.021102714,26,6
D:1| T0: 0.10| T1: 515.00| I0: 300.0| I1: 125.0| WTP: 350000,1,0.096153846,515,350000,1,0.2,300,125,-6473459806,1431870609,7404.67459,6103226076,610322607.6,40,59316,2565,1230,1230,0,1230,59316,0,1230,14.39238786,0.370185773,0.370185773,63914.32034,184.3257816,0.926597191,99258.55233,0.643280512,0.001856328,1.12102E-05,0,0.020736395,316,69
D:1| T0: 0.10| T1: 515.00| I0: 300.0| I1: 125.0| WTP: 350000,1,0.096153846,515,350000,1,0.2,300,125,-1380995164,1592383984,8676.901492,947150089.8,94715008.98,6,72264,3306,739,1441,702,739,72264,702,1441,106.3586387,1.840314136,3.64921466,46759.48691,552.8481675,5.586387435,98976.98168,0.471140621,0.005553561,5.73305E-05,0.487161693,0.019941049,55,10
D:1| T0: 0.10| T1: 515.00| I0: 300.0| I1: 125.0| WTP: 350000,1,0.096153846,515,350000,1,0.2,300,125,-1767203152,1440183867,7803.491912,1377028557,137702855.7,8,65064,2865,991,1296,305,991,65064,305,1296,49.82724719,1.293539326,1.703651685,47242.54354,440.7457865,3.092696629,98967.26404,0.476651379,0.004432179,3.22866E-05,0.235339506,0.019918849,102,15
D:1| T0: 0.10| T1: 515.00| I0: 300.0| I1: 125.0| WTP: 350000,1,0.096153846,515,350000,1,0.2,300,125,-1810782143,1696510588,8680.208407,1376771723,137677172.3,8,66742,2845,1124,1442,318,1124,66742,318,1442,37.57234727,1.082529475,1.411575563,45265.28296,336.8263666,2.607717042,98833.71704,0.457192021,0.003391096,2.76751E-05,0.220527046,0.021605586,134,15
D:1| T0: 0.10| T1: 515.00| I0: 300.0| I1: 125.0| WTP: 350000,1,0.096153846,515,350000,1,0.2,300,125,-1546791553,895039877,11731.87867,960197619.3,96019761.93,6,88845,3763,683,1949,1266,683,88845,1266,1949,236.6305419,3.261083744,9.45320197,46669.00493,2306.172414,12.79802956,98949.06404,0.468630885,0.023163417,0.000130271,0.649563879,0.021937081,29,10
D:1| T0: 0.10| T1: 515.00| I0: 300.0| I1: 125.0| WTP: 350000,1,0.096153846,515,350000,1,0.2,300,125,-2184347627,129565953,9119.012996,1728396978,172839697.8,10,67575,2872,1272,1515,243,1272,67575,243,1515,35.59356137,1.179074447,1.415492958,43962.55332,480.4114688,2.701207243,98764.73843,0.444221021,0.004837497,2.82231E-05,0.16039604,0.022419534,141,19
D:1| T0: 0.10| T1: 515.00| I0: 300.0| I1: 125.0| WTP: 350000,1,0.096153846,515,350000,1,0.2,300,125,-1911945230,1902565669,7208.685142,1551510973,155151097.3,10,62974,2792,1075,1197,122,1075,62974,122,1197,47.82176871,1.285714286,1.443537415,54274.37823,329.4680272,2.903401361,99149.52925,0.546690688,0.003312206,3.10551E-05,0.10192147,0.019007845,105,17
D:1| T0: 0.10| T1: 515.00| I0: 300.0| I1: 125.0| WTP: 350000,1,0.096153846,515,350000,1,0.2,300,125,-4994569157,1984179288,7668.340374,4611152138,461115213.8,30,57755,2446,1273,1274,1,1273,57755,1,1274,15.09222333,0.461615155,0.461615155,57892.0319,216.9780658,1.093220339,99080.46411,0.58374024,0.00218514,1.27718E-05,0.000784929,0.022058696,287,52
D:1| T0: 0.10| T1: 515.00| I0: 300.0| I1: 125.0| WTP: 350000,1,0.096153846,515,350000,1,0.2,300,125,-1672883771,677377223,10776.64854,1134051344,113405134.4,6,84378,3760,982,1790,808,982,84378,808,1790,137.5146199,2.754385965,5.076023392,44094.5,2006.149123,7.964912281,98893.07018,0.443490911,0.020177447,8.15647E-05,0.451396648,0.021214061,48,12
D:1| T0: 0.10| T1: 515.00| I0: 300.0| I1: 125.0| WTP: 350000,1,0.096153846,515,350000,1,0.2,300,125,-1636446099,973583301,10114.98174,1130697012,113069701.2,6,83161,3652,1049,1680,631,1049,83161,631,1680,116.6813472,2.593264249,4.191709845,43396.62953,1753.088083,6.904145078,98924.07772,0.436575097,0.017627865,7.11207E-05,0.375595238,0.020201777,56,12
D:1| T0: 0.10| T1: 515.00| I0: 300.0| I1: 125.0| WTP: 350000,1,0.096153846,515,350000,1,0.2,300,125,-1778166004,781062938,7830.615225,1386635243,138663524.3,8,69101,3331,1051,1300,249,1051,69101,249,1300,55.09986684,1.251664447,1.576564581,45458.21704,424.4647137,2.962716378,98994.90013,0.458428814,0.004268442,3.14665E-05,0.191538462,0.018813042,108,15
D:1| T0: 0.10| T1: 515.00| I0: 300.0| I1: 125.0| WTP: 350000,1,0.096153846,515,350000,1,0.2,300,125,-1955668869,338783425,9537.685585,1478784589,147878458.9,8,78335,3480,1117,1584,467,1117,78335,467,1584,112.8989637,2.764248705,3.917098446,51237.18135,1650.994819,6.821243523,99078.8057,0.515062453,0.016597431,7.03429E-05,0.294823232,0.020220846,56,16
D:1| T0: 0.10| T1: 515.00| I0: 300.0| I1: 125.0| WTP: 350000,1,0.096153846,515,350000,1,0.2,300,125,-5950032478,1027579040,7399.581884,5580053384,558005338.4,36,59733,2720,1229,1229,0,1229,59733,0,1229,14.97037702,0.382405745,0.382405745,59232.85099,201.448833,0.931328546,99155.86041,0.596774739,0.002028765,1.10955E-05,0,0.020574892,318,63
D:1| T0: 0.10| T1: 515.00| I0: 300.0| I1: 125.0| WTP: 350000,1,0.096153846,515,350000,1,0.2,300,125,-1929482539,764973813,9103.822861,1474291396,147429139.6,8,73054,3240,1051,1512,461,1051,73054,461,1512,84.37654321,2.047325103,2.979423868,48412.15638,1025.329218,5.148148148,98978.14198,0.487535729,0.010308046,5.30212E-05,0.30489418,0.020697302,69,16
D:1| T0: 0.10| T1: 515.00| I0: 300.0| I1: 125.0| WTP: 350000,1,0.096153846,515,350000,1,0.2,300,125,-1636982850,1245753446,10126.8896,1130638370,113063837,6,82957,3589,791,1682,891,791,82957,891,1682,146.1483871,2.432258065,5.270967742,44432.0129,1834.8,7.822580645,98945.21935,0.446895393,0.018438291,8.02072E-05,0.529726516,0.020275809,45,12
D:1| T0: 0.10| T1: 515.00| I0: 300.0| I1: 125.0| WTP: 350000,1,0.096153846,515,350000,1,0.2,300,125,-1558974130,1013177794,8890.602571,1114444001,111444400.1,6,67359,2884,1090,1477,387,1090,67359,387,1477,54.01221374,1.523664122,2.097709924,46385.86107,428.5923664,3.766412214,98854.17252,0.468359867,0.004312399,3.94282E-05,0.262017603,0.021927285,94,12
D:1| T0: 0.10| T1: 515.00| I0: 300.0| I1: 125.0| WTP: 350000,1,0.096153846,515,350000,1,0.2,300,125,-4689371562,1395089249,6992.926498,4339725237,433972523.7,28,48506,2093,1162,1162,0,1162,48506,0,1162,11.53251478,0.365620737,0.365620737,67101.75034,114.7489768,0.897680764,99216.4693,0.67574785,0.001156188,1.06253E-05,0,0.023955799,315,49
D:1| T0: 0.10| T1: 515.00| I0: 300.0| I1: 125.0| WTP: 350000,1,0.096153846,515,350000,1,0.2,300,125,-4803975899,1339545835,5850.591842,4511446307,451144630.7,30,45387,1950,972,972,0,972,45387,0,972,8.97023361,0.203089676,0.203089676,73136.28975,129.6454408,0.564431047,99423.60437,0.735142426,0.001304884,7.35777E-06,0,0.021415824,380,51
D:1| T0: 0.10| T1: 515.00| I0: 300.0| I1: 125.0| WTP: 350000,1,0.096153846,515,350000,1,0.2,300,125,-1332052832,219139554,10832.89656,790408004.2,79040800.42,4,90154,4019,758,1799,1041,758,90154,1041,1799,289.5,4.191011236,9.938202247,41275.98315,1331.713483,14.19101124,98921.76404,0.415222809,0.01335809,0.000144089,0.578654808,0.019954744,26,8
D:1| T0: 0.10| T1: 515.00| I0: 300.0| I1: 125.0| WTP: 350000,1,0.096153846,515,350000,1,0.2,300,125,-2444916835,1336508942,7500.499814,2069891844,206989184.4,14,58598,2482,1222,1246,24,1222,58598,24,1246,28.18721038,0.947173309,0.969416126,56932.79055,218.3558851,2.121408712,99095.10936,0.573907174,0.00219751,2.29949E-05,0.019261637,0.021263524,155,23
D:1| T0: 0.10| T1: 515.00| I0: 300.0| I1: 125.0| WTP: 350000,1,0.096153846,515,350000,1,0.2,300,125,-5244032812,448559423,6022.698943,4942897865,494289786.5,28,39291,1583,1001,1001,0,1001,39291,0,1001,11.16463768,0.411594203,0.411594203,74423.32348,176.9872464,0.991304348,99346.53217,0.748738381,0.001780433,1.16573E-05,0,0.025477221,247,56
D:1| T0: 0.10| T1: 515.00| I0: 300.0| I1: 125.0| WTP: 350000,1,0.096153846,515,350000,1,0.2,300,125,-1911483973,2110028840,8879.417722,1467513087,146751308.7,8,69517,3061,1230,1475,245,1230,69517,245,1475,51.83779972,1.576868829,1.902679831,47762.10014,479.5430183,3.631875882,98924.52186,0.481801812,0.004825597,3.83819E-05,0.166101695,0.021217832,102,16
D:1| T0: 0.10| T1: 515.00| I0: 300.0| I1: 125.0| WTP: 350000,1,0.096153846,515,350000,1,0.2,300,125,-1880253901,1982030155,10008.45454,1379831174,137983117.4,8,71774,2961,1141,1663,522,1141,71774,522,1663,85.25,2.542056075,3.731308411,51459.83645,1115.469626,6.397196262,98925.57009,0.51839322,0.011222821,6.5909E-05,0.313890559,0.02316995,62,15
D:1| T0: 0.10| T1: 515.00| I0: 300.0| I1: 125.0| WTP: 350000,1,0.096153846,515,350000,1,0.2,300,125,-1409392462,696219407,9306.462171,944069353.5,94406935.35,6,70618,3115,722,1546,824,722,70618,824,1546,120.0093168,2.105590062,4.639751553,52791.51553,731.7670807,6.863354037,99014.2205,0.531473813,0.007349119,7.07552E-05,0.532988357,0.021892435,46,10
D:1| T0: 0.10| T1: 515.00| I0: 300.0| I1: 125.0| WTP: 350000,1,0.096153846,515,350000,1,0.2,300,125,-1324873222,1402539442,10665.09851,791618296.9,79161829.69,4,93537,4147,701,1771,1070,701,93537,1070,1771,257.9359606,3.359605911,8.586206897,42599.54187,2112.738916,12.03448276,99011.71921,0.427492934,0.021198924,0.000122191,0.60417843,0.018933684,29,8
D:1| T0: 0.10| T1: 515.00| I0: 300.0| I1: 125.0| WTP: 350000,1,0.096153846,515,350000,1,0.2,300,125,-1616951961,1319833493,11312.62624,1051320650,105132065,6,88806,3972,720,1879,1159,720,88806,1159,1879,214.6410256,2.948717949,7.858974359,43348.15812,2568.15812,10.91452991,98904.40598,0.435550006,0.025803612,0.000111646,0.616817456,0.021158719,34,11
D:1| T0: 0.10| T1: 515.00| I0: 300.0| I1: 125.0| WTP: 350000,1,0.096153846,515,350000,1,0.2,300,125,-2390180393,663608076,8048.804291,1987740179,198774017.9,12,62798,2722,1216,1337,121,1216,62798,121,1337,34.254842,1.073394495,1.19266055,50496.83282,386.3761468,2.435270133,98963.579,0.509543148,0.003887968,2.61725E-05,0.090501122,0.021290487,141,22
D:1| T0: 0.10| T1: 515.00| I0: 300.0| I1: 125.0| WTP: 350000,1,0.096153846,515,350000,1,0.2,300,125,-2420765089,414696500,6978.65505,2071832336,207183233.6,12,57038,2482,1150,1159,9,1150,57038,9,1159,27.37661221,0.820292347,0.8288908,57901.30181,339.0567498,1.824591574,99162.38091,0.583267515,0.003409502,1.99518E-05,0.007772021,0.020302255,166,23
D:1| T0: 0.10| T1: 515.00| I0: 300.0| I1: 125.0| WTP: 350000,1,0.096153846,515,350000,1,0.2,300,125,-3639252230,1249738535,7034.936962,3287505382,328750538.2,22,48264,1997,1169,1169,0,1169,48264,0,1169,18.88248673,0.686884003,0.686884003,70529.84382,145.4351782,1.567854435,99286.74829,0.709800116,0.001464363,1.78161E-05,0,0.024221453,189,37
D:1| T0: 0.10| T1: 515.00| I0: 300.0| I1: 125.0| WTP: 350000,1,0.096153846,515,350000,1,0.2,300,125,-2430668475,614415382,7212.326972,2070052127,207005212.7,12,55643,2428,1158,1198,40,1158,55643,40,1198,26.44550173,0.870242215,0.907439446,55905.02941,303.7110727,1.906574394,99061.98702,0.563751224,0.003055351,2.04853E-05,0.033388982,0.021530112,166,23
D:1| T0: 0.10| T1: 515.00| I0: 300.0| I1: 125.0| WTP: 350000,1,0.096153846,515,350000,1,0.2,300,125,-4803526195,524899953,5661.443041,4520454043,452045404.3,28,49899,2294,940,940,0,940,49899,0,940,14.52435388,0.304671968,0.304671968,66059.2336,143.250994,0.761928429,99373.24901,0.664345799,0.001441018,9.38334E-06,0,0.01883843,288,51
D:1| T0: 0.10| T1: 515.00| I0: 300.0| I1: 125.0| WTP: 350000,1,0.096153846,515,350000,1,0.2,300,125,-1298416506,1338977757,11848.84101,705974455.5,70597445.55,4,93037,4177,742,1968,1226,742,93037,1226,1968,246.6805556,3.384259259,9,30919.31944,1130.555556,12.43518519,98616.37963,0.311861299,0.011361959,0.000126125,0.62296748,0.021152875,31,7
D:1| T0: 0.10| T1: 515.00| I0: 300.0| I1: 125.0| WTP: 350000,1,0.096153846,515,350000,1,0.2,300,125,-1509472910,341384587,9564.561546,1031244833,103124483.3,6,72362,3090,882,1589,707,882,72362,707,1589,69.08679928,1.430379747,2.692585895,41771.97288,445.8191682,4.289330922,98747.48463,0.422125918,0.004486588,4.49716E-05,0.444933921,0.021959039,79,11
D:1| T0: 0.10| T1: 515.00| I0: 300.0| I1: 125.0| WTP: 350000,1,0.096153846,515,350000,1,0.2,300,125,-1850855691,2032000160,9331.27625,1384291879,138429187.9,8,73252,3177,1096,1550,454,1096,73252,454,1550,97.6039604,2.589108911,3.675742574,50245.84653,1229.831683,6.383663366,98994.06188,0.505922606,0.012365755,6.58456E-05,0.292903226,0.021160121,58,15
D:1| T0: 0.10| T1: 515.00| I0: 300.0| I1: 125.0| WTP: 350000,1,0.096153846,515,350000,1,0.2,300,125,-1397049287,779488939,12224.57154,785820710.3,78582071.03,4,91732,3912,625,2031,1406,625,91732,1406,2031,228.8679245,2.844339623,9.438679245,44968.23113,1638.759434,12.38207547,98888.78302,0.451296361,0.016466312,0.000125932,0.692269818,0.022140583,31,8
D:1| T0: 0.10| T1: 515.00| I0: 300.0| I1: 125.0| WTP: 350000,1,0.096153846,515,350000,1,0.2,300,125,-2397782161,1449019578,8287.621658,1983401078,198340107.8,12,61675,2526,1274,1377,103,1274,61675,103,1377,28.34558824,1.008272059,1.099264706,51952.19577,352.8501838,2.261948529,98938.46599,0.524385943,0.003551823,2.4512E-05,0.07480029,0.022326713,155,22
D:1| T0: 0.10| T1: 515.00| I0: 300.0| I1: 125.0| WTP: 350000,1,0.096153846,515,350000,1,0.2,300,125,-3835324863,351952211,5606.971912,3554976268,355497626.8,26,51342,2296,931,931,0,931,51342,0,931,16.45502031,0.36506094,0.36506094,67564.22229,132.5455601,0.90307603,99409.56413,0.679178559,0.001333549,1.08509E-05,0,0.018133302,247,40
D:1| T0: 0.10| T1: 515.00| I0: 300.0| I1: 125.0| WTP: 350000,1,0.096153846,515,350000,1,0.2,300,125,-3160598570,486595046,7753.308621,2772933139,277293313.9,16,58508,2538,1277,1288,11,1277,58508,11,1288,18.55797528,0.607416127,0.614479105,54088.80224,284.707475,1.37198352,99003.19305,0.545683289,0.002865813,1.51857E-05,0.008540373,0.022014084,241,31
D:1| T0: 0.10| T1: 515.00| I0: 300.0| I1: 125.0| WTP: 350000,1,0.096153846,515,350000,1,0.2,300,125,-1735691716,296745624,8849.667205,1293208356,129320835.6,8,71515,3071,984,1470,486,984,71515,486,1470,77.77846791,1.913043478,2.890269151,46705.36025,727.010352,4.931677019,98938.50518,0.470830937,0.007308844,5.10734E-05,0.330612245,0.020555128,69,14
D:1| T0: 0.10| T1: 515.00| I0: 300.0| I1: 125.0| WTP: 350000,1,0.096153846,515,350000,1,0.2,300,125,-3199283992,1671484194,6803.904267,2859088779,285908877.9,18,55500,2506,1127,1130,3,1127,55500,3,1130,22.62773723,0.643065693,0.644525547,59850.78613,209.059854,1.457664234,99189.76642,0.602921639,0.00210335,1.65558E-05,0.002657219,0.020342709,196,32
D:1| T0: 0.10| T1: 515.00| I0: 300.0| I1: 125.0| WTP: 350000,1,0.096153846,515,350000,1,0.2,300,125,-1400656959,422157396,12131.22765,794095577.1,79409557.71,4,96591,4263,730,2015,1285,730,96591,1285,2015,303.9602273,4.085227273,11.3125,36754.43182,2040.965909,15.46022727,98801.69318,0.369351593,0.02049057,0.000156608,0.637717122,0.020861157,26,8
D:1| T0: 0.10| T1: 515.00| I0: 300.0| I1: 125.0| WTP: 350000,1,0.096153846,515,350000,1,0.2,300,125,-1314413236,1916599091,12196.69492,704578489.8,70457848.98,4,94800,4122,739,2026,1287,739,94800,1287,2026,306.1169591,4.263157895,11.69005848,38038.8655,1935.216374,16.00584795,98795.16374,0.382568431,0.019426391,0.000162357,0.635241856,0.021371308,25,7
D:1| T0: 0.10| T1: 515.00| I0: 300.0| I1: 125.0| WTP: 350000,1,0.096153846,515,350000,1,0.2,300,125,-1394522098,1005953941,12016.98896,793672650.1,79367265.01,4,96439,4253,739,1996,1257,739,96439,1257,1996,300.8587571,4.107344633,11.1299435,35529.49153,2208.711864,15.31638418,98792.36723,0.357169885,0.022171188,0.000155156,0.629759519,0.020697021,26,8
D:1| T0: 0.10| T1: 515.00| I0: 300.0| I1: 125.0| WTP: 350000,1,0.096153846,515,350000,1,0.2,300,125,-1351808627,1422765615,11418.30215,780893519.3,78089351.93,4,84828,3612,733,1897,1164,733,84828,1164,1897,138.1939394,2.115151515,5.615151515,35722.34242,890.2272727,7.851515152,98624.77576,0.360262854,0.008957915,8.01868E-05,0.613600422,0.022362899,48,8
D:1| T0: 0.10| T1: 515.00| I0: 300.0| I1: 125.0| WTP: 350000,1,0.096153846,515,350000,1,0.2,300,125,-4882873682,699740192,5694.281903,4598159587,459815958.7,28,42653,1810,946,946,0,946,42653,0,946,13.33622685,0.373263889,0.373263889,74402.47164,147.0746528,0.923611111,99437.44965,0.747820896,0.001479505,1.09947E-05,0,0.022179499,247,52
D:1| T0: 0.10| T1: 515.00| I0: 300.0| I1: 125.0| WTP: 350000,1,0.096153846,515,350000,1,0.2,300,125,-4966358046,240885764,5556.925478,4688511772,468851177.2,30,47045,2119,923,923,0,923,47045,0,923,12.15859031,0.272148801,0.272148801,70566.18747,140.8414097,0.733724914,99430.08076,0.709280438,0.001416694,9.07313E-06,0,0.019619513,292,53
D:1| T0: 0.10| T1: 515.00| I0: 300.0| I1: 125.0| WTP: 350000,1,0.096153846,515,350000,1,0.2,300,125,-1584343244,2023806564,9152.798641,1126703312,112670331.2,6,75258,3396,960,1520,560,960,75258,560,1520,95.45777778,2.011111111,3.222222222,42319.47111,696.26,5.357777778,98873.16889,0.426830896,0.007001431,5.5422E-05,0.368421053,0.020197188,65,12
D:1| T0: 0.10| T1: 515.00| I0: 300.0| I1: 125.0| WTP: 350000,1,0.096153846,515,350000,1,0.2,300,125,-3396274066,1907493879,7301.329203,3031207606,303120760.6,18,54513,2300,1213,1213,0,1213,54513,0,1213,18.59447301,0.596401028,0.596401028,61495.70758,218.3335476,1.379177378,99159.83548,0.619611104,0.002197442,1.56761E-05,0,0.022251573,222,34
D:1| T0: 0.10| T1: 515.00| I0: 300.0| I1: 125.0| WTP: 350000,1,0.096153846,515,350000,1,0.2,300,125,-2006116322,1565815291,10623.41755,1474945445,147494544.5,8,76751,3304,1108,1765,657,1108,76751,657,1765,121.8869048,3.175595238,5.077380952,53762.17857,1840.910714,8.375,99013.96131,0.540680734,0.018513514,8.60053E-05,0.37223796,0.022996443,48,16
D:1| T0: 0.10| T1: 515.00| I0: 300.0| I1: 125.0| WTP: 350000,1,0.096153846,515,350000,1,0.2,300,125,-4604034466,784442364,5334.612168,4337303858,433730385.8,26,44235,1946,886,886,0,886,44235,0,886,14.63794135,0.353680431,0.353680431,70641.79174,139.8007181,0.875523639,99424.5757,0.710155332,0.001405829,1.06452E-05,0,0.020029388,238,49
D:1| T0: 0.10| T1: 515.00| I0: 300.0| I1: 125.0| WTP: 350000,1,0.096153846,515,350000,1,0.2,300,125,-1328696419,206369745,10808.1209,788290373.8,78829037.38,4,89831,3978,651,1795,1144,651,89831,1144,1795,221.8854626,2.748898678,7.735682819,43566.67401,1652.828194,10.59911894,98966.01322,0.437483646,0.016592473,0.000108216,0.637325905,0.019981966,33,8
D:1| T0: 0.10| T1: 515.00| I0: 300.0| I1: 125.0| WTP: 350000,1,0.096153846,515,350000,1,0.2,300,125,-1399854953,2087235992,12154.60119,792124894.1,79212489.41,4,96085,4163,716,2019,1303,716,96085,1303,2019,244.4439252,3.271028037,9.299065421,35212.33178,1958.341121,12.64485981,98751.13084,0.353717758,0.019681409,0.000128441,0.645368995,0.021012645,31,8
D:1| T0: 0.10| T1: 515.00| I0: 300.0| I1: 125.0| WTP: 350000,1,0.096153846,515,350000,1,0.2,300,125,-1888918648,1019092536,8428.974663,1467469915,146746991.5,8,68486,3012,1175,1400,225,1175,68486,225,1400,47.73514212,1.351421189,1.630490956,47432.21189,489.2596899,3.147286822,98953.3553,0.478391663,0.004922074,3.34598E-05,0.160714286,0.020442433,111,16
D:1| T0: 0.10| T1: 515.00| I0: 300.0| I1: 125.0| WTP: 350000,1,0.096153846,515,350000,1,0.2,300,125,-1516146340,1885906113,8126.405233,1109826079,110982607.9,6,62004,2636,1026,1350,324,1026,62004,324,1350,66.26868687,1.884848485,2.525252525,53878.5596,383.0848485,4.612121212,99027.85657,0.543218206,0.00385044,4.82333E-05,0.24,0.021774545,71,12
D:1| T0: 0.10| T1: 515.00| I0: 300.0| I1: 125.0| WTP: 350000,1,0.096153846,515,350000,1,0.2,300,125,-3853433377,2028637200,7502.409026,3478312926,347831292.6,26,60079,2719,1245,1246,1,1245,60079,1,1246,25.70795796,0.736486486,0.737237237,58118.32432,174.2935435,1.673423423,99153.45721,0.58552118,0.001754711,1.88041E-05,0.000802568,0.02073936,191,39
D:1| T0: 0.10| T1: 515.00| I0: 300.0| I1: 125.0| WTP: 350000,1,0.096153846,515,350000,1,0.2,300,125,-1348419305,181476086,11216.21996,787608306.9,78760830.69,4,90943,4062,602,1863,1261,602,90943,1261,1863,222.6339286,2.558035714,8.147321429,41150.10714,1895.102679,10.85267857,98895.33036,0.413318973,0.019025792,0.000110546,0.676865271,0.020485359,32,8
D:1| T0: 0.10| T1: 515.00| I0: 300.0| I1: 125.0| WTP: 350000,1,0.096153846,515,350000,1,0.2,300,125,-1373254053,2097578470,11685.14698,788996704.4,78899670.44,4,89677,4071,709,1941,1232,709,89677,1232,1941,204.465587,2.761133603,7.71659919,39028.49798,1979.57085,10.57894737,98772.87449,0.392509754,0.019896899,0.00010786,0.634724369,0.021644346,36,8
D:1| T0: 0.10| T1: 515.00| I0: 300.0| I1: 125.0| WTP: 350000,1,0.096153846,515,350000,1,0.2,300,125,-1918339302,119646392,9058.946356,1465391984,146539198.4,8,66491,2790,1175,1505,330,1175,66491,330,1505,68.68023256,2.147286822,2.763565891,53410.46705,806.5620155,5.044573643,98979.2345,0.538191609,0.008112949,5.22235E-05,0.219269103,0.022634642,74,16
D:1| T0: 0.10| T1: 515.00| I0: 300.0| I1: 125.0| WTP: 350000,1,0.096153846,515,350000,1,0.2,300,125,-1370247682,1298895859,11601.48818,790173272.4,79017327.24,4,93306,4115,776,1927,1151,776,93306,1151,1927,241.3113208,3.566037736,8.938679245,37637.36321,1834.410377,12.61320755,98806.64151,0.378343302,0.018428409,0.000128055,0.597301505,0.020652477,31,8
D:1| T0: 0.10| T1: 515.00| I0: 300.0| I1: 125.0| WTP: 350000,1,0.096153846,515,350000,1,0.2,300,125,-1281086956,1489316290,10024.69192,779852360.3,77985236.03,4,79345,3565,660,1665,1005,660,79345,1005,1665,180.0277778,2.492063492,6.44047619,46518.76587,1094.714286,9.075396825,98935.94841,0.468242795,0.010993592,9.26423E-05,0.603603604,0.020984309,36,8
D:1| T0: 0.10| T1: 515.00| I0: 300.0| I1: 125.0| WTP: 350000,1,0.096153846,515,350000,1,0.2,300,125,-1452302520,855602142,13311.86476,786709281.5,78670928.15,4,96804,3861,655,2212,1557,655,96804,1557,2212,211.2857143,2.761904762,9.454545455,32627.65368,1496.593074,12.29004329,98553.32468,0.327857515,0.015056015,0.000124876,0.703887884,0.022850295,33,8
D:1| T0: 0.10| T1: 515.00| I0: 300.0| I1: 125.0| WTP: 350000,1,0.096153846,515,350000,1,0.2,300,125,-1814548709,1438649896,8640.058816,1382545768,138254576.8,8,69989,3087,1053,1435,382,1053,69989,382,1435,62.58995138,1.585089141,2.196110211,45529.67585,577.2155592,3.904376013,98911.89465,0.459269985,0.00580605,4.0552E-05,0.266202091,0.020503222,88,15
D:1| T0: 0.10| T1: 515.00| I0: 300.0| I1: 125.0| WTP: 350000,1,0.096153846,515,350000,1,0.2,300,125,-5249580951,952489126,7612.584114,4868951745,486895174.5,30,54204,2220,1265,1265,0,1265,54204,0,1265,13.16505324,0.427879961,0.427879961,63852.08277,201.9240077,1.034849952,99170.48015,0.643292026,0.002033412,1.23178E-05,0,0.023337761,296,55
D:1| T0: 0.10| T1: 515.00| I0: 300.0| I1: 125.0| WTP: 350000,1,0.096153846,515,350000,1,0.2,300,125,-1139908859,1550779155,10709.2349,604447113.9,60444711.39,4,84344,3554,549,1779,1230,549,84344,1230,1779,228.5606061,2.666666667,8.833333333,31327.41919,1191.515152,11.61616162,98631.5101,0.317057843,0.011953381,0.00011807,0.691399663,0.021092194,29,6
D:1| T0: 0.10| T1: 515.00| I0: 300.0| I1: 125.0| WTP: 350000,1,0.096153846,515,350000,1,0.2,300,125,-4437897582,607323321,7073.448753,4084225145,408422514.5,28,54377,2435,1175,1175,0,1175,54377,0,1175,18.93274112,0.538705584,0.538705584,68962.45495,166.5234772,1.282994924,99338.96827,0.693642924,0.001676634,1.49897E-05,0,0.021608401,226,46
D:1| T0: 0.10| T1: 515.00| I0: 300.0| I1: 125.0| WTP: 350000,1,0.096153846,515,350000,1,0.2,300,125,-1508441244,2103646485,7946.611489,1111110670,111111067,6,62287,2719,864,1320,456,864,62287,456,1320,63.35084428,1.491557223,2.335834897,50390.0863,351.3320826,3.943714822,98970.16135,0.508481349,0.003531716,4.11747E-05,0.345454545,0.021192223,77,12
D:1| T0: 0.10| T1: 515.00| I0: 300.0| I1: 125.0| WTP: 350000,1,0.096153846,515,350000,1,0.2,300,125,-1187916302,258120157,9816.134032,697109600.8,69710960.08,4,86490,3877,765,1630,865,765,86490,865,1630,274.125,4.25,9.079545455,37882.96023,1249.409091,13.42045455,98913.35227,0.38198227,0.012523214,0.000136465,0.530674847,0.018846109,26,7
D:1| T0: 0.10| T1: 515.00| I0: 300.0| I1: 125.0| WTP: 350000,1,0.096153846,515,350000,1,0.2,300,125,-2785071938,1068951401,7178.020241,2426170926,242617092.6,18,61249,2789,1157,1192,35,1157,61249,35,1192,29.87708516,0.844600527,0.875329236,54051.30026,209.761194,1.879719052,99109.52239,0.544828056,0.00211083,2.07288E-05,0.029362416,0.019461542,163,27
D:1| T0: 0.10| T1: 515.00| I0: 300.0| I1: 125.0| WTP: 350000,1,0.096153846,515,350000,1,0.2,300,125,-2226758050,635956235,8330.404531,1810237823,181023782.3,10,61109,2663,1278,1384,106,1278,61109,106,1384,28.23300971,1.028243601,1.114739629,49927.49426,410.3654016,2.240953222,98888.60724,0.504073485,0.004129585,2.3637E-05,0.076589595,0.022648426,161,20
D:1| T0: 0.10| T1: 515.00| I0: 300.0| I1: 125.0| WTP: 350000,1,0.096153846,515,350000,1,0.2,300,125,-4122869057,1346693470,6158.541679,3814941973,381494197.3,26,47344,2110,1023,1023,0,1023,47344,0,1023,16.43098064,0.447845097,0.447845097,72837.14491,151.9081824,1.08182386,99408.98251,0.732243846,0.001528615,1.28371E-05,0,0.02160872,229,43
D:1| T0: 0.10| T1: 515.00| I0: 300.0| I1: 125.0| WTP: 350000,1,0.096153846,515,350000,1,0.2,300,125,-1436811384,847102011,12905.10747,791556010.2,79155601.02,4,96205,4107,751,2144,1393,751,96205,1393,2144,273.8465608,3.899470899,11.17989418,35680.60317,1746.306878,15.15873016,98687.22751,0.35874908,0.017551088,0.000153949,0.649720149,0.022285744,27,8
D:1| T0: 0.10| T1: 515.00| I0: 300.0| I1: 125.0| WTP: 350000,1,0.096153846,515,350000,1,0.2,300,125,-1714735427,812083272,11705.96907,1129436974,112943697.4,6,83229,3514,929,1945,1016,929,83229,1016,1945,144.9046053,2.927631579,6.226973684,47286.86513,1685.930921,9.289473684,98850.78289,0.475603073,0.016966441,9.51709E-05,0.522365039,0.023369258,44,12
D:1| T0: 0.10| T1: 515.00| I0: 300.0| I1: 125.0| WTP: 350000,1,0.096153846,515,350000,1,0.2,300,125,-1329200586,2146825809,10784.68261,789966455.8,78996645.58,4,92017,4213,791,1791,1000,791,92017,1000,1791,304.4285714,4.642857143,10.5,37555.85714,1728.714286,15.19642857,98890.13095,0.378191999,0.017334485,0.000154162,0.558347292,0.019463795,24,8
D:1| T0: 0.10| T1: 515.00| I0: 300.0| I1: 125.0| WTP: 350000,1,0.096153846,515,350000,1,0.2,300,125,-1422160518,226186520,12664.04666,788958184.6,78895818.46,4,95343,4023,741,2104,1363,741,95343,1363,2104,260.0829016,3.797927461,10.79274611,37185.46114,1436.834197,14.62176166,98720.09845,0.373754352,0.014436702,0.00014812,0.647813688,0.022067692,28,8
D:1| T0: 0.10| T1: 515.00| I0: 300.0| I1: 125.0| WTP: 350000,1,0.096153846,515,350000,1,0.2,300,125,-1671403457,1110225441,10793.9403,1131706442,113170644.2,6,83782,3620,1052,1793,741,1052,83782,741,1793,109.9299517,2.446859903,4.200483092,41402.09903,1563.417874,6.734299517,98811.07971,0.416752734,0.015736354,6.91861E-05,0.413273843,0.021400778,60,12
D:1| T0: 0.10| T1: 515.00| I0: 300.0| I1: 125.0| WTP: 350000,1,0.096153846,515,350000,1,0.2,300,125,-1549218757,1190767082,8438.31671,1127302922,112730292.2,6,76949,3602,948,1401,453,948,76949,453,1401,118.9835616,2.449315068,3.660273973,47656.75068,1125.112329,6.265753425,99097.87671,0.479408559,0.011297258,6.46439E-05,0.323340471,0.018206864,53,12
D:1| T0: 0.10| T1: 515.00| I0: 300.0| I1: 125.0| WTP: 350000,1,0.096153846,515,350000,1,0.2,300,125,-2450069688,2108234095,7667.623861,2066688495,206668849.5,12,56196,2325,1216,1274,58,1216,56196,58,1274,30.03597884,1.092063492,1.15026455,57759.19048,363.1164021,2.455026455,99069.84974,0.58236799,0.003651818,2.64903E-05,0.045525903,0.022670653,135,23
D:1| T0: 0.10| T1: 515.00| I0: 300.0| I1: 125.0| WTP: 350000,1,0.096153846,515,350000,1,0.2,300,125,-1427185703,465621985,12659.72959,794199223.5,79419922.35,4,95321,4277,739,2103,1364,739,95321,1364,2103,254.4666667,3.428571429,9.880952381,29536.09524,1563.871429,13.39047619,98550.21429,0.297670185,0.015724434,0.000136115,0.648597242,0.022062295,30,8
D:1| T0: 0.10| T1: 515.00| I0: 300.0| I1: 125.0| WTP: 350000,1,0.096153846,515,350000,1,0.2,300,125,-2118711244,1487072553,7809.705154,1728225986,172822598.6,12,63602,2897,1192,1297,105,1192,63602,105,1297,41.3912037,1.208333333,1.325231481,52719.62384,263.7349537,2.701388889,99038.29051,0.531664709,0.002654092,2.89638E-05,0.080956052,0.02039244,124,19
D:1| T0: 0.10| T1: 515.00| I0: 300.0| I1: 125.0| WTP: 350000,1,0.096153846,515,350000,1,0.2,300,125,-1585188215,1213733847,9300.804262,1120148002,112014800.2,6,70532,3040,894,1545,651,894,70532,651,1545,119.8707692,2.618461538,4.593846154,51998.73538,921.44,7.335384615,99000.21846,0.523719141,0.009257401,7.54013E-05,0.421359223,0.021904951,47,12
D:1| T0: 0.10| T1: 515.00| I0: 300.0| I1: 125.0| WTP: 350000,1,0.096153846,515,350000,1,0.2,300,125,-1450304295,2003658337,10022.77439,949165575.6,94916557.56,6,77421,3295,720,1665,945,720,77421,945,1665,143.9792388,2.380622837,5.619377163,48371.38062,1095.865052,8.103806228,98950.68166,0.486844863,0.011008874,8.29139E-05,0.567567568,0.021505793,42,10
D:1| T0: 0.10| T1: 515.00| I0: 300.0| I1: 125.0| WTP: 350000,1,0.096153846,515,350000,1,0.2,300,125,-5904086421,1170868072,6622.506043,5572961119,557296111.9,38,53937,2423,1100,1100,0,1100,53937,0,1100,13.29560887,0.315980081,0.315980081,66554.16206,143.0461747,0.812132187,99324.72657,0.669462649,0.001440086,1.00098E-05,0,0.020394164,316,63
D:1| T0: 0.10| T1: 515.00| I0: 300.0| I1: 125.0| WTP: 350000,1,0.096153846,515,350000,1,0.2,300,125,-1248387758,569919592,10946.42582,701066467.4,70106646.74,4,90927,4036,754,1818,1064,754,90927,1064,1818,253.4723618,3.698492462,8.979899497,30524.05528,1191.648241,12.79396985,98700.54774,0.30818856,0.011961138,0.000129833,0.585258526,0.019994061,29,7
D:1| T0: 0.10| T1: 515.00| I0: 300.0| I1: 125.0| WTP: 350000,1,0.096153846,515,350000,1,0.2,300,125,-1536052886,1833180623,8233.200098,1124392881,112439288.1,6,73609,3467,1010,1367,357,1010,73609,357,1367,94.02031603,2.119638826,2.898419865,46665.58916,775.4740406,5.162528217,99053.39278,0.469996077,0.007789716,5.39094E-05,0.261155816,0.018571099,64,12
D:1| T0: 0.10| T1: 515.00| I0: 300.0| I1: 125.0| WTP: 350000,1,0.096153846,515,350000,1,0.2,300,125,-1449906411,1123666637,13169.32017,791440402.2,79144040.22,4,93680,4045,755,2188,1433,755,93680,1433,2188,305.5621302,4.384615385,12.77514793,40612.14201,1667.100592,17.24260355,98739.3432,0.408409567,0.01674863,0.000174963,0.654936015,0.023356106,25,8
D:1| T0: 0.10| T1: 515.00| I0: 300.0| I1: 125.0| WTP: 350000,1,0.096153846,515,350000,1,0.2,300,125,-1704109548,1682024981,11412.92154,1133463471,113346347.1,6,89643,3842,764,1896,1132,764,89643,1132,1896,188.3951613,2.943548387,7.475806452,45053.7621,2954.197581,10.55241935,98945.47581,0.452364142,0.029691437,0.000107839,0.597046414,0.021150564,35,12
D:1| T0: 0.10| T1: 515.00| I0: 300.0| I1: 125.0| WTP: 350000,1,0.096153846,515,350000,1,0.2,300,125,-1614347386,1687523543,9853.780441,1121658364,112165836.4,6,73916,3191,910,1637,727,910,73916,727,1637,121.412844,2.660550459,4.856269113,51852.32722,863.6544343,7.617737003,98992.85015,0.521887287,0.008680329,7.82927E-05,0.44410507,0.02214736,47,12
D:1| T0: 0.10| T1: 515.00| I0: 300.0| I1: 125.0| WTP: 350000,1,0.096153846,515,350000,1,0.2,300,125,-1345635842,178034412,11156.26963,787822360.1,78782236.01,4,88629,4029,653,1853,1200,653,88629,1200,1853,261.5811518,3.287958115,9.523560209,46469.73822,1635.806283,12.93717277,98981.01571,0.466733283,0.016413064,0.000131658,0.647598489,0.020907378,28,8
D:1| T0: 0.10| T1: 515.00| I0: 300.0| I1: 125.0| WTP: 350000,1,0.096153846,515,350000,1,0.2,300,125,-1343632261,739490003,11055.20661,790871930.9,79087193.09,4,91593,4084,689,1836,1147,689,91593,1147,1836,260.4773869,3.376884422,9.085427136,41796.68844,1289.628141,12.54271357,98924.0804,0.419874794,0.012941805,0.00012734,0.624727669,0.0200452,29,8
D:1| T0: 0.10| T1: 515.00| I0: 300.0| I1: 125.0| WTP: 350000,1,0.096153846,515,350000,1,0.2,300,125,-1553233087,178482706,10405.85626,1032940274,103294027.4,6,74832,3109,748,1729,981,748,74832,981,1729,105.8054054,1.886486486,4.510810811,44486.69189,865.7702703,6.52972973,98771.49189,0.44878558,0.008704529,6.73512E-05,0.567379988,0.023105397,53,11
D:1| T0: 0.10| T1: 515.00| I0: 300.0| I1: 125.0| WTP: 350000,1,0.096153846,515,350000,1,0.2,300,125,-1600293509,1919366370,9565.681338,1122009442,112200944.2,6,72536,3120,1061,1589,528,1061,72536,528,1589,79.68263473,1.966067864,2.992015968,46096.87226,498.7105788,5.119760479,98854.37126,0.464988624,0.005017954,5.3222E-05,0.332284456,0.021906666,72,12
D:1| T0: 0.10| T1: 515.00| I0: 300.0| I1: 125.0| WTP: 350000,1,0.096153846,515,350000,1,0.2,300,125,-1350194507,1819796913,11110.46298,794671358.1,79467135.81,4,96556,4424,693,1845,1152,693,96556,1152,1845,305.4971751,3.858757062,10.31638418,39525.46893,2242.305085,14.22033898,98959.40113,0.396708982,0.022489033,0.000143838,0.624390244,0.019108082,26,8
D:1| T0: 0.10| T1: 515.00| I0: 300.0| I1: 125.0| WTP: 350000,1,0.096153846,515,350000,1,0.2,300,125,-2010765753,1866591913,10583.52646,1481589430,148158943,8,83928,3660,1083,1758,675,1083,83928,675,1758,134.4268657,3.140298507,5.11641791,53016.58806,2060.208955,8.328358209,99104.49552,0.532233364,0.020715747,8.52932E-05,0.383959044,0.020946526,48,16
D:1| T0: 0.10| T1: 515.00| I0: 300.0| I1: 125.0| WTP: 350000,1,0.096153846,515,350000,1,0.2,300,125,-1283167706,1219425989,11643.03443,701015984.6,70101598.46,4,90737,4104,792,1934,1142,792,90737,1142,1934,271.2054054,4.194594595,10.29189189,32771.8973,1265.313514,14.56216216,98674.60541,0.330799664,0.012702179,0.000148043,0.590486039,0.021314348,27,7
D:1| T0: 0.10| T1: 515.00| I0: 300.0| I1: 125.0| WTP: 350000,1,0.096153846,515,350000,1,0.2,300,125,-1375186767,502409586,11691.69309,790602112.6,79060211.26,4,94589,4132,740,1942,1202,740,94589,1202,1942,234.9086758,3.292237443,8.716894977,35365.22374,1740.424658,12.12328767,98775.38813,0.355504956,0.017480772,0.000123025,0.618949537,0.020530929,32,8
D:1| T0: 0.10| T1: 515.00| I0: 300.0| I1: 125.0| WTP: 350000,1,0.096153846,515,350000,1,0.2,300,125,-1298231005,1405887957,10390.66199,778697905.8,77869790.58,4,81475,3596,731,1726,995,731,81475,995,1726,190.7467811,3.017167382,7.253218884,47510.91416,1061.261803,10.39484979,98959.02575,0.477923174,0.010656147,0.000105861,0.576477404,0.021184412,34,8
D:1| T0: 0.10| T1: 515.00| I0: 300.0| I1: 125.0| WTP: 350000,1,0.096153846,515,350000,1,0.2,300,125,-1310750888,283033753,10772.86618,772107578.5,77210757.85,4,78441,3243,736,1790,1054,736,78441,1054,1790,159.4703557,2.754940711,6.865612648,46613.99605,821.6679842,9.794466403,98849.01581,0.469582242,0.008255853,0.000100309,0.588826816,0.022819699,37,8
D:1| T0: 0.10| T1: 515.00| I0: 300.0| I1: 125.0| WTP: 350000,1,0.096153846,515,350000,1,0.2,300,125,-1631707308,1083157068,10178.47526,1122783545,112278354.5,6,75552,3236,1104,1691,587,1104,75552,587,1691,82.34836066,2.096311475,3.266393443,42607.33607,785.3504098,5.540983607,98773.31967,0.429969257,0.007901423,5.76564E-05,0.347131875,0.022381936,70,12
D:1| T0: 0.10| T1: 515.00| I0: 300.0| I1: 125.0| WTP: 350000,1,0.096153846,515,350000,1,0.2,300,125,-1564332210,1988704626,9034.193081,1112622556,111262255.6,6,67100,2768,1203,1501,298,1203,67100,298,1501,64.71537002,2.102466793,2.652751423,51775.22201,327.0910816,4.935483871,98950.97154,0.522184476,0.003291057,5.16087E-05,0.19853431,0.022369598,76,12
D:1| T0: 0.10| T1: 515.00| I0: 300.0| I1: 125.0| WTP: 350000,1,0.096153846,515,350000,1,0.2,300,125,-1235553535,884761309,10818.19661,694643704,69464370.4,4,83967,3749,680,1797,1117,680,83967,1117,1797,191.8065844,2.703703704,7.279835391,29886.15226,898.345679,10.08230453,98566.96708,0.302686556,0.009023984,0.000102489,0.621591541,0.02140152,35,7
D:1| T0: 0.10| T1: 515.00| I0: 300.0| I1: 125.0| WTP: 350000,1,0.096153846,515,350000,1,0.2,300,125,-2441139097,533485933,7227.448728,2079766660,207976666,16,63549,2964,1186,1200,14,1186,63549,14,1200,40.21122112,1.100110011,1.115511551,57231.11881,190.0088009,2.407040704,99199.88339,0.576301021,0.001911822,2.63777E-05,0.011666667,0.018883958,130,23
D:1| T0: 0.10| T1: 515.00| I0: 300.0| I1: 125.0| WTP: 350000,1,0.096153846,515,350000,1,0.2,300,125,-2198840098,632196071,7813.231492,1808178523,180817852.3,14,59827,2540,1213,1298,85,1213,59827,85,1298,40.6068152,1.407601573,1.513761468,57168.98165,202.3289646,3.094364351,99084.87025,0.57631586,0.002036229,3.30828E-05,0.065485362,0.02169589,109,20
D:1| T0: 0.10| T1: 515.00| I0: 300.0| I1: 125.0| WTP: 350000,1,0.096153846,515,350000,1,0.2,300,125,-1367451527,393400457,11482.34108,793334472.9,79333447.29,4,94442,4189,581,1907,1326,581,94442,1326,1907,266.935,2.815,9.385,40691.735,1473.695,12.275,98891.985,0.408448052,0.014792933,0.000124897,0.695332984,0.020192287,29,8
D:1| T0: 0.10| T1: 515.00| I0: 300.0| I1: 125.0| WTP: 350000,1,0.096153846,515,350000,1,0.2,300,125,-1308958325,398973227,10671.83767,775366441.6,77536644.16,4,79252,3307,687,1773,1086,687,79252,1086,1773,156.6273063,2.420664207,6.383763838,44968.54613,876.2804428,8.915129151,98833.99631,0.453017302,0.00880499,9.123E-05,0.612521151,0.02237224,39,8
D:1| T0: 0.10| T1: 515.00| I0: 300.0| I1: 125.0| WTP: 350000,1,0.096153846,515,350000,1,0.2,300,125,-1625618266,1402256491,9910.577449,1130089394,113008939.4,6,80612,3629,974,1646,672,974,80612,672,1646,151.8067797,3.166101695,5.396610169,50178.82712,1719.433898,8.708474576,99058.63729,0.504385303,0.017273538,8.92648E-05,0.408262454,0.020418796,43,12
D:1| T0: 0.10| T1: 515.00| I0: 300.0| I1: 125.0| WTP: 350000,1,0.096153846,515,350000,1,0.2,300,125,-1417702314,2102527413,12585.78621,788413003.6,78841300.36,4,91625,3900,698,2091,1393,698,91625,1393,2091,198.4365079,2.662698413,8.154761905,39848.72619,2102.353175,10.92063492,98734.33333,0.400390378,0.021147796,0.000111369,0.666188427,0.022821282,36,8
D:1| T0: 0.10| T1: 515.00| I0: 300.0| I1: 125.0| WTP: 350000,1,0.096153846,515,350000,1,0.2,300,125,-1376646080,1748031099,11822.1405,785539054.7,78553905.47,4,91504,3881,672,1964,1292,672,91504,1292,1964,205.0805085,2.737288136,8.177966102,38983.5339,2100.516949,11.00847458,98797.72458,0.39176593,0.021109395,0.000112304,0.657841141,0.021464012,34,8
D:1| T0: 0.10| T1: 515.00| I0: 300.0| I1: 125.0| WTP: 350000,1,0.096153846,515,350000,1,0.2,300,125,-1815205527,1946754629,8758.466225,1377282216,137728221.6,8,66108,2908,1222,1455,233,1222,66108,233,1455,47.11497326,1.467914439,1.762032086,50121.11096,339.5935829,3.394385027,98927.35294,0.505714593,0.003417865,3.60028E-05,0.160137457,0.022010438,107,15
D:1| T0: 0.10| T1: 515.00| I0: 300.0| I1: 125.0| WTP: 350000,1,0.096153846,515,350000,1,0.2,300,125,-1513576986,2097712204,8013.258541,1112914059,111291405.9,6,64921,2912,1013,1331,318,1013,64921,318,1331,62.7920434,1.638336347,2.198915009,51456.95118,366.3562387,4.048824593,99031.05606,0.518807863,0.003683309,4.25992E-05,0.238918107,0.020501841,79,12
D:1| T0: 0.10| T1: 515.00| I0: 300.0| I1: 125.0| WTP: 350000,1,0.096153846,515,350000,1,0.2,300,125,-1885383761,1198827119,8427.924174,1463987552,146398755.2,8,61458,2695,1235,1400,165,1235,61458,165,1400,46.82479784,1.517520216,1.735849057,54867.54582,532.3989218,3.396226415,98998.42453,0.553175636,0.005355092,3.57125E-05,0.117857143,0.022779785,106,16
D:1| T0: 0.10| T1: 515.00| I0: 300.0| I1: 125.0| WTP: 350000,1,0.096153846,515,350000,1,0.2,300,125,-4797819026,109253198,5760.041257,4509816963,450981696.3,28,43302,1831,957,957,0,957,43302,0,957,10.47029019,0.268539843,0.268539843,73653.35191,139.0230309,0.711192999,99423.15845,0.740387841,0.001398817,8.85449E-06,0,0.022100596,310,51
D:1| T0: 0.10| T1: 515.00| I0: 300.0| I1: 125.0| WTP: 350000,1,0.096153846,515,350000,1,0.2,300,125,-2858585360,314481292,7008.035195,2508183600,250818360,20,56132,2497,1159,1164,5,1159,56132,5,1164,29.49374398,0.914340712,0.918190568,61725.46679,160.493744,2.038498556,99209.58133,0.621599689,0.001615418,2.2467E-05,0.004295533,0.020736835,149,28
D:1| T0: 0.10| T1: 515.00| I0: 350.0| I1: 75.0| WTP: 400000,1,0.096153846,515,400000,1,0.2,350,75,-4291928936,1178568022,7608.797342,3911489069,391148906.9,22,57943,2528,1264,1264,0,1264,57943,0,1264,18.61634845,0.557875895,0.557875895,60691.56086,178.4427208,1.318019093,99138.4648,0.611564699,0.001797478,1.51703E-05,0,0.021814542,239,44
D:1| T0: 0.10| T1: 515.00| I0: 350.0| I1: 75.0| WTP: 400000,1,0.096153846,515,400000,1,0.2,350,75,-1383520751,2029998696,11830.2407,792008715.4,79200871.54,4,94945,4164,648,1965,1317,648,94945,1317,1965,230.8502203,2.753303965,8.524229075,35657.04846,1414.511013,11.37444934,98757.2467,0.358235323,0.014213002,0.00011567,0.670229008,0.020696193,33,8
D:1| T0: 0.10| T1: 515.00| I0: 350.0| I1: 75.0| WTP: 400000,1,0.096153846,515,400000,1,0.2,350,75,-1413972414,776062361,12590.52504,784446162.6,78444616.26,4,92374,3822,796,2092,1296,796,92374,1296,2092,176.2304833,2.862453532,7.643122677,39223.80669,2136.762082,10.60594796,98727.87361,0.394065151,0.021505698,0.000108069,0.619502868,0.022647065,38,8
D:1| T0: 0.10| T1: 515.00| I0: 350.0| I1: 75.0| WTP: 400000,1,0.096153846,515,400000,1,0.2,350,75,-3629152462,1813046880,8259.379111,3216183507,321618350.7,18,61162,2782,1366,1372,6,1366,61162,6,1372,22.65548981,0.71268902,0.715976331,57331.66141,254.4286654,1.623274162,99051.58843,0.578075923,0.002562697,1.81136E-05,0.004373178,0.022432229,218,36
D:1| T0: 0.10| T1: 515.00| I0: 350.0| I1: 75.0| WTP: 400000,1,0.096153846,515,400000,1,0.2,350,75,-2105309265,2032407216,7563.107386,1727153896,172715389.6,10,63774,2844,1151,1256,105,1151,63774,105,1256,42.35817308,1.188701923,1.308894231,53134.13822,268.0961538,2.689903846,99098.81611,0.535527463,0.002696444,2.90788E-05,0.083665339,0.019679483,119,19
D:1| T0: 0.10| T1: 515.00| I0: 350.0| I1: 75.0| WTP: 400000,1,0.096153846,515,400000,1,0.2,350,75,-5306860261,1507873352,7070.97894,4953311314,495331131.4,28,50532,2122,1175,1175,0,1175,50532,0,1175,11.83737185,0.366728798,0.366728798,72823.99907,171.082945,0.912861137,99374.96552,0.732208719,0.001722657,1.10102E-05,0,0.023252592,306,56
D:1| T0: 0.10| T1: 515.00| I0: 350.0| I1: 75.0| WTP: 400000,1,0.096153846,515,400000,1,0.2,350,75,-3092172913,1855899401,6484.46326,2767949750,276794975,16,51804,2327,1077,1077,0,1077,51804,0,1077,20.94873646,0.593501805,0.593501805,65770.23394,139.4469314,1.376895307,99293.60866,0.661891688,0.001403559,1.56251E-05,0,0.020790703,198,31
D:1| T0: 0.10| T1: 515.00| I0: 350.0| I1: 75.0| WTP: 400000,1,0.096153846,515,400000,1,0.2,350,75,-1281892609,1819459251,10172.70203,773257507.6,77325750.76,4,76418,3302,742,1690,948,742,76418,948,1690,125.5731707,2.131097561,4.987804878,45077.6372,836.4054878,7.237804878,98842.49695,0.454341786,0.008406084,7.45449E-05,0.560946746,0.022116077,47,8
D:1| T0: 0.10| T1: 515.00| I0: 350.0| I1: 75.0| WTP: 400000,1,0.096153846,515,400000,1,0.2,350,75,-3344996423,909791748,6327.530794,3028619884,302861988.4,20,50712,2245,1051,1051,0,1051,50712,0,1051,16.26127709,0.44288225,0.44288225,65429.96954,96.57527827,1.07029877,99284.03749,0.65852689,0.000972959,1.23717E-05,0,0.020724878,244,34
D:1| T0: 0.10| T1: 515.00| I0: 350.0| I1: 75.0| WTP: 400000,1,0.096153846,515,400000,1,0.2,350,75,-1476838419,1339092841,9063.685199,1023654159,102365415.9,6,65749,2721,812,1506,694,812,65749,694,1506,89.15915119,2.068965517,3.888594164,51412.98674,627.1883289,6.031830239,98925.66048,0.518515701,0.006302596,6.17803E-05,0.460823373,0.02290564,54,11
D:1| T0: 0.10| T1: 515.00| I0: 350.0| I1: 75.0| WTP: 400000,1,0.096153846,515,400000,1,0.2,350,75,-1403507233,1365866345,12208.93929,793060268.4,79306026.84,4,95855,4267,715,2028,1313,715,95855,1313,2028,219.3112033,2.887966805,8.298755187,32980.77593,1247.344398,11.24481328,98667.9917,0.331489792,0.0125414,0.000114431,0.647435897,0.021156956,35,8
D:1| T0: 0.10| T1: 515.00| I0: 350.0| I1: 75.0| WTP: 400000,1,0.096153846,515,400000,1,0.2,350,75,-1572425539,825453433,8912.60515,1126795282,112679528.2,6,75128,3348,899,1480,581,899,75128,581,1480,106.8044554,2.094059406,3.514851485,45192.02475,946.3836634,5.747524752,98971.0198,0.455215944,0.009507945,5.91903E-05,0.392567568,0.019699712,58,12
D:1| T0: 0.10| T1: 515.00| I0: 350.0| I1: 75.0| WTP: 400000,1,0.096153846,515,400000,1,0.2,350,75,-1392680308,939711378,11974.9893,793930842.6,79393084.26,4,96951,4287,640,1989,1349,640,96951,1349,1989,232.7434783,2.726086957,8.539130435,32911.42174,1656.417391,11.30434783,98717.07391,0.330585224,0.016642516,0.000114881,0.678230266,0.020515518,33,8
D:1| T0: 0.10| T1: 515.00| I0: 350.0| I1: 75.0| WTP: 400000,1,0.096153846,515,400000,1,0.2,350,75,-1894952660,638950699,8430.951515,1473405084,147340508.4,8,70609,3151,1087,1400,313,1087,70609,313,1400,69.30204778,1.747440273,2.262798635,45785.31399,760.7542662,4.126279863,98958.57167,0.461567767,0.007648648,4.26643E-05,0.223571429,0.019827501,84,16
D:1| T0: 0.10| T1: 515.00| I0: 350.0| I1: 75.0| WTP: 400000,1,0.096153846,515,400000,1,0.2,350,75,-2206431598,938699148,7851.094209,1813876887,181387688.7,10,64230,2848,1222,1304,82,1222,64230,82,1304,39.35958904,1.221461187,1.310502283,53554.69863,247.3892694,2.707762557,99068.48858,0.539833916,0.002489606,2.89925E-05,0.062883436,0.02030204,126,20
D:1| T0: 0.10| T1: 515.00| I0: 350.0| I1: 75.0| WTP: 400000,1,0.096153846,515,400000,1,0.2,350,75,-4246468213,121790188,6678.271925,3912554617,391255461.7,22,56723,2607,1109,1109,0,1109,56723,0,1109,18.69436374,0.472399768,0.472399768,61812.38001,237.1801278,1.113306217,99262.22429,0.622176249,0.002385967,1.29521E-05,0,0.019551152,245,44
D:1| T0: 0.10| T1: 515.00| I0: 350.0| I1: 75.0| WTP: 400000,1,0.096153846,515,400000,1,0.2,350,75,-1618858892,1331335240,11336.8885,1052014467,105201446.7,6,90734,3926,720,1883,1163,720,90734,1163,1883,202.708,2.764,7.368,40985.628,2391.792,10.244,98879.656,0.41171151,0.024033941,0.000104673,0.617631439,0.02075297,36,11
D:1| T0: 0.10| T1: 515.00| I0: 350.0| I1: 75.0| WTP: 400000,1,0.096153846,515,400000,1,0.2,350,75,-1344883793,470935411,12850.55476,702356055.6,70235605.56,4,93723,3995,728,2135,1407,728,93723,1407,2135,299.1823529,4.194117647,12.37647059,34795.56471,1426.711765,16.67058824,98640.10588,0.350554058,0.014330058,0.000169245,0.659016393,0.022779894,25,7
D:1| T0: 0.10| T1: 515.00| I0: 350.0| I1: 75.0| WTP: 400000,1,0.096153846,515,400000,1,0.2,350,75,-1605330363,823434397,9785.986436,1116031041,111603104.1,6,69486,2888,1189,1626,437,1189,69486,437,1626,59.44059406,1.836633663,2.537953795,46806.24092,586.9438944,4.491749175,98788.86469,0.472555394,0.005908499,4.67626E-05,0.268757688,0.023400734,87,12
D:1| T0: 0.10| T1: 515.00| I0: 350.0| I1: 75.0| WTP: 400000,1,0.096153846,515,400000,1,0.2,350,75,-2922615160,493045351,6527.698779,2596230221,259623022.1,16,57318,2545,1084,1084,0,1084,57318,0,1084,28.48212649,0.802933089,0.802933089,65236.79102,133.3996334,1.780018332,99362.20807,0.655901568,0.001342304,1.99614E-05,0,0.018912035,156,29
D:1| T0: 0.10| T1: 515.00| I0: 350.0| I1: 75.0| WTP: 400000,1,0.096153846,515,400000,1,0.2,350,75,-1838661655,1700216563,7361.064812,1470608414,147060841.4,8,65144,3001,975,1222,247,975,65144,247,1222,88.37837838,2.094594595,2.628378378,56137.5518,787.8243243,4.81981982,99214.01126,0.564670987,0.007908486,4.96717E-05,0.20212766,0.018758731,64,16
D:1| T0: 0.10| T1: 515.00| I0: 350.0| I1: 75.0| WTP: 400000,1,0.096153846,515,400000,1,0.2,350,75,-1762581707,1744119059,7689.729462,1378095233,137809523.3,8,64075,2981,1133,1277,144,1133,64075,144,1277,58.29886914,1.620355412,1.844911147,53829.28595,286.3812601,3.675282714,99103.937,0.542536813,0.002879593,3.91244E-05,0.112764291,0.019930081,89,15
D:1| T0: 0.10| T1: 515.00| I0: 350.0| I1: 75.0| WTP: 400000,1,0.096153846,515,400000,1,0.2,350,75,-2903243006,2036906360,7902.815283,2508102242,250810224.2,14,59619,2573,1291,1313,22,1291,59619,22,1313,17.88068517,0.619019492,0.632014176,51861.80626,244.6255168,1.398109864,98956.56054,0.523484226,0.00246325,1.54732E-05,0.016755522,0.022023181,241,28
D:1| T0: 0.10| T1: 515.00| I0: 350.0| I1: 75.0| WTP: 400000,1,0.096153846,515,400000,1,0.2,350,75,-1877769364,809704121,8171.308232,1469203953,146920395.3,8,67694,3069,1009,1357,348,1009,67694,348,1357,91.42925659,2.278177458,3.09352518,55503.19664,838.7889688,5.51558753,99149.98561,0.558406623,0.008424791,5.69833E-05,0.256448047,0.02004609,59,16
D:1| T0: 0.10| T1: 515.00| I0: 350.0| I1: 75.0| WTP: 400000,1,0.096153846,515,400000,1,0.2,350,75,-1700234090,1219866412,11258.06692,1137330744,113733074.4,6,89654,3951,801,1870,1069,801,89654,1069,1870,186.7528517,2.923954373,6.950570342,40127.79468,2798.513308,9.992395437,98855.30798,0.403365863,0.028130056,0.000102118,0.571657754,0.020857965,38,12
D:1| T0: 0.10| T1: 515.00| I0: 350.0| I1: 75.0| WTP: 400000,1,0.096153846,515,400000,1,0.2,350,75,-4983301947,843498920,7446.078098,4610998042,461099804.2,28,55950,2431,1237,1237,0,1237,55950,0,1237,16.99158249,0.498877666,0.498877666,68380.15993,150.8563412,1.185746352,99306.92144,0.687898053,0.001519574,1.39618E-05,0,0.022109421,255,52
D:1| T0: 0.10| T1: 515.00| I0: 350.0| I1: 75.0| WTP: 400000,1,0.096153846,515,400000,1,0.2,350,75,-1981660987,107351963,10326.07949,1465357012,146535701.2,8,71840,2807,1295,1716,421,1295,71840,421,1716,48.4813278,1.64868603,2.215767635,44824.26694,690.9377593,3.987551867,98718.40387,0.452727074,0.006959652,4.19493E-05,0.245337995,0.023886414,104,16
D:1| T0: 0.10| T1: 515.00| I0: 350.0| I1: 75.0| WTP: 400000,1,0.096153846,515,400000,1,0.2,350,75,-1938570457,773789021,9313.572893,1472891812,147289181.2,8,69960,3174,1120,1547,427,1120,69960,427,1547,80.8989899,2.125252525,2.965656566,51247.27879,958.0060606,5.22020202,98966.28485,0.516321658,0.009635197,5.41865E-05,0.2760181,0.022112636,71,16
D:1| T0: 0.10| T1: 515.00| I0: 350.0| I1: 75.0| WTP: 400000,1,0.096153846,515,400000,1,0.2,350,75,-1618199969,850936611,10020.55179,1117172380,111717238,6,69867,2894,1127,1665,538,1127,69867,538,1665,57.07142857,1.641304348,2.448757764,44639.63509,575.613354,4.187888199,98709.67081,0.451028243,0.005796502,4.36564E-05,0.323123123,0.023830993,92,12
D:1| T0: 0.10| T1: 515.00| I0: 350.0| I1: 75.0| WTP: 400000,1,0.096153846,515,400000,1,0.2,350,75,-1568445633,1701318364,8982.293752,1119330945,111933094.5,6,70496,3025,1075,1492,417,1075,70496,417,1492,60.82250396,1.580031696,2.228209192,42821.13154,470.340729,3.93977813,98808.25674,0.43253079,0.004732987,4.09292E-05,0.279490617,0.021164321,91,12
D:1| T0: 0.10| T1: 515.00| I0: 350.0| I1: 75.0| WTP: 400000,1,0.096153846,515,400000,1,0.2,350,75,-3525259050,778708269,6411.891239,3204664488,320466448.8,18,50071,2231,1065,1065,0,1065,50071,0,1065,16.29895713,0.463499421,0.463499421,62562.87428,223.608343,1.082271147,99212.04925,0.630150115,0.002248852,1.23993E-05,0,0.021269797,247,36
D:1| T0: 0.10| T1: 515.00| I0: 350.0| I1: 75.0| WTP: 400000,1,0.096153846,515,400000,1,0.2,350,75,-3008445454,1391938506,8274.853795,2594702764,259470276.4,16,57227,2381,1329,1375,46,1329,57227,46,1375,19.3497053,0.712508186,0.741977734,55016.81532,134.0759659,1.614931238,98925.78324,0.555617384,0.001351631,1.78193E-05,0.033454545,0.02402712,219,29
D:1| T0: 0.10| T1: 515.00| I0: 350.0| I1: 75.0| WTP: 400000,1,0.096153846,515,400000,1,0.2,350,75,-4213255184,43418681,6253.893679,3900560500,390056050,22,48309,2083,1039,1039,0,1039,48309,0,1039,11.96384396,0.314462417,0.314462417,68417.83349,129.8991437,0.81208373,99324.60419,0.688389655,0.00130761,9.93267E-06,0,0.02150738,301,44
D:1| T0: 0.10| T1: 515.00| I0: 350.0| I1: 75.0| WTP: 400000,1,0.096153846,515,400000,1,0.2,350,75,-1417547193,817384966,12692.12962,782940711.9,78294071.19,4,90602,3756,789,2109,1320,789,90602,1320,2109,252.4456522,4.195652174,11.2826087,40878.88587,1341.407609,15.5923913,98743.14674,0.411496812,0.013472938,0.000158227,0.625889047,0.023277632,27,8
D:1| T0: 0.10| T1: 515.00| I0: 350.0| I1: 75.0| WTP: 400000,1,0.096153846,515,400000,1,0.2,350,75,-1329680087,762053968,10908.90403,784234885.7,78423488.57,4,89409,3903,706,1812,1106,706,89409,1106,1812,233.9460784,3.362745098,8.730392157,42878.75,1366.02451,12.18627451,98936.04902,0.430944848,0.013709946,0.000123882,0.610375276,0.020266416,30,8
D:1| T0: 0.10| T1: 515.00| I0: 350.0| I1: 75.0| WTP: 400000,1,0.096153846,515,400000,1,0.2,350,75,-2203774780,1692506311,7726.122047,1817468677,181746867.7,10,67031,3056,1176,1283,107,1176,67031,107,1283,37.49795918,1.047959184,1.154081633,47771.57347,453.5826531,2.357142857,99020.71122,0.481665051,0.004562278,2.5228E-05,0.083398285,0.019140398,139,20
D:1| T0: 0.10| T1: 515.00| I0: 350.0| I1: 75.0| WTP: 400000,1,0.096153846,515,400000,1,0.2,350,75,-3522179565,1037620300,6387.248266,3202817152,320281715.2,18,49850,2150,1061,1061,0,1061,49850,0,1061,16.79143389,0.48106766,0.48106766,67288.55183,129.7920546,1.134698945,99313.69212,0.677073131,0.001306453,1.32339E-05,0,0.021283852,231,36
D:1| T0: 0.10| T1: 515.00| I0: 350.0| I1: 75.0| WTP: 400000,1,0.096153846,515,400000,1,0.2,350,75,-3061729143,301400999,7507.402883,2686358999,268635899.9,16,60478,2616,1247,1247,0,1247,60478,0,1247,25.16510903,0.767133956,0.767133956,57635.81386,195.2367601,1.744548287,99144.69159,0.580801114,0.001965277,1.953E-05,0,0.020619068,184,30
D:1| T0: 0.10| T1: 515.00| I0: 350.0| I1: 75.0| WTP: 400000,1,0.096153846,515,400000,1,0.2,350,75,-1333353780,1868336855,11034.19698,781643931.1,78164393.11,4,85024,3691,738,1833,1095,738,85024,1095,1833,181.6062992,2.767716535,7.05511811,45113.5,1305.53937,9.94488189,98904.12598,0.453593972,0.013117366,0.000101749,0.597381342,0.021558619,37,8
D:1| T0: 0.10| T1: 515.00| I0: 350.0| I1: 75.0| WTP: 400000,1,0.096153846,515,400000,1,0.2,350,75,-1328426135,1868498144,11020.78071,777387099.5,77738709.95,4,83064,3574,738,1831,1093,738,83064,1093,1831,154.2624113,2.468085106,6.308510638,43508.91489,1229.22695,8.946808511,98828.9078,0.437946382,0.012357932,9.15984E-05,0.596941562,0.022043244,41,8
D:1| T0: 0.10| T1: 515.00| I0: 350.0| I1: 75.0| WTP: 400000,1,0.096153846,515,400000,1,0.2,350,75,-2862264318,2101566889,7080.122107,2508258213,250825821.3,14,54745,2441,1170,1176,6,1170,54745,6,1176,23.89269051,0.731726283,0.736391913,59239.69751,241.7923795,1.652410575,99135.28149,0.597079439,0.002432946,1.83359E-05,0.005102041,0.021481414,184,28
D:1| T0: 0.10| T1: 515.00| I0: 350.0| I1: 75.0| WTP: 400000,1,0.096153846,515,400000,1,0.2,350,75,-1413178542,1665097450,12448.42765,790757159.4,79075715.94,4,95364,4084,709,2068,1359,709,95364,1359,2068,231.5315315,3.157657658,9.216216216,29969.05405,1471.099099,12.40540541,98565.62162,0.301893621,0.01479362,0.000125802,0.657156673,0.021685332,32,8
D:1| T0: 0.10| T1: 515.00| I0: 350.0| I1: 75.0| WTP: 400000,1,0.096153846,515,400000,1,0.2,350,75,-1337506518,1716179948,10775.50476,798731279.7,79873127.97,4,97436,4498,713,1789,1076,713,97436,1076,1789,304.7365591,3.747311828,9.478494624,36982.23118,1808.892473,13.31182796,98946.6129,0.371245615,0.018147954,0.000134933,0.601453326,0.01836077,27,8
D:1| T0: 0.10| T1: 515.00| I0: 350.0| I1: 75.0| WTP: 400000,1,0.096153846,515,400000,1,0.2,350,75,-3139189720,1560278715,7533.734001,2762503020,276250302,16,50468,2061,1252,1252,0,1252,50468,0,1252,22.0745614,0.895614035,0.895614035,65586.71754,151.0701754,2.007017544,99165.41579,0.660808992,0.001521161,2.20836E-05,0,0.024808782,162,31
D:1| T0: 0.10| T1: 515.00| I0: 350.0| I1: 75.0| WTP: 400000,1,0.096153846,515,400000,1,0.2,350,75,-1400544680,991019385,12343.8999,783349685.4,78334968.54,4,90105,3827,713,2051,1338,713,90105,1338,2051,176.2255639,2.560150376,7.567669173,38985.35338,2004.496241,10.26691729,98708.37218,0.392013411,0.020164468,0.000104562,0.6523647,0.022762333,38,8
D:1| T0: 0.10| T1: 515.00| I0: 350.0| I1: 75.0| WTP: 400000,1,0.096153846,515,400000,1,0.2,350,75,-1350120201,118052103,11293.66053,785437174.6,78543717.46,4,87357,3891,765,1876,1111,765,87357,1111,1876,180.4701493,2.720149254,6.824626866,45449.93657,1649.537313,9.701492537,98919.63433,0.456590564,0.016581293,9.90906E-05,0.592217484,0.021475096,39,8
D:1| T0: 0.10| T1: 515.00| I0: 350.0| I1: 75.0| WTP: 400000,1,0.096153846,515,400000,1,0.2,350,75,-1405055439,1209758844,12434.00238,783355320.1,78335532.01,4,89402,3728,691,2066,1375,691,89402,1375,2066,240.5179487,3.441025641,10.44102564,45146.83077,1345.369231,13.96410256,98835.05128,0.45362038,0.013515966,0.000142049,0.66553727,0.023109103,28,8
D:1| T0: 0.10| T1: 515.00| I0: 350.0| I1: 75.0| WTP: 400000,1,0.096153846,515,400000,1,0.2,350,75,-4989250466,70671723,7572.068919,4610647020,461064702,26,57412,2446,1258,1258,0,1258,57412,0,1258,15.83386076,0.474156118,0.474156118,63632.18565,186.7241561,1.135548523,99213.66667,0.64074199,0.001880514,1.3347E-05,0,0.021911795,271,52
D:1| T0: 0.10| T1: 515.00| I0: 350.0| I1: 75.0| WTP: 400000,1,0.096153846,515,400000,1,0.2,350,75,-3163248037,1722612191,6160.017382,2855247168,285524716.8,16,51821,2308,1023,1023,0,1023,51821,0,1023,19.92027491,0.513402062,0.513402062,64316.40962,196.2542955,1.230927835,99307.13333,0.647174665,0.001973601,1.41242E-05,0,0.019741032,207,32
D:1| T0: 0.10| T1: 515.00| I0: 350.0| I1: 75.0| WTP: 400000,1,0.096153846,515,400000,1,0.2,350,75,-3142452402,1968291596,5757.449843,2854579910,285457991,16,49402,2243,956,956,0,956,49402,0,956,22.01995395,0.545663853,0.545663853,67550.33461,151.9033001,1.272448196,99381.32617,0.679290093,0.001527551,1.47328E-05,0,0.019351443,187,32
D:1| T0: 0.10| T1: 515.00| I0: 350.0| I1: 75.0| WTP: 400000,1,0.096153846,515,400000,1,0.2,350,75,-1449474365,1877569084,13169.17406,791015662.1,79101566.21,4,96488,4069,745,2188,1443,745,96488,1443,2188,266.1295337,3.813471503,11.21243523,35133.56995,1600.093264,15.05181347,98644.61658,0.353250926,0.016087307,0.00015278,0.659506399,0.022676395,28,8
D:1| T0: 0.10| T1: 515.00| I0: 350.0| I1: 75.0| WTP: 400000,1,0.096153846,515,400000,1,0.2,350,75,-1400909269,1726322189,12190.40189,791389174.1,79138917.41,4,95421,4151,742,2025,1283,742,95421,1283,2025,268.4352332,3.777202073,10.33678756,36894.84456,1673.772021,14.19170984,98778.33161,0.370759373,0.0168105,0.000144015,0.633580247,0.021221744,28,8
D:1| T0: 0.10| T1: 515.00| I0: 350.0| I1: 75.0| WTP: 400000,1,0.096153846,515,400000,1,0.2,350,75,-1390977632,307848836,12063.07059,787824102.3,78782410.23,4,91431,4027,613,2004,1391,613,91431,1391,2004,231.5627907,2.772093023,9.195348837,41100.16744,1495.390698,12.03255814,98811.69767,0.412902006,0.015021828,0.000122332,0.694111776,0.021918168,31,8
D:1| T0: 0.10| T1: 515.00| I0: 350.0| I1: 75.0| WTP: 400000,1,0.096153846,515,400000,1,0.2,350,75,-1341668484,1154000220,11019.14034,790711467.3,79071146.73,4,90887,4116,741,1830,1089,741,90887,1089,1830,279.227027,3.940540541,9.762162162,33141.29189,1277.481081,13.76756757,98752.11351,0.33430677,0.012817088,0.000139538,0.595081967,0.020134893,27,8
D:1| T0: 0.10| T1: 515.00| I0: 350.0| I1: 75.0| WTP: 400000,1,0.096153846,515,400000,1,0.2,350,75,-4577864565,2028661055,6400.261283,4257851501,425785150.1,24,53087,2343,1063,1063,0,1063,53087,0,1063,16.80369515,0.42551963,0.42551963,67687.84353,159.6351039,1.043879908,99362.39838,0.680712665,0.001606378,1.23332E-05,0,0.020023735,248,48
D:1| T0: 0.10| T1: 515.00| I0: 350.0| I1: 75.0| WTP: 400000,1,0.096153846,515,400000,1,0.2,350,75,-1969113409,1629114640,9866.976405,1475764588,147576458.8,8,77650,3408,1069,1639,570,1069,77650,570,1639,116.0362117,2.857938719,4.398328691,48852.92201,1342.593315,7.381615599,98990.05014,0.491602052,0.013496319,7.58473E-05,0.347773032,0.021107534,52,16
D:1| T0: 0.10| T1: 515.00| I0: 350.0| I1: 75.0| WTP: 400000,1,0.096153846,515,400000,1,0.2,350,75,-1448079271,1439048174,13026.9009,796734226.2,79673422.62,4,96599,4308,746,2164,1418,746,96599,1418,2164,300.1748634,4,11.66666667,38851.43169,2247.836066,15.75956284,98756.08743,0.390137629,0.022590817,0.000159786,0.655268022,0.022401888,27,8
D:1| T0: 0.10| T1: 515.00| I0: 350.0| I1: 75.0| WTP: 400000,1,0.096153846,515,400000,1,0.2,350,75,-1292416835,865227006,11976.89732,693571969.4,69357196.94,4,88440,3679,705,1990,1285,705,88440,1285,1990,275.0722892,4.120481928,11.79518072,34329.10843,1429.783133,16.08433735,98636.85542,0.346731923,0.014345885,0.000163076,0.645728643,0.02250164,24,7
D:1| T0: 0.10| T1: 515.00| I0: 350.0| I1: 75.0| WTP: 400000,1,0.096153846,515,400000,1,0.2,350,75,-1691078570,890479738,11095.6054,1136298300,113629830,6,88008,3838,815,1843,1028,815,88008,1028,1843,149.7808642,2.416666667,5.552469136,37508.04012,1938.632716,8.074074074,98771.28395,0.377419917,0.019499109,8.25542E-05,0.557786218,0.020941278,47,12
D:1| T0: 0.10| T1: 515.00| I0: 350.0| I1: 75.0| WTP: 400000,1,0.096153846,515,400000,1,0.2,350,75,-3492592548,1017049163,7351.387925,3125023151,312502315.1,20,58800,2691,1220,1221,1,1220,58800,1,1221,23.713246,0.707423581,0.708151383,59761.92576,152.3558952,1.595342067,99176.96361,0.602008244,0.001534031,1.78616E-05,0.000819001,0.020765659,197,35
D:1| T0: 0.10| T1: 515.00| I0: 350.0| I1: 75.0| WTP: 400000,1,0.096153846,515,400000,1,0.2,350,75,-3862089799,1707305064,6141.524935,3555013552,355501355.2,20,50388,2270,1020,1020,0,1020,50388,0,1020,18.8006689,0.494983278,0.494983278,65757.21873,177.0688963,1.179264214,99318.78997,0.661642656,0.00178094,1.37061E-05,0,0.020243718,214,40
D:1| T0: 0.10| T1: 515.00| I0: 350.0| I1: 75.0| WTP: 400000,1,0.096153846,515,400000,1,0.2,350,75,-1286251020,400145663,11803.58029,696072005.8,69607200.58,4,86942,3738,730,1961,1231,730,86942,1231,1961,245.9270833,3.723958333,10.078125,32762.4375,1214.723958,13.875,98577.98958,0.331264071,0.012196606,0.000140896,0.627740948,0.022555267,28,7
D:1| T0: 0.10| T1: 515.00| I0: 350.0| I1: 75.0| WTP: 400000,1,0.096153846,515,400000,1,0.2,350,75,-3920487793,1662654181,7141.20395,3563427596,356342759.6,22,59362,2695,1182,1186,4,1182,59362,4,1186,20.64299183,0.566939032,0.568824639,57812.27341,152.336895,1.308610937,99160.55688,0.582430797,0.001533932,1.49629E-05,0.003372681,0.019979111,228,40
D:1| T0: 0.10| T1: 515.00| I0: 350.0| I1: 75.0| WTP: 400000,1,0.096153846,515,400000,1,0.2,350,75,-1362182916,182136456,11380.26596,793169618,79316961.8,4,95282,4251,770,1890,1120,770,95282,1120,1890,282.1489362,4.037234043,9.909574468,37686.44149,1749.590426,14,98864.92021,0.378761919,0.017562797,0.000142007,0.592592593,0.019835856,27,8
D:1| T0: 0.10| T1: 515.00| I0: 350.0| I1: 75.0| WTP: 400000,1,0.096153846,515,400000,1,0.2,350,75,-4193963817,979575387,5851.83282,3901372176,390137217.6,22,47470,2139,972,972,0,972,47470,0,972,13.22525773,0.342783505,0.342783505,66300.75361,163.1969072,0.839175258,99318.96753,0.667184734,0.001641476,1.00643E-05,0,0.02047609,278,44
D:1| T0: 0.10| T1: 515.00| I0: 350.0| I1: 75.0| WTP: 400000,1,0.096153846,515,400000,1,0.2,350,75,-1414555815,2142525414,12519.76766,788567431.6,78856743.16,4,93670,3990,711,2080,1369,711,93670,1369,2080,256.7384615,3.523076923,10.48717949,45475.51282,1895.589744,14.17435897,98908.51282,0.456217912,0.019047371,0.000143821,0.658173077,0.022205615,28,8
D:1| T0: 0.10| T1: 515.00| I0: 350.0| I1: 75.0| WTP: 400000,1,0.096153846,515,400000,1,0.2,350,75,-1308353211,1464057597,10553.45839,780680291.3,78068029.13,4,83440,3665,765,1753,988,765,83440,988,1753,168.3247232,2.6900369,6.287822878,47638.99262,1154.653137,9.103321033,98981.90406,0.478795989,0.011598857,9.33721E-05,0.563605248,0.021010116,39,8
D:1| T0: 0.10| T1: 515.00| I0: 350.0| I1: 75.0| WTP: 400000,1,0.096153846,515,400000,1,0.2,350,75,-1363136256,364562610,11575.53304,784359603.8,78435960.38,4,90373,3854,667,1923,1256,667,90373,1256,1923,239.7939698,3.246231156,9.497487437,43443.79899,1533.854271,12.86432161,98892.47739,0.436426742,0.015401995,0.000130688,0.653146126,0.021278479,29,8
D:1| T0: 0.10| T1: 515.00| I0: 350.0| I1: 75.0| WTP: 400000,1,0.096153846,515,400000,1,0.2,350,75,-1378858728,40350784,11893.77738,784169859.3,78416985.93,4,90261,3748,686,1976,1290,686,90261,1290,1976,227.5502392,3.148325359,9.267942584,45322.52632,1657.406699,12.54545455,98905.97608,0.455083565,0.016649277,0.000127961,0.652834008,0.021892069,30,8
D:1| T0: 0.10| T1: 515.00| I0: 350.0| I1: 75.0| WTP: 400000,1,0.096153846,515,400000,1,0.2,350,75,-1265754340,804064356,9606.088596,785449910.1,78544991.01,4,84018,3843,543,1595,1052,543,84018,1052,1595,237.9466019,2.524271845,7.59223301,49044.34466,1179.524272,10.21359223,99108.40291,0.492538805,0.011823978,0.00010408,0.659561129,0.018984253,30,8
D:1| T0: 0.10| T1: 515.00| I0: 350.0| I1: 75.0| WTP: 400000,1,0.096153846,515,400000,1,0.2,350,75,-2226170089,2125493986,8288.796424,1811730268,181173026.8,12,62980,2658,1180,1377,197,1180,62980,197,1377,35.73786408,1.116504854,1.323624595,50710.35383,214.6979504,2.590075512,98915.02697,0.512039444,0.002162407,2.77467E-05,0.143064633,0.021864431,133,20
D:1| T0: 0.10| T1: 515.00| I0: 350.0| I1: 75.0| WTP: 400000,1,0.096153846,515,400000,1,0.2,350,75,-1238899457,23154253,9166.195974,780589658.5,78058965.85,4,78757,3560,713,1522,809,713,78757,809,1522,180.2627451,2.670588235,5.815686275,47154.9451,824.9607843,8.62745098,99039.89804,0.474417196,0.0082769,8.79372E-05,0.531537451,0.019325266,37,8
D:1| T0: 0.10| T1: 515.00| I0: 350.0| I1: 75.0| WTP: 400000,1,0.096153846,515,400000,1,0.2,350,75,-2678837364,1391367689,6965.232544,2330575737,233057573.7,14,53269,2397,1157,1157,0,1157,53269,0,1157,25.97071872,0.826974268,0.826974268,63304.69299,159.7346939,1.855368234,99217.7134,0.637534205,0.001607587,2.06332E-05,0,0.02171995,161,26
D:1| T0: 0.10| T1: 515.00| I0: 350.0| I1: 75.0| WTP: 400000,1,0.096153846,515,400000,1,0.2,350,75,-1552896132,574142276,8711.360882,1117328088,111732808.8,6,68260,3027,1028,1447,419,1028,68260,419,1447,58.45525903,1.489795918,2.128728414,45664.82418,492.7974882,3.739403454,98876.81319,0.460916927,0.004956339,3.90818E-05,0.289564616,0.021198359,91,12
D:1| T0: 0.10| T1: 515.00| I0: 350.0| I1: 75.0| WTP: 400000,1,0.096153846,515,400000,1,0.2,350,75,-4918919815,898736779,6255.368871,4606151371,460615137.1,26,49751,2157,1039,1039,0,1039,49751,0,1039,12.98367537,0.320895522,0.320895522,66427.44263,171.6338619,0.805037313,99299.26959,0.668498457,0.001727051,9.73818E-06,0,0.020884002,307,52
D:1| T0: 0.10| T1: 515.00| I0: 350.0| I1: 75.0| WTP: 400000,1,0.096153846,515,400000,1,0.2,350,75,-1592145177,346473503,9107.904737,1136749940,113674994,6,83659,3995,705,1512,807,705,83659,807,1512,187.6121673,2.558935361,5.593155894,47566.31939,1805.48289,8.281368821,99124.53992,0.477771188,0.018116781,8.4613E-05,0.533730159,0.018073369,38,12
D:1| T0: 0.10| T1: 515.00| I0: 350.0| I1: 75.0| WTP: 400000,1,0.096153846,515,400000,1,0.2,350,75,-1614837646,445552282,9771.244653,1126275413,112627541.3,6,74932,3334,1023,1623,600,1023,74932,600,1623,92.79039301,2.100436681,3.390829694,44598.56332,935.5764192,5.626637555,98843.41703,0.449686464,0.009411044,5.81305E-05,0.369685767,0.021659638,65,12
D:1| T0: 0.10| T1: 515.00| I0: 350.0| I1: 75.0| WTP: 400000,1,0.096153846,515,400000,1,0.2,350,75,-1357914148,911758476,11272.52828,794287734,79428773.4,4,92384,4221,734,1872,1138,734,92384,1138,1872,299.1277778,3.994444444,10.21111111,32892.38889,1436.666667,14.30555556,98743.08889,0.331642215,0.014415871,0.000145371,0.607905983,0.020263249,26,8
D:1| T0: 0.10| T1: 515.00| I0: 350.0| I1: 75.0| WTP: 400000,1,0.096153846,515,400000,1,0.2,350,75,-1381815226,1464197940,11687.88935,797420758.4,79742075.84,4,96108,4386,679,1941,1262,679,96108,1262,1941,277.2636816,3.278606965,9.527363184,38605.37313,2774.383085,12.90547264,98875.17413,0.387457565,0.027857109,0.000130907,0.650180319,0.020196029,29,8
D:1| T0: 0.10| T1: 515.00| I0: 350.0| I1: 75.0| WTP: 400000,1,0.096153846,515,400000,1,0.2,350,75,-2144976943,500405854,8397.253504,1725114268,172511426.8,10,63488,2732,1271,1395,124,1271,63488,124,1395,38.88786127,1.293641618,1.428901734,52241.42081,295.7109827,2.90867052,98963.54682,0.527145099,0.00297687,3.10022E-05,0.088888889,0.021973002,124,19
D:1| T0: 0.10| T1: 515.00| I0: 350.0| I1: 75.0| WTP: 400000,1,0.096153846,515,400000,1,0.2,350,75,-1367557469,772037341,11777.84409,778665265.1,77866526.51,4,84909,3608,627,1957,1330,627,84909,1330,1957,214.6699029,2.917475728,9.32038835,47682.80583,1350.533981,12.36893204,98881.03398,0.47935571,0.013564432,0.000125993,0.67961165,0.023048205,30,8
D:1| T0: 0.10| T1: 515.00| I0: 350.0| I1: 75.0| WTP: 400000,1,0.096153846,515,400000,1,0.2,350,75,-4159583754,1543158763,5238.054289,3897681040,389768104,22,44973,1937,870,870,0,870,44973,0,870,13.89254257,0.331767469,0.331767469,72296.12155,128.1197886,0.836758661,99462.45332,0.726526216,0.00128867,1.02558E-05,0,0.01934537,244,44
D:1| T0: 0.10| T1: 515.00| I0: 350.0| I1: 75.0| WTP: 400000,1,0.096153846,515,400000,1,0.2,350,75,-1456046314,1604932531,13319.00724,790095952.1,79009595.21,4,94892,4067,764,2213,1449,764,94892,1449,2213,253.65,3.76,10.935,33670.975,1394.895,14.74,98553.945,0.33912986,0.014029531,0.000149718,0.654767284,0.023321249,29,8
D:1| T0: 0.10| T1: 515.00| I0: 350.0| I1: 75.0| WTP: 400000,1,0.096153846,515,400000,1,0.2,350,75,-1368832810,539051477,11601.00889,788782365.3,78878236.53,4,91936,4058,718,1927,1209,718,91936,1209,1927,224.8883929,3.107142857,8.446428571,42742.0625,2343.183036,11.64285714,98910.42857,0.429129865,0.02354521,0.000118658,0.627400104,0.020960233,32,8
D:1| T0: 0.10| T1: 515.00| I0: 350.0| I1: 75.0| WTP: 400000,1,0.096153846,515,400000,1,0.2,350,75,-3583331347,1743124675,5882.392471,3289211724,328921172.4,22,47750,2137,977,977,0,977,47750,0,977,19.70926756,0.553064275,0.553064275,69944.49626,120.5635277,1.285500747,99397.45516,0.703197389,0.001212981,1.46644E-05,0,0.020460733,192,37
D:1| T0: 0.10| T1: 515.00| I0: 350.0| I1: 75.0| WTP: 400000,1,0.096153846,515,400000,1,0.2,350,75,-1902714697,1965983789,8728.905623,1466269416,146626941.6,8,67867,2932,1120,1450,330,1120,67867,330,1450,55.7202473,1.647604328,2.142194745,47688.49304,610.4250386,3.874806801,98911.63524,0.480975201,0.006140139,3.99464E-05,0.227586207,0.021365632,93,16
D:1| T0: 0.10| T1: 515.00| I0: 350.0| I1: 75.0| WTP: 400000,1,0.096153846,515,400000,1,0.2,350,75,-3252239099,516774280,7807.746962,2861851751,286185175.1,16,63051,2678,1273,1297,24,1273,63051,24,1297,17.81291391,0.566777042,0.578366446,49245.36921,223.1578366,1.28200883,98960.33499,0.497104266,0.002247279,1.4268E-05,0.018504241,0.020570649,258,32
D:1| T0: 0.10| T1: 515.00| I0: 350.0| I1: 75.0| WTP: 400000,1,0.096153846,515,400000,1,0.2,350,75,-998389498.6,86603142,11251.91933,435793532.2,43579353.22,2,88466,3815,624,1869,1245,624,88466,1245,1869,285.6569767,3.534883721,10.72674419,32496.5407,1333.540698,14.31976744,98668.77907,0.32826279,0.013375069,0.000145509,0.666131621,0.021126999,25,4
D:1| T0: 0.10| T1: 515.00| I0: 350.0| I1: 75.0| WTP: 400000,1,0.096153846,515,400000,1,0.2,350,75,-5666306703,1431870609,6997.018618,5316455772,531645577.2,30,59266,2621,1162,1162,0,1162,59266,0,1162,16.98819908,0.413545408,0.413545408,63210.5254,209.638276,1.000513084,99290.38327,0.636089055,0.002109926,1.19876E-05,0,0.01960652,279,60
D:1| T0: 0.10| T1: 515.00| I0: 350.0| I1: 75.0| WTP: 400000,1,0.096153846,515,400000,1,0.2,350,75,-1241929708,1592383984,9320.840289,775887694,77588769.4,4,75834,3394,816,1548,732,816,75834,732,1548,142.5348837,2.594684385,5.003322259,48621.0897,734.4053156,7.707641196,99004.48837,0.489411742,0.007375628,7.88586E-05,0.472868217,0.020413007,43,8
D:1| T0: 0.10| T1: 515.00| I0: 350.0| I1: 75.0| WTP: 400000,1,0.096153846,515,400000,1,0.2,350,75,-1525685022,1440183867,8176.73623,1116848210,111684821,6,67584,3004,1053,1358,305,1053,67584,305,1358,56.20637329,1.474962064,1.918057663,46558.82246,494.0622155,3.509863429,98949.02124,0.46969305,0.004968516,3.67834E-05,0.224594993,0.020093513,95,12
D:1| T0: 0.10| T1: 515.00| I0: 350.0| I1: 75.0| WTP: 400000,1,0.096153846,515,400000,1,0.2,350,75,-1888403916,1696510588,8499.729687,1463417431,146341743.1,8,65038,2772,1094,1412,318,1094,65038,318,1412,49.20114123,1.420827389,1.858773181,49760.97004,436.7974322,3.415121255,98930.56776,0.502040875,0.004394225,3.59543E-05,0.225212465,0.021710385,101,16
D:1| T0: 0.10| T1: 515.00| I0: 350.0| I1: 75.0| WTP: 400000,1,0.096153846,515,400000,1,0.2,350,75,-1377059077,895039877,11834.12517,785352818.9,78535281.89,4,89167,3768,700,1966,1266,700,89167,1266,1966,198.7037037,2.781893004,7.95473251,40717.83128,1933.230453,10.81893004,98795.68313,0.409387433,0.019434156,0.000110336,0.643947101,0.022048516,35,8
D:1| T0: 0.10| T1: 515.00| I0: 350.0| I1: 75.0| WTP: 400000,1,0.096153846,515,400000,1,0.2,350,75,-2265430852,129565953,9004.636664,1815199019,181519901.9,10,66524,2823,1253,1496,243,1253,66524,243,1496,38.05452563,1.264994547,1.521264995,45386.32279,512.2104689,2.895310796,98797.23119,0.458453647,0.005156351,3.01702E-05,0.162433155,0.022488125,130,20
D:1| T0: 0.10| T1: 515.00| I0: 350.0| I1: 75.0| WTP: 400000,1,0.096153846,515,400000,1,0.2,350,75,-2079317387,1902565669,7093.841058,1724625334,172462533.4,10,61964,2750,1056,1178,122,1056,61964,122,1178,38.34881087,1.032842582,1.164212911,52545.25028,270.3306908,2.346545866,99112.61268,0.529564482,0.002718502,2.54208E-05,0.103565365,0.019011039,127,19
D:1| T0: 0.10| T1: 515.00| I0: 350.0| I1: 75.0| WTP: 400000,1,0.096153846,515,400000,1,0.2,350,75,-5022043083,1984179288,8114.428447,4616321661,461632166.1,26,62503,2689,1347,1348,1,1347,62503,1,1348,16.13226744,0.47625969,0.476744186,56197.33527,228.8648256,1.122577519,99060.01744,0.566705051,0.002305609,1.31393E-05,0.00074184,0.021566965,295,52
D:1| T0: 0.10| T1: 515.00| I0: 350.0| I1: 75.0| WTP: 400000,1,0.096153846,515,400000,1,0.2,350,75,-1672883771,677377223,10776.64854,1134051344,113405134.4,6,84378,3760,982,1790,808,982,84378,808,1790,137.5146199,2.754385965,5.076023392,44094.5,2006.149123,7.964912281,98893.07018,0.443490911,0.020177447,8.15647E-05,0.451396648,0.021214061,48,12
D:1| T0: 0.10| T1: 515.00| I0: 350.0| I1: 75.0| WTP: 400000,1,0.096153846,515,400000,1,0.2,350,75,-1636446099,973583301,10114.98174,1130697012,113069701.2,6,83161,3652,1049,1680,631,1049,83161,631,1680,116.6813472,2.593264249,4.191709845,43396.62953,1753.088083,6.904145078,98924.07772,0.436575097,0.017627865,7.11207E-05,0.375595238,0.020201777,56,12
D:1| T0: 0.10| T1: 515.00| I0: 350.0| I1: 75.0| WTP: 400000,1,0.096153846,515,400000,1,0.2,350,75,-1856171829,781062938,7679.789883,1472182335,147218233.5,8,67209,3246,1026,1275,249,1026,67209,249,1275,49.92288557,1.143034826,1.446517413,45508.20274,385.210199,2.715174129,98990.48507,0.459033208,0.003873499,2.87656E-05,0.195294118,0.018970674,115,16
D:1| T0: 0.10| T1: 515.00| I0: 350.0| I1: 75.0| WTP: 400000,1,0.096153846,515,400000,1,0.2,350,75,-1955668869,338783425,9537.685585,1478784589,147878458.9,8,78335,3480,1117,1584,467,1117,78335,467,1584,112.8989637,2.764248705,3.917098446,51237.18135,1650.994819,6.821243523,99078.8057,0.515062453,0.016597431,7.03429E-05,0.294823232,0.020220846,56,16
D:1| T0: 0.10| T1: 515.00| I0: 350.0| I1: 75.0| WTP: 400000,1,0.096153846,515,400000,1,0.2,350,75,-5643287482,1027579040,6652.812436,5310646861,531064686.1,30,55501,2488,1105,1105,0,1105,55501,0,1105,15.06218145,0.400611621,0.400611621,61589.50204,211.5718654,0.966360856,99244.00917,0.620108558,0.002128756,1.13207E-05,0,0.019909551,280,60
D:1| T0: 0.10| T1: 515.00| I0: 350.0| I1: 75.0| WTP: 400000,1,0.096153846,515,400000,1,0.2,350,75,-1950862494,764973813,9559.780085,1472873489,147287348.9,8,73415,3145,1069,1588,519,1069,73415,519,1588,85.89699571,2.169527897,3.25751073,46979.78755,1074.948498,5.568669528,98901.34979,0.473453766,0.010810716,5.73582E-05,0.326826196,0.021630752,66,16
D:1| T0: 0.10| T1: 515.00| I0: 350.0| I1: 75.0| WTP: 400000,1,0.096153846,515,400000,1,0.2,350,75,-1636982850,1245753446,10126.8896,1130638370,113063837,6,82957,3589,791,1682,891,791,82957,891,1682,146.1483871,2.432258065,5.270967742,44432.0129,1834.8,7.822580645,98945.21935,0.446895393,0.018438291,8.02072E-05,0.529726516,0.020275809,45,12
D:1| T0: 0.10| T1: 515.00| I0: 350.0| I1: 75.0| WTP: 400000,1,0.096153846,515,400000,1,0.2,350,75,-1558974130,1013177794,8890.602571,1114444001,111444400.1,6,67359,2884,1090,1477,387,1090,67359,387,1477,54.01221374,1.523664122,2.097709924,46385.86107,428.5923664,3.766412214,98854.17252,0.468359867,0.004312399,3.94282E-05,0.262017603,0.021927285,94,12
D:1| T0: 0.10| T1: 515.00| I0: 350.0| I1: 75.0| WTP: 400000,1,0.096153846,515,400000,1,0.2,350,75,-4254240850,1395089249,7053.049525,3901588374,390158837.4,22,49950,2062,1172,1172,0,1172,49950,0,1172,14.83625731,0.488888889,0.488888889,69612.15556,152.1988304,1.183040936,99289.8924,0.700534883,0.001532567,1.37803E-05,0,0.023463463,245,44
D:1| T0: 0.10| T1: 515.00| I0: 350.0| I1: 75.0| WTP: 400000,1,0.096153846,515,400000,1,0.2,350,75,-4498857231,1339545835,5104.391361,4243637663,424363766.3,24,39872,1691,848,848,0,848,39872,0,848,9.435389464,0.227375056,0.227375056,75936.53489,136.2210716,0.612787033,99491.78748,0.762889066,0.001369929,7.66522E-06,0,0.021268058,318,48
D:1| T0: 0.10| T1: 515.00| I0: 350.0| I1: 75.0| WTP: 400000,1,0.096153846,515,400000,1,0.2,350,75,-1332052832,219139554,10832.89656,790408004.2,79040800.42,4,90154,4019,758,1799,1041,758,90154,1041,1799,289.5,4.191011236,9.938202247,41275.98315,1331.713483,14.19101124,98921.76404,0.415222809,0.01335809,0.000144089,0.578654808,0.019954744,26,8
D:1| T0: 0.10| T1: 515.00| I0: 350.0| I1: 75.0| WTP: 400000,1,0.096153846,515,400000,1,0.2,350,75,-2463741040,1336508942,7813.837671,2073049157,207304915.7,12,60084,2600,1274,1298,24,1274,60084,24,1298,34.49036403,1.158458244,1.184154176,59403.44111,258.3479657,2.555674518,99144.63169,0.598483821,0.002599489,2.76875E-05,0.018489985,0.021603089,134,23
D:1| T0: 0.10| T1: 515.00| I0: 350.0| I1: 75.0| WTP: 400000,1,0.096153846,515,400000,1,0.2,350,75,-5271783372,448559423,6474.779499,4948044397,494804439.7,28,42418,1763,1076,1076,0,1076,42418,0,1076,11.84040297,0.397136797,0.397136797,73520.59544,173.6648993,0.953340403,99338.71792,0.739655482,0.001747667,1.1466E-05,0,0.02536659,270,56
D:1| T0: 0.10| T1: 515.00| I0: 350.0| I1: 75.0| WTP: 400000,1,0.096153846,515,400000,1,0.2,350,75,-1911483973,2110028840,8879.417722,1467513087,146751308.7,8,69517,3061,1230,1475,245,1230,69517,245,1475,51.83779972,1.576868829,1.902679831,47762.10014,479.5430183,3.631875882,98924.52186,0.481801812,0.004825597,3.83819E-05,0.166101695,0.021217832,102,16
D:1| T0: 0.10| T1: 515.00| I0: 350.0| I1: 75.0| WTP: 400000,1,0.096153846,515,400000,1,0.2,350,75,-1967411288,1982030155,9996.479795,1467587298,146758729.8,8,71617,2963,1139,1661,522,1139,71617,522,1661,88.08192771,2.621686747,3.848192771,52236.53012,1148.144578,6.590361446,98944.50602,0.526119546,0.01155041,6.78709E-05,0.314268513,0.023192817,60,16
D:1| T0: 0.10| T1: 515.00| I0: 350.0| I1: 75.0| WTP: 400000,1,0.096153846,515,400000,1,0.2,350,75,-1494538539,696219407,9258.390737,1031619002,103161900.2,6,70261,3097,714,1538,824,714,70261,824,1538,126.9605263,2.220394737,4.904605263,54283.64803,771.1151316,7.236842105,99049.41118,0.546300187,0.007742379,7.43982E-05,0.535760728,0.021889811,44,11
D:1| T0: 0.10| T1: 515.00| I0: 350.0| I1: 75.0| WTP: 400000,1,0.096153846,515,400000,1,0.2,350,75,-1324873222,1402539442,10665.09851,791618296.9,79161829.69,4,93537,4147,701,1771,1070,701,93537,1070,1771,257.9359606,3.359605911,8.586206897,42599.54187,2112.738916,12.03448276,99011.71921,0.427492934,0.021198924,0.000122191,0.60417843,0.018933684,29,8
D:1| T0: 0.10| T1: 515.00| I0: 350.0| I1: 75.0| WTP: 400000,1,0.096153846,515,400000,1,0.2,350,75,-1702737195,1319833493,11276.57542,1138908424,113890842.4,6,88725,3972,714,1873,1159,714,88725,1159,1873,196.827451,2.701960784,7.207843137,40723.70196,2354.388235,9.992156863,98841.07059,0.40941903,0.023663899,0.00010201,0.61879338,0.021110172,37,12
D:1| T0: 0.10| T1: 515.00| I0: 350.0| I1: 75.0| WTP: 400000,1,0.096153846,515,400000,1,0.2,350,75,-2563486737,663608076,7995.005173,2163736478,216373647.8,12,62055,2727,1207,1328,121,1207,62055,121,1328,33.84577114,1.061691542,1.178109453,50347.89254,373.2656716,2.371144279,98957.32637,0.508088395,0.003755797,2.53668E-05,0.091114458,0.021400371,144,24
D:1| T0: 0.10| T1: 515.00| I0: 350.0| I1: 75.0| WTP: 400000,1,0.096153846,515,400000,1,0.2,350,75,-2505365861,414696500,6900.859613,2160322880,216032288,12,56903,2518,1137,1146,9,1137,56903,9,1146,25.71485306,0.752978554,0.760921366,56637.3193,312.6306593,1.660841938,99135.25814,0.570703815,0.003144114,1.8223E-05,0.007853403,0.020140244,179,24
D:1| T0: 0.10| T1: 515.00| I0: 350.0| I1: 75.0| WTP: 400000,1,0.096153846,515,400000,1,0.2,350,75,-3221971904,1249738535,7390.323771,2852455715,285245571.5,16,51733,2155,1228,1228,0,1228,51733,0,1228,20.92163009,0.764106583,0.764106583,68305.46944,162.830721,1.735893417,99242.21003,0.687657464,0.001639723,1.93512E-05,0,0.023737266,183,32
D:1| T0: 0.10| T1: 515.00| I0: 350.0| I1: 75.0| WTP: 400000,1,0.096153846,515,400000,1,0.2,350,75,-2197090595,614415382,7729.944272,1810593381,181059338.1,10,59012,2604,1244,1284,40,1244,59012,40,1284,33.97283177,1.13061651,1.175548589,56600.69383,389.8171369,2.469174504,99075.22362,0.570515045,0.003921616,2.65585E-05,0.031152648,0.021758655,137,20
D:1| T0: 0.10| T1: 515.00| I0: 350.0| I1: 75.0| WTP: 400000,1,0.096153846,515,400000,1,0.2,350,75,-4542252344,524899953,5732.932996,4255605694,425560569.4,24,49316,2261,952,952,0,952,49316,0,952,16.25524476,0.393356643,0.393356643,66831.09965,166.0582751,0.943473193,99354.69755,0.672228212,0.001670283,1.11421E-05,0,0.01930408,246,48
D:1| T0: 0.10| T1: 515.00| I0: 350.0| I1: 75.0| WTP: 400000,1,0.096153846,515,400000,1,0.2,350,75,-1298416506,1338977757,11848.84101,705974455.5,70597445.55,4,93037,4177,742,1968,1226,742,93037,1226,1968,246.6805556,3.384259259,9,30919.31944,1130.555556,12.43518519,98616.37963,0.311861299,0.011361959,0.000126125,0.62296748,0.021152875,31,7
D:1| T0: 0.10| T1: 515.00| I0: 350.0| I1: 75.0| WTP: 400000,1,0.096153846,515,400000,1,0.2,350,75,-1591392250,341384587,9462.256,1118279450,111827945,6,71935,3085,865,1572,707,865,71935,707,1572,64.07445008,1.304568528,2.485617597,41714.67174,415.0203046,3.947546531,98747.12521,0.421626689,0.004177007,4.15014E-05,0.449745547,0.021853366,85,12
D:1| T0: 0.10| T1: 515.00| I0: 350.0| I1: 75.0| WTP: 400000,1,0.096153846,515,400000,1,0.2,350,75,-1939928387,2032000160,9355.371822,1472159796,147215979.6,8,73150,3178,1100,1554,454,1100,73150,454,1554,92.42757009,2.453271028,3.478971963,48971.89019,1159.079439,6.039719626,98962.89019,0.493264602,0.011655925,6.23514E-05,0.292149292,0.021244019,62,16
D:1| T0: 0.10| T1: 515.00| I0: 350.0| I1: 75.0| WTP: 400000,1,0.096153846,515,400000,1,0.2,350,75,-1397049287,779488939,12224.57154,785820710.3,78582071.03,4,91732,3912,625,2031,1406,625,91732,1406,2031,228.8679245,2.844339623,9.438679245,44968.23113,1638.759434,12.38207547,98888.78302,0.451296361,0.016466312,0.000125932,0.692269818,0.022140583,31,8
D:1| T0: 0.10| T1: 515.00| I0: 350.0| I1: 75.0| WTP: 400000,1,0.096153846,515,400000,1,0.2,350,75,-2244564411,1449019578,8655.180538,1811805384,181180538.4,10,63798,2665,1335,1438,103,1335,63798,103,1438,32.52169625,1.140039448,1.237672584,52205.38363,390.8619329,2.551282051,98937.75542,0.526853522,0.003935021,2.75182E-05,0.07162726,0.022539892,144,20
D:1| T0: 0.10| T1: 515.00| I0: 350.0| I1: 75.0| WTP: 400000,1,0.096153846,515,400000,1,0.2,350,75,-4096198318,351952211,5541.286942,3819133971,381913397.1,22,49504,2299,920,920,0,920,49504,0,920,15.26293779,0.309984318,0.309984318,67540.83743,114.7036069,0.807109252,99391.02352,0.679129787,0.001154397,9.65773E-06,0,0.018584357,274,43
D:1| T0: 0.10| T1: 515.00| I0: 350.0| I1: 75.0| WTP: 400000,1,0.096153846,515,400000,1,0.2,350,75,-3229707763,486595046,7440.078752,2857703825,285770382.5,16,57827,2468,1223,1236,13,1223,57827,13,1236,16.02847931,0.536270822,0.543256314,52880.67706,256.8581408,1.206878023,99002.81139,0.533567014,0.002585236,1.32881E-05,0.010517799,0.021374468,264,32
D:1| T0: 0.10| T1: 515.00| I0: 350.0| I1: 75.0| WTP: 400000,1,0.096153846,515,400000,1,0.2,350,75,-1825607656,296745624,8891.755235,1381019894,138101989.4,8,71097,3074,991,1477,486,991,71097,486,1477,69.36095764,1.703499079,2.572744015,44953.53591,642.8213628,4.405156538,98891.53223,0.45344578,0.006463983,4.57015E-05,0.329045362,0.020774435,78,15
D:1| T0: 0.10| T1: 515.00| I0: 350.0| I1: 75.0| WTP: 400000,1,0.096153846,515,400000,1,0.2,350,75,-3183909971,1671484194,6538.949532,2856962495,285696249.5,16,54922,2442,1083,1086,3,1083,54922,3,1086,20.48247423,0.572508591,0.573883162,60581.5945,194.3168385,1.314776632,99220.55189,0.61017919,0.00195495,1.49781E-05,0.002764977,0.019755289,208,32
D:1| T0: 0.10| T1: 515.00| I0: 350.0| I1: 75.0| WTP: 400000,1,0.096153846,515,400000,1,0.2,350,75,-1400656959,422157396,12131.22765,794095577.1,79409557.71,4,96591,4263,730,2015,1285,730,96591,1285,2015,303.9602273,4.085227273,11.3125,36754.43182,2040.965909,15.46022727,98801.69318,0.369351593,0.02049057,0.000156608,0.637717122,0.020861157,26,8
D:1| T0: 0.10| T1: 515.00| I0: 350.0| I1: 75.0| WTP: 400000,1,0.096153846,515,400000,1,0.2,350,75,-1402373523,1916599091,12202.70418,792238313.8,79223831.38,4,94779,4116,740,2027,1287,740,94779,1287,2027,278.4787234,3.877659574,10.63297872,35077.48936,1759.478723,14.56382979,98720.57979,0.353014342,0.017671537,0.000147862,0.634928466,0.021386594,27,8
D:1| T0: 0.10| T1: 515.00| I0: 350.0| I1: 75.0| WTP: 400000,1,0.096153846,515,400000,1,0.2,350,75,-1394522098,1005953941,12016.98896,793672650.1,79367265.01,4,96439,4253,739,1996,1257,739,96439,1257,1996,300.8587571,4.107344633,11.1299435,35529.49153,2208.711864,15.31638418,98792.36723,0.357169885,0.022171188,0.000155156,0.629759519,0.020697021,26,8
D:1| T0: 0.10| T1: 515.00| I0: 350.0| I1: 75.0| WTP: 400000,1,0.096153846,515,400000,1,0.2,350,75,-1351808627,1422765615,11418.30215,780893519.3,78089351.93,4,84828,3612,733,1897,1164,733,84828,1164,1897,138.1939394,2.115151515,5.615151515,35722.34242,890.2272727,7.851515152,98624.77576,0.360262854,0.008957915,8.01868E-05,0.613600422,0.022362899,48,8
D:1| T0: 0.10| T1: 515.00| I0: 350.0| I1: 75.0| WTP: 400000,1,0.096153846,515,400000,1,0.2,350,75,-4228123661,699740192,6524.677461,3901889787,390188978.7,22,47875,1996,1084,1084,0,1084,47875,0,1084,16.47122762,0.493606138,0.493606138,73489.03133,183.2525575,1.186061381,99419.09399,0.738662547,0.00184361,1.39285E-05,0,0.022642298,224,44
D:1| T0: 0.10| T1: 515.00| I0: 350.0| I1: 75.0| WTP: 400000,1,0.096153846,515,400000,1,0.2,350,75,-4883601785,240885764,5647.154947,4601244038,460124403.8,26,46925,2119,938,938,0,938,46925,0,938,11.74084507,0.275586854,0.275586854,69845.83099,134.5915493,0.710798122,99410.97746,0.702175877,0.001353941,8.84481E-06,0,0.019989345,305,52
D:1| T0: 0.10| T1: 515.00| I0: 350.0| I1: 75.0| WTP: 400000,1,0.096153846,515,400000,1,0.2,350,75,-1581553720,2023806564,9122.285902,1125439425,112543942.5,6,76148,3443,814,1515,701,814,76148,701,1515,91.77223427,1.650759219,3.15835141,39103.4859,691.2494577,4.934924078,98828.77007,0.394598588,0.006949047,5.07944E-05,0.462706271,0.019895989,66,12
D:1| T0: 0.10| T1: 515.00| I0: 350.0| I1: 75.0| WTP: 400000,1,0.096153846,515,400000,1,0.2,350,75,-3557687725,1907493879,7042.767173,3205549367,320554936.7,18,53151,2268,1170,1170,0,1170,53151,0,1170,16.79456907,0.522432113,0.522432113,61118.89315,196.4191263,1.216646989,99155.99055,0.615907552,0.00197704,1.38864E-05,0,0.022012756,241,36
D:1| T0: 0.10| T1: 515.00| I0: 350.0| I1: 75.0| WTP: 400000,1,0.096153846,515,400000,1,0.2,350,75,-2006116322,1565815291,10623.41755,1474945445,147494544.5,8,76751,3304,1108,1765,657,1108,76751,657,1765,121.8869048,3.175595238,5.077380952,53762.17857,1840.910714,8.375,99013.96131,0.540680734,0.018513514,8.60053E-05,0.37223796,0.022996443,48,16
D:1| T0: 0.10| T1: 515.00| I0: 350.0| I1: 75.0| WTP: 400000,1,0.096153846,515,400000,1,0.2,350,75,-4205690363,784442364,6009.252836,3905227721,390522772.1,22,50954,2269,998,998,0,998,50954,0,998,17.99034749,0.451093951,0.451093951,69793.39575,173.1589447,1.092664093,99417.48198,0.701555278,0.001741625,1.29003E-05,0,0.019586294,221,44
D:1| T0: 0.10| T1: 515.00| I0: 350.0| I1: 75.0| WTP: 400000,1,0.096153846,515,400000,1,0.2,350,75,-1328696419,206369745,10808.1209,788290373.8,78829037.38,4,89831,3978,651,1795,1144,651,89831,1144,1795,221.8854626,2.748898678,7.735682819,43566.67401,1652.828194,10.59911894,98966.01322,0.437483646,0.016592473,0.000108216,0.637325905,0.019981966,33,8
D:1| T0: 0.10| T1: 515.00| I0: 350.0| I1: 75.0| WTP: 400000,1,0.096153846,515,400000,1,0.2,350,75,-1399854953,2087235992,12154.60119,792124894.1,79212489.41,4,96085,4163,716,2019,1303,716,96085,1303,2019,244.4439252,3.271028037,9.299065421,35212.33178,1958.341121,12.64485981,98751.13084,0.353717758,0.019681409,0.000128441,0.645368995,0.021012645,31,8
D:1| T0: 0.10| T1: 515.00| I0: 350.0| I1: 75.0| WTP: 400000,1,0.096153846,515,400000,1,0.2,350,75,-1888918648,1019092536,8428.974663,1467469915,146746991.5,8,68486,3012,1175,1400,225,1175,68486,225,1400,47.73514212,1.351421189,1.630490956,47432.21189,489.2596899,3.147286822,98953.3553,0.478391663,0.004922074,3.34598E-05,0.160714286,0.020442433,111,16
D:1| T0: 0.10| T1: 515.00| I0: 350.0| I1: 75.0| WTP: 400000,1,0.096153846,515,400000,1,0.2,350,75,-1516146340,1885906113,8126.405233,1109826079,110982607.9,6,62004,2636,1026,1350,324,1026,62004,324,1350,66.26868687,1.884848485,2.525252525,53878.5596,383.0848485,4.612121212,99027.85657,0.543218206,0.00385044,4.82333E-05,0.24,0.021774545,71,12
D:1| T0: 0.10| T1: 515.00| I0: 350.0| I1: 75.0| WTP: 400000,1,0.096153846,515,400000,1,0.2,350,75,-3960628633,2028637200,7839.590437,3568649111,356864911.1,22,63664,2849,1301,1302,1,1301,63664,1,1302,26.38348083,0.755162242,0.755899705,57500.08997,182.2035398,1.730825959,99140.62611,0.57930228,0.001835076,1.93075E-05,0.000768049,0.020451761,194,40
D:1| T0: 0.10| T1: 515.00| I0: 350.0| I1: 75.0| WTP: 400000,1,0.096153846,515,400000,1,0.2,350,75,-1348419305,181476086,11216.21996,787608306.9,78760830.69,4,90943,4062,602,1863,1261,602,90943,1261,1863,222.6339286,2.558035714,8.147321429,41150.10714,1895.102679,10.85267857,98895.33036,0.413318973,0.019025792,0.000110546,0.676865271,0.020485359,32,8
D:1| T0: 0.10| T1: 515.00| I0: 350.0| I1: 75.0| WTP: 400000,1,0.096153846,515,400000,1,0.2,350,75,-1373254053,2097578470,11685.14698,788996704.4,78899670.44,4,89677,4071,709,1941,1232,709,89677,1232,1941,204.465587,2.761133603,7.71659919,39028.49798,1979.57085,10.57894737,98772.87449,0.392509754,0.019896899,0.00010786,0.634724369,0.021644346,36,8
D:1| T0: 0.10| T1: 515.00| I0: 350.0| I1: 75.0| WTP: 400000,1,0.096153846,515,400000,1,0.2,350,75,-1912530852,119646392,8909.355244,1467063090,146706309,8,66475,2877,1148,1480,332,1148,66475,332,1480,80.0372807,2.401315789,3.10745614,54870.66009,920.9802632,5.61622807,99036.08114,0.55261572,0.009258779,5.79312E-05,0.224324324,0.022264009,66,16
D:1| T0: 0.10| T1: 515.00| I0: 350.0| I1: 75.0| WTP: 400000,1,0.096153846,515,400000,1,0.2,350,75,-1370247682,1298895859,11601.48818,790173272.4,79017327.24,4,93306,4115,776,1927,1151,776,93306,1151,1927,241.3113208,3.566037736,8.938679245,37637.36321,1834.410377,12.61320755,98806.64151,0.378343302,0.018428409,0.000128055,0.597301505,0.020652477,31,8
D:1| T0: 0.10| T1: 515.00| I0: 350.0| I1: 75.0| WTP: 400000,1,0.096153846,515,400000,1,0.2,350,75,-1281086956,1489316290,10024.69192,779852360.3,77985236.03,4,79345,3565,660,1665,1005,660,79345,1005,1665,180.0277778,2.492063492,6.44047619,46518.76587,1094.714286,9.075396825,98935.94841,0.468242795,0.010993592,9.26423E-05,0.603603604,0.020984309,36,8
D:1| T0: 0.10| T1: 515.00| I0: 350.0| I1: 75.0| WTP: 400000,1,0.096153846,515,400000,1,0.2,350,75,-1452302520,855602142,13311.86476,786709281.5,78670928.15,4,96804,3861,655,2212,1557,655,96804,1557,2212,211.2857143,2.761904762,9.454545455,32627.65368,1496.593074,12.29004329,98553.32468,0.327857515,0.015056015,0.000124876,0.703887884,0.022850295,33,8
D:1| T0: 0.10| T1: 515.00| I0: 350.0| I1: 75.0| WTP: 400000,1,0.096153846,515,400000,1,0.2,350,75,-1894139245,1438649896,8507.478514,1468765319,146876531.9,8,68900,3023,1031,1413,382,1031,68900,382,1413,67.20284698,1.722419929,2.393238434,47425.13879,623.475089,4.229537367,98950.07651,0.478202688,0.006269348,4.37207E-05,0.27034678,0.020507983,80,16
D:1| T0: 0.10| T1: 515.00| I0: 350.0| I1: 75.0| WTP: 400000,1,0.096153846,515,400000,1,0.2,350,75,-4978624815,952489126,7474.110567,4604919287,460491928.7,26,54345,2203,1242,1242,0,1242,54345,0,1242,13.66683831,0.452626159,0.452626159,64239.90062,214.3424305,1.083419156,99200.48095,0.647009671,0.002157902,1.28642E-05,0,0.022853988,278,52
D:1| T0: 0.10| T1: 515.00| I0: 350.0| I1: 75.0| WTP: 400000,1,0.096153846,515,400000,1,0.2,350,75,-1139908859,1550779155,10709.2349,604447113.9,60444711.39,4,84344,3554,549,1779,1230,549,84344,1230,1779,228.5606061,2.666666667,8.833333333,31327.41919,1191.515152,11.61616162,98631.5101,0.317057843,0.011953381,0.00011807,0.691399663,0.021092194,29,6
D:1| T0: 0.10| T1: 515.00| I0: 350.0| I1: 75.0| WTP: 400000,1,0.096153846,515,400000,1,0.2,350,75,-4486829764,607323321,6440.574197,4164801054,416480105.4,24,49172,2092,1070,1070,0,1070,49172,0,1070,15.01810748,0.449182243,0.449182243,67510.30841,138.864486,1.072429907,99294.63376,0.679434199,0.001397982,1.25598E-05,0,0.021763007,245,47
D:1| T0: 0.10| T1: 515.00| I0: 350.0| I1: 75.0| WTP: 400000,1,0.096153846,515,400000,1,0.2,350,75,-1508441244,2103646485,7946.611489,1111110670,111111067,6,62287,2719,864,1320,456,864,62287,456,1320,63.35084428,1.491557223,2.335834897,50390.0863,351.3320826,3.943714822,98970.16135,0.508481349,0.003531716,4.11747E-05,0.345454545,0.021192223,77,12
D:1| T0: 0.10| T1: 515.00| I0: 350.0| I1: 75.0| WTP: 400000,1,0.096153846,515,400000,1,0.2,350,75,-1276594682,258120157,9822.37854,785475755,78547575.5,4,86451,3878,766,1631,865,766,86451,865,1631,245.9393939,3.782828283,8.075757576,35194.74242,1110.146465,11.93939394,98852.54545,0.355139236,0.011134346,0.000121481,0.530349479,0.018866179,29,8
D:1| T0: 0.10| T1: 515.00| I0: 350.0| I1: 75.0| WTP: 400000,1,0.096153846,515,400000,1,0.2,350,75,-2884812702,1068951401,7430.109263,2513307239,251330723.9,16,61816,2790,1199,1234,35,1199,61816,35,1234,31.12615955,0.948979592,0.981447124,54442.06772,223.4183673,2.08812616,99104.53061,0.548738679,0.002248184,2.26887E-05,0.028363047,0.019962469,154,28
D:1| T0: 0.10| T1: 515.00| I0: 350.0| I1: 75.0| WTP: 400000,1,0.096153846,515,400000,1,0.2,350,75,-2213380924,635956235,8012.909379,1812735455,181273545.5,10,61976,2736,1223,1331,108,1223,61976,108,1331,28.34062237,0.923465097,1.015138772,48376.36838,396.2842725,2.047098402,98906.68966,0.488402099,0.003987702,2.1605E-05,0.081141998,0.021476055,169,20
D:1| T0: 0.10| T1: 515.00| I0: 350.0| I1: 75.0| WTP: 400000,1,0.096153846,515,400000,1,0.2,350,75,-4367410086,1346693470,5845.347213,4075142726,407514272.6,24,47491,2025,971,971,0,971,47491,0,971,15.22982132,0.414048059,0.414048059,73006.16143,150.3610598,1.007393715,99452.29945,0.733644919,0.001512532,1.20164E-05,0,0.02044684,232,46
D:1| T0: 0.10| T1: 515.00| I0: 350.0| I1: 75.0| WTP: 400000,1,0.096153846,515,400000,1,0.2,350,75,-1436811384,847102011,12905.10747,791556010.2,79155601.02,4,96205,4107,751,2144,1393,751,96205,1393,2144,273.8465608,3.899470899,11.17989418,35680.60317,1746.306878,15.15873016,98687.22751,0.35874908,0.017551088,0.000153949,0.649720149,0.022285744,27,8
D:1| T0: 0.10| T1: 515.00| I0: 350.0| I1: 75.0| WTP: 400000,1,0.096153846,515,400000,1,0.2,350,75,-1714735427,812083272,11705.96907,1129436974,112943697.4,6,83229,3514,929,1945,1016,929,83229,1016,1945,144.9046053,2.927631579,6.226973684,47286.86513,1685.930921,9.289473684,98850.78289,0.475603073,0.016966441,9.51709E-05,0.522365039,0.023369258,44,12
D:1| T0: 0.10| T1: 515.00| I0: 350.0| I1: 75.0| WTP: 400000,1,0.096153846,515,400000,1,0.2,350,75,-1329200586,2146825809,10784.68261,789966455.8,78996645.58,4,92017,4213,791,1791,1000,791,92017,1000,1791,304.4285714,4.642857143,10.5,37555.85714,1728.714286,15.19642857,98890.13095,0.378191999,0.017334485,0.000154162,0.558347292,0.019463795,24,8
D:1| T0: 0.10| T1: 515.00| I0: 350.0| I1: 75.0| WTP: 400000,1,0.096153846,515,400000,1,0.2,350,75,-1422160518,226186520,12664.04666,788958184.6,78895818.46,4,95343,4023,741,2104,1363,741,95343,1363,2104,260.0829016,3.797927461,10.79274611,37185.46114,1436.834197,14.62176166,98720.09845,0.373754352,0.014436702,0.00014812,0.647813688,0.022067692,28,8
D:1| T0: 0.10| T1: 515.00| I0: 350.0| I1: 75.0| WTP: 400000,1,0.096153846,515,400000,1,0.2,350,75,-1671403457,1110225441,10793.9403,1131706442,113170644.2,6,83782,3620,1052,1793,741,1052,83782,741,1793,109.9299517,2.446859903,4.200483092,41402.09903,1563.417874,6.734299517,98811.07971,0.416752734,0.015736354,6.91861E-05,0.413273843,0.021400778,60,12
D:1| T0: 0.10| T1: 515.00| I0: 350.0| I1: 75.0| WTP: 400000,1,0.096153846,515,400000,1,0.2,350,75,-1549218757,1190767082,8438.31671,1127302922,112730292.2,6,76949,3602,948,1401,453,948,76949,453,1401,118.9835616,2.449315068,3.660273973,47656.75068,1125.112329,6.265753425,99097.87671,0.479408559,0.011297258,6.46439E-05,0.323340471,0.018206864,53,12
D:1| T0: 0.10| T1: 515.00| I0: 350.0| I1: 75.0| WTP: 400000,1,0.096153846,515,400000,1,0.2,350,75,-2523168635,2108234095,7379.33451,2154201909,215420190.9,12,55307,2298,1168,1226,58,1168,55307,58,1226,29.39481865,1.050777202,1.107772021,57664.53057,350.4601036,2.32746114,99077.42798,0.581402941,0.003524371,2.49354E-05,0.04730832,0.022167978,138,24
D:1| T0: 0.10| T1: 515.00| I0: 350.0| I1: 75.0| WTP: 400000,1,0.096153846,515,400000,1,0.2,350,75,-1427185703,465621985,12659.72959,794199223.5,79419922.35,4,95321,4277,739,2103,1364,739,95321,1364,2103,254.4666667,3.428571429,9.880952381,29536.09524,1563.871429,13.39047619,98550.21429,0.297670185,0.015724434,0.000136115,0.648597242,0.022062295,30,8
D:1| T0: 0.10| T1: 515.00| I0: 350.0| I1: 75.0| WTP: 400000,1,0.096153846,515,400000,1,0.2,350,75,-2130774259,1487072553,8014.512928,1730048612,173004861.2,10,65324,2966,1226,1331,105,1226,65324,105,1331,42.99532164,1.281871345,1.4,52374.34035,274.3122807,2.824561404,99032.90994,0.528151909,0.002761007,3.00732E-05,0.078888054,0.02037536,123,19
D:1| T0: 0.10| T1: 515.00| I0: 350.0| I1: 75.0| WTP: 400000,1,0.096153846,515,400000,1,0.2,350,75,-1585188215,1213733847,9300.804262,1120148002,112014800.2,6,70532,3040,894,1545,651,894,70532,651,1545,119.8707692,2.618461538,4.593846154,51998.73538,921.44,7.335384615,99000.21846,0.523719141,0.009257401,7.54013E-05,0.421359223,0.021904951,47,12
D:1| T0: 0.10| T1: 515.00| I0: 350.0| I1: 75.0| WTP: 400000,1,0.096153846,515,400000,1,0.2,350,75,-1284823097,2003658337,10197.28708,774958743.2,77495874.32,4,78538,3342,749,1694,945,749,78538,945,1694,140.7766667,2.353333333,5.473333333,47004.39,1069.653333,7.96,98919.34667,0.473175567,0.010748333,8.18436E-05,0.55785124,0.021570001,43,8
D:1| T0: 0.10| T1: 515.00| I0: 350.0| I1: 75.0| WTP: 400000,1,0.096153846,515,400000,1,0.2,350,75,-5288054123,1170868072,6651.28832,4955489707,495548970.7,28,52983,2269,1105,1105,0,1105,52983,0,1105,12.87302348,0.352180163,0.352180163,66976.93292,147.5701965,0.877815046,99330.60278,0.673788228,0.001485473,1.06431E-05,0,0.020855746,299,56
D:1| T0: 0.10| T1: 515.00| I0: 350.0| I1: 75.0| WTP: 400000,1,0.096153846,515,400000,1,0.2,350,75,-1335608429,569919592,10946.28814,788294021.8,78829402.18,4,90824,4024,754,1818,1064,754,90824,1064,1818,264.0842105,3.878947368,9.410526316,31576.06316,1246.510526,13.38947368,98725.11053,0.318722427,0.012508754,0.000135951,0.585258526,0.020016736,28,8
D:1| T0: 0.10| T1: 515.00| I0: 350.0| I1: 75.0| WTP: 400000,1,0.096153846,515,400000,1,0.2,350,75,-1536052886,1833180623,8233.200098,1124392881,112439288.1,6,73609,3467,1010,1367,357,1010,73609,357,1367,94.02031603,2.119638826,2.898419865,46665.58916,775.4740406,5.162528217,99053.39278,0.469996077,0.007789716,5.39094E-05,0.261155816,0.018571099,64,12
D:1| T0: 0.10| T1: 515.00| I0: 350.0| I1: 75.0| WTP: 400000,1,0.096153846,515,400000,1,0.2,350,75,-1449906411,1123666637,13169.32017,791440402.2,79144040.22,4,93680,4045,755,2188,1433,755,93680,1433,2188,305.5621302,4.384615385,12.77514793,40612.14201,1667.100592,17.24260355,98739.3432,0.408409567,0.01674863,0.000174963,0.654936015,0.023356106,25,8
D:1| T0: 0.10| T1: 515.00| I0: 350.0| I1: 75.0| WTP: 400000,1,0.096153846,515,400000,1,0.2,350,75,-1704109548,1682024981,11412.92154,1133463471,113346347.1,6,89643,3842,764,1896,1132,764,89643,1132,1896,188.3951613,2.943548387,7.475806452,45053.7621,2954.197581,10.55241935,98945.47581,0.452364142,0.029691437,0.000107839,0.597046414,0.021150564,35,12
D:1| T0: 0.10| T1: 515.00| I0: 350.0| I1: 75.0| WTP: 400000,1,0.096153846,515,400000,1,0.2,350,75,-1614347386,1687523543,9853.780441,1121658364,112165836.4,6,73916,3191,910,1637,727,910,73916,727,1637,121.412844,2.660550459,4.856269113,51852.32722,863.6544343,7.617737003,98992.85015,0.521887287,0.008680329,7.82927E-05,0.44410507,0.02214736,47,12
D:1| T0: 0.10| T1: 515.00| I0: 350.0| I1: 75.0| WTP: 400000,1,0.096153846,515,400000,1,0.2,350,75,-1345635842,178034412,11156.26963,787822360.1,78782236.01,4,88629,4029,653,1853,1200,653,88629,1200,1853,261.5811518,3.287958115,9.523560209,46469.73822,1635.806283,12.93717277,98981.01571,0.466733283,0.016413064,0.000131658,0.647598489,0.020907378,28,8
D:1| T0: 0.10| T1: 515.00| I0: 350.0| I1: 75.0| WTP: 400000,1,0.096153846,515,400000,1,0.2,350,75,-1343632261,739490003,11055.20661,790871930.9,79087193.09,4,91593,4084,689,1836,1147,689,91593,1147,1836,260.4773869,3.376884422,9.085427136,41796.68844,1289.628141,12.54271357,98924.0804,0.419874794,0.012941805,0.00012734,0.624727669,0.0200452,29,8
D:1| T0: 0.10| T1: 515.00| I0: 350.0| I1: 75.0| WTP: 400000,1,0.096153846,515,400000,1,0.2,350,75,-1632749712,178482706,10255.52932,1119973245,111997324.5,6,73756,3058,723,1704,981,723,73756,981,1704,125.6019417,2.223300971,5.365695793,48541.16828,1021.236246,7.699029126,98876.09385,0.489142598,0.010260109,7.89631E-05,0.576042278,0.023089647,45,12
D:1| T0: 0.10| T1: 515.00| I0: 350.0| I1: 75.0| WTP: 400000,1,0.096153846,515,400000,1,0.2,350,75,-1604761086,1919366370,9708.888994,1119316637,111931663.7,6,69705,3015,869,1613,744,869,69705,744,1613,107.1815642,2.312849162,4.37150838,50930.91341,672.2513966,6.787709497,98908.24302,0.513376182,0.006758993,6.96902E-05,0.461252325,0.023140377,52,12
D:1| T0: 0.10| T1: 515.00| I0: 350.0| I1: 75.0| WTP: 400000,1,0.096153846,515,400000,1,0.2,350,75,-1350194507,1819796913,11110.46298,794671358.1,79467135.81,4,96556,4424,693,1845,1152,693,96556,1152,1845,305.4971751,3.858757062,10.31638418,39525.46893,2242.305085,14.22033898,98959.40113,0.396708982,0.022489033,0.000143838,0.624390244,0.019108082,26,8
D:1| T0: 0.10| T1: 515.00| I0: 350.0| I1: 75.0| WTP: 400000,1,0.096153846,515,400000,1,0.2,350,75,-1687407474,1866591913,11129.97502,1130908723,113090872.3,6,83745,3646,1088,1849,761,1088,83745,761,1849,108.7070218,2.520581114,4.319612591,44543.16949,1673.42615,6.96125908,98850.49395,0.448054997,0.016843643,7.16161E-05,0.411573824,0.02207893,59,12
D:1| T0: 0.10| T1: 515.00| I0: 350.0| I1: 75.0| WTP: 400000,1,0.096153846,515,400000,1,0.2,350,75,-1369589293,1219425989,11619.00268,788639159.1,78863915.91,4,90583,4102,788,1930,1142,788,90583,1142,1930,291.6686047,4.488372093,11.04651163,34593.16279,1358.366279,15.62209302,98721.4593,0.349013794,0.013630391,0.000158696,0.591709845,0.021306426,25,8
D:1| T0: 0.10| T1: 515.00| I0: 350.0| I1: 75.0| WTP: 400000,1,0.096153846,515,400000,1,0.2,350,75,-1375186767,502409586,11691.69309,790602112.6,79060211.26,4,94589,4132,740,1942,1202,740,94589,1202,1942,234.9086758,3.292237443,8.716894977,35365.22374,1740.424658,12.12328767,98775.38813,0.355504956,0.017480772,0.000123025,0.618949537,0.020530929,32,8
D:1| T0: 0.10| T1: 515.00| I0: 350.0| I1: 75.0| WTP: 400000,1,0.096153846,515,400000,1,0.2,350,75,-1298231005,1405887957,10390.66199,778697905.8,77869790.58,4,81475,3596,731,1726,995,731,81475,995,1726,190.7467811,3.017167382,7.253218884,47510.91416,1061.261803,10.39484979,98959.02575,0.477923174,0.010656147,0.000105861,0.576477404,0.021184412,34,8
D:1| T0: 0.10| T1: 515.00| I0: 350.0| I1: 75.0| WTP: 400000,1,0.096153846,515,400000,1,0.2,350,75,-1310750888,283033753,10772.86618,772107578.5,77210757.85,4,78441,3243,736,1790,1054,736,78441,1054,1790,159.4703557,2.754940711,6.865612648,46613.99605,821.6679842,9.794466403,98849.01581,0.469582242,0.008255853,0.000100309,0.588826816,0.022819699,37,8
D:1| T0: 0.10| T1: 515.00| I0: 350.0| I1: 75.0| WTP: 400000,1,0.096153846,515,400000,1,0.2,350,75,-1631707308,1083157068,10178.47526,1122783545,112278354.5,6,75552,3236,1104,1691,587,1104,75552,587,1691,82.34836066,2.096311475,3.266393443,42607.33607,785.3504098,5.540983607,98773.31967,0.429969257,0.007901423,5.76564E-05,0.347131875,0.022381936,70,12
D:1| T0: 0.10| T1: 515.00| I0: 350.0| I1: 75.0| WTP: 400000,1,0.096153846,515,400000,1,0.2,350,75,-1575601853,1988704626,9315.465025,1109828602,110982860.2,6,64252,2684,1092,1548,456,1092,64252,456,1548,52.1364366,1.566613162,2.290529695,49615.64045,264.8988764,4.048154093,98808.39647,0.501301032,0.002667251,4.26434E-05,0.294573643,0.024092635,89,12
D:1| T0: 0.10| T1: 515.00| I0: 350.0| I1: 75.0| WTP: 400000,1,0.096153846,515,400000,1,0.2,350,75,-1235553535,884761309,10818.19661,694643704,69464370.4,4,83967,3749,680,1797,1117,680,83967,1117,1797,191.8065844,2.703703704,7.279835391,29886.15226,898.345679,10.08230453,98566.96708,0.302686556,0.009023984,0.000102489,0.621591541,0.02140152,35,7
D:1| T0: 0.10| T1: 515.00| I0: 350.0| I1: 75.0| WTP: 400000,1,0.096153846,515,400000,1,0.2,350,75,-2669828243,533485933,6655.080897,2337074199,233707419.9,14,59249,2674,1091,1105,14,1091,59249,14,1105,24.77769517,0.67732342,0.687732342,53291.21338,119.6349442,1.494423792,99135.14498,0.537133408,0.001204449,1.64053E-05,0.012669683,0.018650104,193,26
D:1| T0: 0.10| T1: 515.00| I0: 350.0| I1: 75.0| WTP: 400000,1,0.096153846,515,400000,1,0.2,350,75,-2287618299,632196071,7819.485638,1896644017,189664401.7,12,59300,2536,1214,1299,85,1214,59300,85,1299,29.27179963,0.97309833,1.048237477,53268.52505,141.9953618,2.179962894,98986.19759,0.537614524,0.001430336,2.34435E-05,0.06543495,0.021905565,154,21
D:1| T0: 0.10| T1: 515.00| I0: 350.0| I1: 75.0| WTP: 400000,1,0.096153846,515,400000,1,0.2,350,75,-1367451527,393400457,11482.34108,793334472.9,79333447.29,4,94442,4189,581,1907,1326,581,94442,1326,1907,266.935,2.815,9.385,40691.735,1473.695,12.275,98891.985,0.408448052,0.014792933,0.000124897,0.695332984,0.020192287,29,8
D:1| T0: 0.10| T1: 515.00| I0: 350.0| I1: 75.0| WTP: 400000,1,0.096153846,515,400000,1,0.2,350,75,-1308958325,398973227,10671.83767,775366441.6,77536644.16,4,79252,3307,687,1773,1086,687,79252,1086,1773,156.6273063,2.420664207,6.383763838,44968.54613,876.2804428,8.915129151,98833.99631,0.453017302,0.00880499,9.123E-05,0.612521151,0.02237224,39,8
D:1| T0: 0.10| T1: 515.00| I0: 350.0| I1: 75.0| WTP: 400000,1,0.096153846,515,400000,1,0.2,350,75,-1632435487,1402256491,10019.10245,1131480364,113148036.4,6,81489,3659,898,1664,766,898,81489,766,1664,145.1238095,2.720634921,5.126984127,46008.50794,1633.187302,7.984126984,98967.87302,0.462769249,0.016412544,8.17556E-05,0.460336538,0.020419934,45,12
D:1| T0: 0.10| T1: 515.00| I0: 350.0| I1: 75.0| WTP: 400000,1,0.096153846,515,400000,1,0.2,350,75,-1417702314,2102527413,12585.78621,788413003.6,78841300.36,4,91625,3900,698,2091,1393,698,91625,1393,2091,198.4365079,2.662698413,8.154761905,39848.72619,2102.353175,10.92063492,98734.33333,0.400390378,0.021147796,0.000111369,0.666188427,0.022821282,36,8
D:1| T0: 0.10| T1: 515.00| I0: 350.0| I1: 75.0| WTP: 400000,1,0.096153846,515,400000,1,0.2,350,75,-1376646080,1748031099,11822.1405,785539054.7,78553905.47,4,91504,3881,672,1964,1292,672,91504,1292,1964,205.0805085,2.737288136,8.177966102,38983.5339,2100.516949,11.00847458,98797.72458,0.39176593,0.021109395,0.000112304,0.657841141,0.021464012,34,8
D:1| T0: 0.10| T1: 515.00| I0: 350.0| I1: 75.0| WTP: 400000,1,0.096153846,515,400000,1,0.2,350,75,-1893686662,1946754629,8578.23922,1464774701,146477470.1,8,65190,2894,1192,1425,233,1192,65190,233,1425,45.28791774,1.367609254,1.650385604,50899.08098,322.033419,3.176092545,98944.10283,0.513580407,0.003241133,3.38349E-05,0.163508772,0.021859181,112,16
D:1| T0: 0.10| T1: 515.00| I0: 350.0| I1: 75.0| WTP: 400000,1,0.096153846,515,400000,1,0.2,350,75,-1513576986,2097712204,8013.258541,1112914059,111291405.9,6,64921,2912,1013,1331,318,1013,64921,318,1331,62.7920434,1.638336347,2.198915009,51456.95118,366.3562387,4.048824593,99031.05606,0.518807863,0.003683309,4.25992E-05,0.238918107,0.020501841,79,12
D:1| T0: 0.10| T1: 515.00| I0: 350.0| I1: 75.0| WTP: 400000,1,0.096153846,515,400000,1,0.2,350,75,-1885383761,1198827119,8427.924174,1463987552,146398755.2,8,61458,2695,1235,1400,165,1235,61458,165,1400,46.82479784,1.517520216,1.735849057,54867.54582,532.3989218,3.396226415,98998.42453,0.553175636,0.005355092,3.57125E-05,0.117857143,0.022779785,106,16
D:1| T0: 0.10| T1: 515.00| I0: 350.0| I1: 75.0| WTP: 400000,1,0.096153846,515,400000,1,0.2,350,75,-4865291188,109253198,5428.574096,4593862483,459386248.3,26,40701,1752,902,902,0,902,40701,0,902,9.925084582,0.274528758,0.274528758,74247.00338,137.717738,0.708071532,99435.79894,0.74630868,0.001385172,8.75441E-06,0,0.022161618,295,52
D:1| T0: 0.10| T1: 515.00| I0: 350.0| I1: 75.0| WTP: 400000,1,0.096153846,515,400000,1,0.2,350,75,-2995286783,314481292,7933.82289,2598595639,259859563.9,16,60474,2635,1313,1318,5,1313,60474,5,1318,31.3972468,1.089478859,1.093411996,61601.71583,177.0894789,2.382497542,99172.78663,0.620437245,0.001783194,2.6016E-05,0.003793627,0.02179449,146,29
D:1| T0: 0.10| T1: 515.00| I0: 350.0| I1: 100.0| WTP: 450000,1,0.096153846,515,450000,1,0.2,350,100,-4029557719,1178568022,7668.103902,3646152524,364615252.4,22,57197,2358,1274,1274,0,1274,57197,0,1274,16.06652244,0.517036236,0.517036236,59023.03678,159.605192,1.208761493,99087.27042,0.595053434,0.001608043,1.38611E-05,0,0.022273895,264,41
D:1| T0: 0.10| T1: 515.00| I0: 350.0| I1: 100.0| WTP: 450000,1,0.096153846,515,450000,1,0.2,350,100,-1383520751,2029998696,11830.2407,792008715.4,79200871.54,4,94945,4164,648,1965,1317,648,94945,1317,1965,230.8502203,2.753303965,8.524229075,35657.04846,1414.511013,11.37444934,98757.2467,0.358235323,0.014213002,0.00011567,0.670229008,0.020696193,33,8
D:1| T0: 0.10| T1: 515.00| I0: 350.0| I1: 100.0| WTP: 450000,1,0.096153846,515,450000,1,0.2,350,100,-1413972414,776062361,12590.52504,784446162.6,78444616.26,4,92374,3822,796,2092,1296,796,92374,1296,2092,176.2304833,2.862453532,7.643122677,39223.80669,2136.762082,10.60594796,98727.87361,0.394065151,0.021505698,0.000108069,0.619502868,0.022647065,38,8
D:1| T0: 0.10| T1: 515.00| I0: 350.0| I1: 100.0| WTP: 450000,1,0.096153846,515,450000,1,0.2,350,100,-3629152462,1813046880,8259.379111,3216183507,321618350.7,18,61162,2782,1366,1372,6,1366,61162,6,1372,22.65548981,0.71268902,0.715976331,57331.66141,254.4286654,1.623274162,99051.58843,0.578075923,0.002562697,1.81136E-05,0.004373178,0.022432229,218,36
D:1| T0: 0.10| T1: 515.00| I0: 350.0| I1: 100.0| WTP: 450000,1,0.096153846,515,450000,1,0.2,350,100,-2105309265,2032407216,7563.107386,1727153896,172715389.6,10,63774,2844,1151,1256,105,1151,63774,105,1256,42.35817308,1.188701923,1.308894231,53134.13822,268.0961538,2.689903846,99098.81611,0.535527463,0.002696444,2.90788E-05,0.083665339,0.019679483,119,19
D:1| T0: 0.10| T1: 515.00| I0: 350.0| I1: 100.0| WTP: 450000,1,0.096153846,515,450000,1,0.2,350,100,-5306860261,1507873352,7070.97894,4953311314,495331131.4,28,50532,2122,1175,1175,0,1175,50532,0,1175,11.83737185,0.366728798,0.366728798,72823.99907,171.082945,0.912861137,99374.96552,0.732208719,0.001722657,1.10102E-05,0,0.023252592,306,56
D:1| T0: 0.10| T1: 515.00| I0: 350.0| I1: 100.0| WTP: 450000,1,0.096153846,515,450000,1,0.2,350,100,-3092172913,1855899401,6484.46326,2767949750,276794975,16,51804,2327,1077,1077,0,1077,51804,0,1077,20.94873646,0.593501805,0.593501805,65770.23394,139.4469314,1.376895307,99293.60866,0.661891688,0.001403559,1.56251E-05,0,0.020790703,198,31
D:1| T0: 0.10| T1: 515.00| I0: 350.0| I1: 100.0| WTP: 450000,1,0.096153846,515,450000,1,0.2,350,100,-1281892609,1819459251,10172.70203,773257507.6,77325750.76,4,76418,3302,742,1690,948,742,76418,948,1690,125.5731707,2.131097561,4.987804878,45077.6372,836.4054878,7.237804878,98842.49695,0.454341786,0.008406084,7.45449E-05,0.560946746,0.022116077,47,8
D:1| T0: 0.10| T1: 515.00| I0: 350.0| I1: 100.0| WTP: 450000,1,0.096153846,515,450000,1,0.2,350,100,-2981204758,909791748,6086.99819,2676854848,267685484.8,20,48932,2197,1011,1011,0,1011,48932,0,1011,27.18044355,0.804435484,0.804435484,72364.55444,159.858871,1.834677419,99438.44052,0.727234026,0.001607784,2.04657E-05,0,0.020663015,142,30
D:1| T0: 0.10| T1: 515.00| I0: 350.0| I1: 100.0| WTP: 450000,1,0.096153846,515,450000,1,0.2,350,100,-1476838419,1339092841,9063.685199,1023654159,102365415.9,6,65749,2721,812,1506,694,812,65749,694,1506,89.15915119,2.068965517,3.888594164,51412.98674,627.1883289,6.031830239,98925.66048,0.518515701,0.006302596,6.17803E-05,0.460823373,0.02290564,54,11
D:1| T0: 0.10| T1: 515.00| I0: 350.0| I1: 100.0| WTP: 450000,1,0.096153846,515,450000,1,0.2,350,100,-1403507233,1365866345,12208.93929,793060268.4,79306026.84,4,95855,4267,715,2028,1313,715,95855,1313,2028,219.3112033,2.887966805,8.298755187,32980.77593,1247.344398,11.24481328,98667.9917,0.331489792,0.0125414,0.000114431,0.647435897,0.021156956,35,8
D:1| T0: 0.10| T1: 515.00| I0: 350.0| I1: 100.0| WTP: 450000,1,0.096153846,515,450000,1,0.2,350,100,-1572425539,825453433,8912.60515,1126795282,112679528.2,6,75128,3348,899,1480,581,899,75128,581,1480,106.8044554,2.094059406,3.514851485,45192.02475,946.3836634,5.747524752,98971.0198,0.455215944,0.009507945,5.91903E-05,0.392567568,0.019699712,58,12
D:1| T0: 0.10| T1: 515.00| I0: 350.0| I1: 100.0| WTP: 450000,1,0.096153846,515,450000,1,0.2,350,100,-1392680308,939711378,11974.9893,793930842.6,79393084.26,4,96951,4287,640,1989,1349,640,96951,1349,1989,232.7434783,2.726086957,8.539130435,32911.42174,1656.417391,11.30434783,98717.07391,0.330585224,0.016642516,0.000114881,0.678230266,0.020515518,33,8
D:1| T0: 0.10| T1: 515.00| I0: 350.0| I1: 100.0| WTP: 450000,1,0.096153846,515,450000,1,0.2,350,100,-1894952660,638950699,8430.951515,1473405084,147340508.4,8,70609,3151,1087,1400,313,1087,70609,313,1400,69.30204778,1.747440273,2.262798635,45785.31399,760.7542662,4.126279863,98958.57167,0.461567767,0.007648648,4.26643E-05,0.223571429,0.019827501,84,16
D:1| T0: 0.10| T1: 515.00| I0: 350.0| I1: 100.0| WTP: 450000,1,0.096153846,515,450000,1,0.2,350,100,-2354616088,938699148,7381.462919,1985542942,198554294.2,12,60459,2688,1144,1226,82,1144,60459,82,1226,38.03399766,1.162954279,1.254396249,55235.80422,239.5615475,2.594372802,99107.3177,0.556682235,0.002409807,2.79233E-05,0.066938776,0.020263341,122,22
D:1| T0: 0.10| T1: 515.00| I0: 350.0| I1: 100.0| WTP: 450000,1,0.096153846,515,450000,1,0.2,350,100,-4156324800,121790188,6636.117416,3824518929,382451892.9,22,56043,2577,1102,1102,0,1102,56043,0,1102,19.27519614,0.491852746,0.491852746,62360.49849,243.032589,1.155099578,99273.68859,0.627622431,0.002444501,1.33666E-05,0,0.019664525,236,43
D:1| T0: 0.10| T1: 515.00| I0: 350.0| I1: 100.0| WTP: 450000,1,0.096153846,515,450000,1,0.2,350,100,-1618858892,1331335240,11336.8885,1052014467,105201446.7,6,90734,3926,720,1883,1163,720,90734,1163,1883,202.708,2.764,7.368,40985.628,2391.792,10.244,98879.656,0.41171151,0.024033941,0.000104673,0.617631439,0.02075297,36,11
D:1| T0: 0.10| T1: 515.00| I0: 350.0| I1: 100.0| WTP: 450000,1,0.096153846,515,450000,1,0.2,350,100,-1344883793,470935411,12850.55476,702356055.6,70235605.56,4,93723,3995,728,2135,1407,728,93723,1407,2135,299.1823529,4.194117647,12.37647059,34795.56471,1426.711765,16.67058824,98640.10588,0.350554058,0.014330058,0.000169245,0.659016393,0.022779894,25,7
D:1| T0: 0.10| T1: 515.00| I0: 350.0| I1: 100.0| WTP: 450000,1,0.096153846,515,450000,1,0.2,350,100,-1605330363,823434397,9785.986436,1116031041,111603104.1,6,69486,2888,1189,1626,437,1189,69486,437,1626,59.44059406,1.836633663,2.537953795,46806.24092,586.9438944,4.491749175,98788.86469,0.472555394,0.005908499,4.67626E-05,0.268757688,0.023400734,87,12
D:1| T0: 0.10| T1: 515.00| I0: 350.0| I1: 100.0| WTP: 450000,1,0.096153846,515,450000,1,0.2,350,100,-2423882903,493045351,6991.461022,2074309852,207430985.2,14,59173,2685,1161,1161,0,1161,59173,0,1161,36.79558011,1.072928177,1.072928177,65142.28729,166.6342541,2.340331492,99338.88508,0.655077159,0.001676648,2.57784E-05,0,0.019620435,130,23
D:1| T0: 0.10| T1: 515.00| I0: 350.0| I1: 100.0| WTP: 450000,1,0.096153846,515,450000,1,0.2,350,100,-1755128038,1700216563,7439.205727,1383167752,138316775.2,8,65454,3003,988,1235,247,988,65454,247,1235,94.81204819,2.262650602,2.83373494,57538.34458,847.0433735,5.207228916,99240.98795,0.578572346,0.008501784,5.37672E-05,0.2,0.018868213,60,15
D:1| T0: 0.10| T1: 515.00| I0: 350.0| I1: 100.0| WTP: 450000,1,0.096153846,515,450000,1,0.2,350,100,-1762581707,1744119059,7689.729462,1378095233,137809523.3,8,64075,2981,1133,1277,144,1133,64075,144,1277,58.29886914,1.620355412,1.844911147,53829.28595,286.3812601,3.675282714,99103.937,0.542536813,0.002879593,3.91244E-05,0.112764291,0.019930081,89,15
D:1| T0: 0.10| T1: 515.00| I0: 350.0| I1: 100.0| WTP: 450000,1,0.096153846,515,450000,1,0.2,350,100,-2903243006,2036906360,7902.815283,2508102242,250810224.2,14,59619,2573,1291,1313,22,1291,59619,22,1313,17.88068517,0.619019492,0.632014176,51861.80626,244.6255168,1.398109864,98956.56054,0.523484226,0.00246325,1.54732E-05,0.016755522,0.022023181,241,28
D:1| T0: 0.10| T1: 515.00| I0: 350.0| I1: 100.0| WTP: 450000,1,0.096153846,515,450000,1,0.2,350,100,-1877769364,809704121,8171.308232,1469203953,146920395.3,8,67694,3069,1009,1357,348,1009,67694,348,1357,91.42925659,2.278177458,3.09352518,55503.19664,838.7889688,5.51558753,99149.98561,0.558406623,0.008424791,5.69833E-05,0.256448047,0.02004609,59,16
D:1| T0: 0.10| T1: 515.00| I0: 350.0| I1: 100.0| WTP: 450000,1,0.096153846,515,450000,1,0.2,350,100,-1700234090,1219866412,11258.06692,1137330744,113733074.4,6,89654,3951,801,1870,1069,801,89654,1069,1870,186.7528517,2.923954373,6.950570342,40127.79468,2798.513308,9.992395437,98855.30798,0.403365863,0.028130056,0.000102118,0.571657754,0.020857965,38,12
D:1| T0: 0.10| T1: 515.00| I0: 350.0| I1: 100.0| WTP: 450000,1,0.096153846,515,450000,1,0.2,350,100,-4614137803,843498920,7138.718431,4257201881,425720188.1,28,53409,2340,1186,1186,0,1186,53409,0,1186,14.66460587,0.422462648,0.422462648,66107.82741,131.9196291,1.042246265,99260.11231,0.665363707,0.001328816,1.2287E-05,0,0.022205995,278,48
D:1| T0: 0.10| T1: 515.00| I0: 350.0| I1: 100.0| WTP: 450000,1,0.096153846,515,450000,1,0.2,350,100,-1981660987,107351963,10326.07949,1465357012,146535701.2,8,71840,2807,1295,1716,421,1295,71840,421,1716,48.4813278,1.64868603,2.215767635,44824.26694,690.9377593,3.987551867,98718.40387,0.452727074,0.006959652,4.19493E-05,0.245337995,0.023886414,104,16
D:1| T0: 0.10| T1: 515.00| I0: 350.0| I1: 100.0| WTP: 450000,1,0.096153846,515,450000,1,0.2,350,100,-1938570457,773789021,9313.572893,1472891812,147289181.2,8,69960,3174,1120,1547,427,1120,69960,427,1547,80.8989899,2.125252525,2.965656566,51247.27879,958.0060606,5.22020202,98966.28485,0.516321658,0.009635197,5.41865E-05,0.2760181,0.022112636,71,16
D:1| T0: 0.10| T1: 515.00| I0: 350.0| I1: 100.0| WTP: 450000,1,0.096153846,515,450000,1,0.2,350,100,-1618199969,850936611,10020.55179,1117172380,111717238,6,69867,2894,1127,1665,538,1127,69867,538,1665,57.07142857,1.641304348,2.448757764,44639.63509,575.613354,4.187888199,98709.67081,0.451028243,0.005796502,4.36564E-05,0.323123123,0.023830993,92,12
D:1| T0: 0.10| T1: 515.00| I0: 350.0| I1: 100.0| WTP: 450000,1,0.096153846,515,450000,1,0.2,350,100,-1568445633,1701318364,8982.293752,1119330945,111933094.5,6,70496,3025,1075,1492,417,1075,70496,417,1492,60.82250396,1.580031696,2.228209192,42821.13154,470.340729,3.93977813,98808.25674,0.43253079,0.004732987,4.09292E-05,0.279490617,0.021164321,91,12
D:1| T0: 0.10| T1: 515.00| I0: 350.0| I1: 100.0| WTP: 450000,1,0.096153846,515,450000,1,0.2,350,100,-3525259050,778708269,6411.891239,3204664488,320466448.8,18,50071,2231,1065,1065,0,1065,50071,0,1065,16.29895713,0.463499421,0.463499421,62562.87428,223.608343,1.082271147,99212.04925,0.630150115,0.002248852,1.23993E-05,0,0.021269797,247,36
D:1| T0: 0.10| T1: 515.00| I0: 350.0| I1: 100.0| WTP: 450000,1,0.096153846,515,450000,1,0.2,350,100,-2841514159,1391938506,8419.382806,2420545019,242054501.9,16,58668,2430,1353,1399,46,1353,58668,46,1399,29.49608611,1.107632094,1.151663405,59313.35029,204.4324853,2.485322896,99041.91487,0.598199155,0.002059142,2.70915E-05,0.032880629,0.023846049,146,27
D:1| T0: 0.10| T1: 515.00| I0: 350.0| I1: 100.0| WTP: 450000,1,0.096153846,515,450000,1,0.2,350,100,-4131602529,43418681,6356.329242,3813786067,381378606.7,22,49099,2103,1056,1056,0,1056,49099,0,1056,15.62790698,0.446756426,0.446756426,71960.61322,169.6646267,1.098531212,99399.9388,0.723485447,0.001707065,1.29859E-05,0,0.021507566,234,43
D:1| T0: 0.10| T1: 515.00| I0: 350.0| I1: 100.0| WTP: 450000,1,0.096153846,515,450000,1,0.2,350,100,-1417547193,817384966,12692.12962,782940711.9,78294071.19,4,90602,3756,789,2109,1320,789,90602,1320,2109,252.4456522,4.195652174,11.2826087,40878.88587,1341.407609,15.5923913,98743.14674,0.411496812,0.013472938,0.000158227,0.625889047,0.023277632,27,8
D:1| T0: 0.10| T1: 515.00| I0: 350.0| I1: 100.0| WTP: 450000,1,0.096153846,515,450000,1,0.2,350,100,-1329680087,762053968,10908.90403,784234885.7,78423488.57,4,89409,3903,706,1812,1106,706,89409,1106,1812,233.9460784,3.362745098,8.730392157,42878.75,1366.02451,12.18627451,98936.04902,0.430944848,0.013709946,0.000123882,0.610375276,0.020266416,30,8
D:1| T0: 0.10| T1: 515.00| I0: 350.0| I1: 100.0| WTP: 450000,1,0.096153846,515,450000,1,0.2,350,100,-2203774780,1692506311,7726.122047,1817468677,181746867.7,10,67031,3056,1176,1283,107,1176,67031,107,1283,37.49795918,1.047959184,1.154081633,47771.57347,453.5826531,2.357142857,99020.71122,0.481665051,0.004562278,2.5228E-05,0.083398285,0.019140398,139,20
D:1| T0: 0.10| T1: 515.00| I0: 350.0| I1: 100.0| WTP: 450000,1,0.096153846,515,450000,1,0.2,350,100,-3339538207,1037620300,6272.635473,3025906433,302590643.3,18,49930,2143,1042,1042,0,1042,49930,0,1042,20.49408983,0.623325453,0.623325453,70074.48069,164.6737589,1.447596533,99381.02443,0.70460792,0.00165651,1.64952E-05,0,0.020869217,182,34
D:1| T0: 0.10| T1: 515.00| I0: 350.0| I1: 100.0| WTP: 450000,1,0.096153846,515,450000,1,0.2,350,100,-2961583940,301400999,7314.307988,2595868541,259586854.1,16,59081,2536,1215,1215,0,1215,59081,0,1215,25.06393443,0.8,0.8,58212.17131,200.6672131,1.785245902,99157.26148,0.586550338,0.002019478,2.0023E-05,0,0.020564987,175,29
D:1| T0: 0.10| T1: 515.00| I0: 350.0| I1: 100.0| WTP: 450000,1,0.096153846,515,450000,1,0.2,350,100,-1333353780,1868336855,11034.19698,781643931.1,78164393.11,4,85024,3691,738,1833,1095,738,85024,1095,1833,181.6062992,2.767716535,7.05511811,45113.5,1305.53937,9.94488189,98904.12598,0.453593972,0.013117366,0.000101749,0.597381342,0.021558619,37,8
D:1| T0: 0.10| T1: 515.00| I0: 350.0| I1: 100.0| WTP: 450000,1,0.096153846,515,450000,1,0.2,350,100,-1328426135,1868498144,11020.78071,777387099.5,77738709.95,4,83064,3574,738,1831,1093,738,83064,1093,1831,154.2624113,2.468085106,6.308510638,43508.91489,1229.22695,8.946808511,98828.9078,0.437946382,0.012357932,9.15984E-05,0.596941562,0.022043244,41,8
D:1| T0: 0.10| T1: 515.00| I0: 350.0| I1: 100.0| WTP: 450000,1,0.096153846,515,450000,1,0.2,350,100,-2862264318,2101566889,7080.122107,2508258213,250825821.3,14,54745,2441,1170,1176,6,1170,54745,6,1176,23.89269051,0.731726283,0.736391913,59239.69751,241.7923795,1.652410575,99135.28149,0.597079439,0.002432946,1.83359E-05,0.005102041,0.021481414,184,28
D:1| T0: 0.10| T1: 515.00| I0: 350.0| I1: 100.0| WTP: 450000,1,0.096153846,515,450000,1,0.2,350,100,-1326607715,1665097450,12466.49921,703282753.9,70328275.39,4,95376,4092,712,2071,1359,712,95376,1359,2071,268.265625,3.651041667,10.65625,33922.08333,1700.838542,14.359375,98663.69271,0.341408236,0.017091824,0.000145674,0.656204732,0.021714058,28,7
D:1| T0: 0.10| T1: 515.00| I0: 350.0| I1: 100.0| WTP: 450000,1,0.096153846,515,450000,1,0.2,350,100,-1337506518,1716179948,10775.50476,798731279.7,79873127.97,4,97436,4498,713,1789,1076,713,97436,1076,1789,304.7365591,3.747311828,9.478494624,36982.23118,1808.892473,13.31182796,98946.6129,0.371245615,0.018147954,0.000134933,0.601453326,0.01836077,27,8
D:1| T0: 0.10| T1: 515.00| I0: 350.0| I1: 100.0| WTP: 450000,1,0.096153846,515,450000,1,0.2,350,100,-3058768198,1560278715,7666.065221,2675464937,267546493.7,16,52553,2104,1274,1274,0,1274,52553,0,1274,23.77124183,0.98225957,0.98225957,65877.61718,167.7591036,2.195144725,99184.22129,0.663571221,0.001689255,2.39207E-05,0,0.024242194,152,30
D:1| T0: 0.10| T1: 515.00| I0: 350.0| I1: 100.0| WTP: 450000,1,0.096153846,515,450000,1,0.2,350,100,-1400544680,991019385,12343.8999,783349685.4,78334968.54,4,90105,3827,713,2051,1338,713,90105,1338,2051,176.2255639,2.560150376,7.567669173,38985.35338,2004.496241,10.26691729,98708.37218,0.392013411,0.020164468,0.000104562,0.6523647,0.022762333,38,8
D:1| T0: 0.10| T1: 515.00| I0: 350.0| I1: 100.0| WTP: 450000,1,0.096153846,515,450000,1,0.2,350,100,-1350120201,118052103,11293.66053,785437174.6,78543717.46,4,87357,3891,765,1876,1111,765,87357,1111,1876,180.4701493,2.720149254,6.824626866,45449.93657,1649.537313,9.701492537,98919.63433,0.456590564,0.016581293,9.90906E-05,0.592217484,0.021475096,39,8
D:1| T0: 0.10| T1: 515.00| I0: 350.0| I1: 100.0| WTP: 450000,1,0.096153846,515,450000,1,0.2,350,100,-1405055439,1209758844,12434.00238,783355320.1,78335532.01,4,89402,3728,691,2066,1375,691,89402,1375,2066,240.5179487,3.441025641,10.44102564,45146.83077,1345.369231,13.96410256,98835.05128,0.45362038,0.013515966,0.000142049,0.66553727,0.023109103,28,8
D:1| T0: 0.10| T1: 515.00| I0: 350.0| I1: 100.0| WTP: 450000,1,0.096153846,515,450000,1,0.2,350,100,-4901167371,70671723,7560.122073,4523161268,452316126.8,26,57478,2458,1256,1256,0,1256,57478,0,1256,16.29507309,0.49269085,0.49269085,64003.91933,191.1093665,1.17866811,99224.20195,0.644417828,0.00192453,1.36789E-05,0,0.02185298,264,51
D:1| T0: 0.10| T1: 515.00| I0: 350.0| I1: 100.0| WTP: 450000,1,0.096153846,515,450000,1,0.2,350,100,-3163248037,1722612191,6160.017382,2855247168,285524716.8,16,51821,2308,1023,1023,0,1023,51821,0,1023,19.92027491,0.513402062,0.513402062,64316.40962,196.2542955,1.230927835,99307.13333,0.647174665,0.001973601,1.41242E-05,0,0.019741032,207,32
D:1| T0: 0.10| T1: 515.00| I0: 350.0| I1: 100.0| WTP: 450000,1,0.096153846,515,450000,1,0.2,350,100,-3038270510,1968291596,5444.86247,2766027386,276602738.6,16,48493,2228,904,904,0,904,48493,0,904,19.74475524,0.469230769,0.469230769,66184.06434,135.5608392,1.1,99364.82378,0.665682215,0.001363455,1.26917E-05,0,0.018641866,205,31
D:1| T0: 0.10| T1: 515.00| I0: 350.0| I1: 100.0| WTP: 450000,1,0.096153846,515,450000,1,0.2,350,100,-1449474365,1877569084,13169.17406,791015662.1,79101566.21,4,96488,4069,745,2188,1443,745,96488,1443,2188,266.1295337,3.813471503,11.21243523,35133.56995,1600.093264,15.05181347,98644.61658,0.353250926,0.016087307,0.00015278,0.659506399,0.022676395,28,8
D:1| T0: 0.10| T1: 515.00| I0: 350.0| I1: 100.0| WTP: 450000,1,0.096153846,515,450000,1,0.2,350,100,-1400909269,1726322189,12190.40189,791389174.1,79138917.41,4,95421,4151,742,2025,1283,742,95421,1283,2025,268.4352332,3.777202073,10.33678756,36894.84456,1673.772021,14.19170984,98778.33161,0.370759373,0.0168105,0.000144015,0.633580247,0.021221744,28,8
D:1| T0: 0.10| T1: 515.00| I0: 350.0| I1: 100.0| WTP: 450000,1,0.096153846,515,450000,1,0.2,350,100,-1390977632,307848836,12063.07059,787824102.3,78782410.23,4,91431,4027,613,2004,1391,613,91431,1391,2004,231.5627907,2.772093023,9.195348837,41100.16744,1495.390698,12.03255814,98811.69767,0.412902006,0.015021828,0.000122332,0.694111776,0.021918168,31,8
D:1| T0: 0.10| T1: 515.00| I0: 350.0| I1: 100.0| WTP: 450000,1,0.096153846,515,450000,1,0.2,350,100,-1256273041,1154000220,11067.13265,702916408,70291640.8,4,91009,4125,749,1838,1089,749,91009,1089,1838,280.1630435,3.983695652,9.836956522,33230.30978,1286.51087,13.89673913,98752.70652,0.335189924,0.012907515,0.000141173,0.592491839,0.020195805,27,7
D:1| T0: 0.10| T1: 515.00| I0: 350.0| I1: 100.0| WTP: 450000,1,0.096153846,515,450000,1,0.2,350,100,-4402234473,2028661055,6400.194063,4082224770,408222477,24,53098,2333,1063,1063,0,1063,53098,0,1063,18.97826087,0.513175231,0.513175231,69108.96113,182.3162055,1.214756258,99394.74967,0.694752371,0.001833975,1.40708E-05,0,0.020019586,217,46
D:1| T0: 0.10| T1: 515.00| I0: 350.0| I1: 100.0| WTP: 450000,1,0.096153846,515,450000,1,0.2,350,100,-1881607245,1629114640,9872.933435,1387960573,138796057.3,8,77706,3400,1070,1640,570,1070,77706,570,1640,121.5146199,3.005847953,4.622807018,50148.26608,1410.076023,7.748538012,99020.85965,0.504481775,0.014172465,7.96657E-05,0.347560976,0.021105463,49,15
D:1| T0: 0.10| T1: 515.00| I0: 350.0| I1: 100.0| WTP: 450000,1,0.096153846,515,450000,1,0.2,350,100,-1448079271,1439048174,13026.9009,796734226.2,79673422.62,4,96599,4308,746,2164,1418,746,96599,1418,2164,300.1748634,4,11.66666667,38851.43169,2247.836066,15.75956284,98756.08743,0.390137629,0.022590817,0.000159786,0.655268022,0.022401888,27,8
D:1| T0: 0.10| T1: 515.00| I0: 350.0| I1: 100.0| WTP: 450000,1,0.096153846,515,450000,1,0.2,350,100,-1292416835,865227006,11976.89732,693571969.4,69357196.94,4,88440,3679,705,1990,1285,705,88440,1285,1990,275.0722892,4.120481928,11.79518072,34329.10843,1429.783133,16.08433735,98636.85542,0.346731923,0.014345885,0.000163076,0.645728643,0.02250164,24,7
D:1| T0: 0.10| T1: 515.00| I0: 350.0| I1: 100.0| WTP: 450000,1,0.096153846,515,450000,1,0.2,350,100,-1691078570,890479738,11095.6054,1136298300,113629830,6,88008,3838,815,1843,1028,815,88008,1028,1843,149.7808642,2.416666667,5.552469136,37508.04012,1938.632716,8.074074074,98771.28395,0.377419917,0.019499109,8.25542E-05,0.557786218,0.020941278,47,12
D:1| T0: 0.10| T1: 515.00| I0: 350.0| I1: 100.0| WTP: 450000,1,0.096153846,515,450000,1,0.2,350,100,-3314351859,1017049163,7285.45217,2950079251,295007925.1,20,60268,2731,1209,1210,1,1209,60268,1,1210,28.35726644,0.846885813,0.847750865,61347.04066,185.7716263,1.888408304,99238.39273,0.617564128,0.001869617,2.10345E-05,0.000826446,0.020076989,166,33
D:1| T0: 0.10| T1: 515.00| I0: 350.0| I1: 100.0| WTP: 450000,1,0.096153846,515,450000,1,0.2,350,100,-3801405197,1707305064,6587.465241,3472031935,347203193.5,20,54234,2480,1094,1094,0,1094,54234,0,1094,20.55740988,0.541388518,0.541388518,64062.52403,190.8738318,1.276368491,99283.11081,0.644706575,0.001920471,1.46765E-05,0,0.020171848,214,39
D:1| T0: 0.10| T1: 515.00| I0: 350.0| I1: 100.0| WTP: 450000,1,0.096153846,515,450000,1,0.2,350,100,-1286251020,400145663,11803.58029,696072005.8,69607200.58,4,86942,3738,730,1961,1231,730,86942,1231,1961,245.9270833,3.723958333,10.078125,32762.4375,1214.723958,13.875,98577.98958,0.331264071,0.012196606,0.000140896,0.627740948,0.022555267,28,7
D:1| T0: 0.10| T1: 515.00| I0: 350.0| I1: 100.0| WTP: 450000,1,0.096153846,515,450000,1,0.2,350,100,-3780476503,1662654181,7767.125355,3392120235,339212023.5,22,63424,2849,1286,1290,4,1286,63424,4,1290,25.65762463,0.752199413,0.754398827,58881.29472,191.5388563,1.703079179,99183.45821,0.592931731,0.001928553,1.89941E-05,0.003100775,0.020339304,195,38
D:1| T0: 0.10| T1: 515.00| I0: 350.0| I1: 100.0| WTP: 450000,1,0.096153846,515,450000,1,0.2,350,100,-1362182916,182136456,11380.26596,793169618,79316961.8,4,95282,4251,770,1890,1120,770,95282,1120,1890,282.1489362,4.037234043,9.909574468,37686.44149,1749.590426,14,98864.92021,0.378761919,0.017562797,0.000142007,0.592592593,0.019835856,27,8
D:1| T0: 0.10| T1: 515.00| I0: 350.0| I1: 100.0| WTP: 450000,1,0.096153846,515,450000,1,0.2,350,100,-4193963817,979575387,5851.83282,3901372176,390137217.6,22,47470,2139,972,972,0,972,47470,0,972,13.22525773,0.342783505,0.342783505,66300.75361,163.1969072,0.839175258,99318.96753,0.667184734,0.001641476,1.00643E-05,0,0.02047609,278,44
D:1| T0: 0.10| T1: 515.00| I0: 350.0| I1: 100.0| WTP: 450000,1,0.096153846,515,450000,1,0.2,350,100,-1414555815,2142525414,12519.76766,788567431.6,78856743.16,4,93670,3990,711,2080,1369,711,93670,1369,2080,256.7384615,3.523076923,10.48717949,45475.51282,1895.589744,14.17435897,98908.51282,0.456217912,0.019047371,0.000143821,0.658173077,0.022205615,28,8
D:1| T0: 0.10| T1: 515.00| I0: 350.0| I1: 100.0| WTP: 450000,1,0.096153846,515,450000,1,0.2,350,100,-1308353211,1464057597,10553.45839,780680291.3,78068029.13,4,83440,3665,765,1753,988,765,83440,988,1753,168.3247232,2.6900369,6.287822878,47638.99262,1154.653137,9.103321033,98981.90406,0.478795989,0.011598857,9.33721E-05,0.563605248,0.021010116,39,8
D:1| T0: 0.10| T1: 515.00| I0: 350.0| I1: 100.0| WTP: 450000,1,0.096153846,515,450000,1,0.2,350,100,-1363136256,364562610,11575.53304,784359603.8,78435960.38,4,90373,3854,667,1923,1256,667,90373,1256,1923,239.7939698,3.246231156,9.497487437,43443.79899,1533.854271,12.86432161,98892.47739,0.436426742,0.015401995,0.000130688,0.653146126,0.021278479,29,8
D:1| T0: 0.10| T1: 515.00| I0: 350.0| I1: 100.0| WTP: 450000,1,0.096153846,515,450000,1,0.2,350,100,-1378858728,40350784,11893.77738,784169859.3,78416985.93,4,90261,3748,686,1976,1290,686,90261,1290,1976,227.5502392,3.148325359,9.267942584,45322.52632,1657.406699,12.54545455,98905.97608,0.455083565,0.016649277,0.000127961,0.652834008,0.021892069,30,8
D:1| T0: 0.10| T1: 515.00| I0: 350.0| I1: 100.0| WTP: 450000,1,0.096153846,515,450000,1,0.2,350,100,-1265754340,804064356,9606.088596,785449910.1,78544991.01,4,84018,3843,543,1595,1052,543,84018,1052,1595,237.9466019,2.524271845,7.59223301,49044.34466,1179.524272,10.21359223,99108.40291,0.492538805,0.011823978,0.00010408,0.659561129,0.018984253,30,8
D:1| T0: 0.10| T1: 515.00| I0: 350.0| I1: 100.0| WTP: 450000,1,0.096153846,515,450000,1,0.2,350,100,-2226170089,2125493986,8288.796424,1811730268,181173026.8,12,62980,2658,1180,1377,197,1180,62980,197,1377,35.73786408,1.116504854,1.323624595,50710.35383,214.6979504,2.590075512,98915.02697,0.512039444,0.002162407,2.77467E-05,0.143064633,0.021864431,133,20
D:1| T0: 0.10| T1: 515.00| I0: 350.0| I1: 100.0| WTP: 450000,1,0.096153846,515,450000,1,0.2,350,100,-1238899457,23154253,9166.195974,780589658.5,78058965.85,4,78757,3560,713,1522,809,713,78757,809,1522,180.2627451,2.670588235,5.815686275,47154.9451,824.9607843,8.62745098,99039.89804,0.474417196,0.0082769,8.79372E-05,0.531537451,0.019325266,37,8
D:1| T0: 0.10| T1: 515.00| I0: 350.0| I1: 100.0| WTP: 450000,1,0.096153846,515,450000,1,0.2,350,100,-2678837364,1391367689,6965.232544,2330575737,233057573.7,14,53269,2397,1157,1157,0,1157,53269,0,1157,25.97071872,0.826974268,0.826974268,63304.69299,159.7346939,1.855368234,99217.7134,0.637534205,0.001607587,2.06332E-05,0,0.02171995,161,26
D:1| T0: 0.10| T1: 515.00| I0: 350.0| I1: 100.0| WTP: 450000,1,0.096153846,515,450000,1,0.2,350,100,-1552896132,574142276,8711.360882,1117328088,111732808.8,6,68260,3027,1028,1447,419,1028,68260,419,1447,58.45525903,1.489795918,2.128728414,45664.82418,492.7974882,3.739403454,98876.81319,0.460916927,0.004956339,3.90818E-05,0.289564616,0.021198359,91,12
D:1| T0: 0.10| T1: 515.00| I0: 350.0| I1: 100.0| WTP: 450000,1,0.096153846,515,450000,1,0.2,350,100,-4918919815,898736779,6255.368871,4606151371,460615137.1,26,49751,2157,1039,1039,0,1039,49751,0,1039,12.98367537,0.320895522,0.320895522,66427.44263,171.6338619,0.805037313,99299.26959,0.668498457,0.001727051,9.73818E-06,0,0.020884002,307,52
D:1| T0: 0.10| T1: 515.00| I0: 350.0| I1: 100.0| WTP: 450000,1,0.096153846,515,450000,1,0.2,350,100,-1592145177,346473503,9107.904737,1136749940,113674994,6,83659,3995,705,1512,807,705,83659,807,1512,187.6121673,2.558935361,5.593155894,47566.31939,1805.48289,8.281368821,99124.53992,0.477771188,0.018116781,8.4613E-05,0.533730159,0.018073369,38,12
D:1| T0: 0.10| T1: 515.00| I0: 350.0| I1: 100.0| WTP: 450000,1,0.096153846,515,450000,1,0.2,350,100,-1614837646,445552282,9771.244653,1126275413,112627541.3,6,74932,3334,1023,1623,600,1023,74932,600,1623,92.79039301,2.100436681,3.390829694,44598.56332,935.5764192,5.626637555,98843.41703,0.449686464,0.009411044,5.81305E-05,0.369685767,0.021659638,65,12
D:1| T0: 0.10| T1: 515.00| I0: 350.0| I1: 100.0| WTP: 450000,1,0.096153846,515,450000,1,0.2,350,100,-1270786973,911758476,11284.51619,706561163.2,70656116.32,4,92449,4212,736,1874,1138,736,92449,1138,1874,252.5492958,3.384976526,8.638497653,28949.4554,1215.075117,12.10798122,98646.93427,0.292196282,0.012203292,0.000123144,0.607257204,0.020270636,31,7
D:1| T0: 0.10| T1: 515.00| I0: 350.0| I1: 100.0| WTP: 450000,1,0.096153846,515,450000,1,0.2,350,100,-1381815226,1464197940,11687.88935,797420758.4,79742075.84,4,96108,4386,679,1941,1262,679,96108,1262,1941,277.2636816,3.278606965,9.527363184,38605.37313,2774.383085,12.90547264,98875.17413,0.387457565,0.027857109,0.000130907,0.650180319,0.020196029,29,8
D:1| T0: 0.10| T1: 515.00| I0: 350.0| I1: 100.0| WTP: 450000,1,0.096153846,515,450000,1,0.2,350,100,-2144976943,500405854,8397.253504,1725114268,172511426.8,10,63488,2732,1271,1395,124,1271,63488,124,1395,38.88786127,1.293641618,1.428901734,52241.42081,295.7109827,2.90867052,98963.54682,0.527145099,0.00297687,3.10022E-05,0.088888889,0.021973002,124,19
D:1| T0: 0.10| T1: 515.00| I0: 350.0| I1: 100.0| WTP: 450000,1,0.096153846,515,450000,1,0.2,350,100,-1367557469,772037341,11777.84409,778665265.1,77866526.51,4,84909,3608,627,1957,1330,627,84909,1330,1957,214.6699029,2.917475728,9.32038835,47682.80583,1350.533981,12.36893204,98881.03398,0.47935571,0.013564432,0.000125993,0.67961165,0.023048205,30,8
D:1| T0: 0.10| T1: 515.00| I0: 350.0| I1: 100.0| WTP: 450000,1,0.096153846,515,450000,1,0.2,350,100,-3809645081,1543158763,5267.833528,3546253405,354625340.5,22,44038,1924,875,875,0,875,44038,0,875,12.35832887,0.318693091,0.318693091,70323.34494,114.0230316,0.784145688,99406.74826,0.707056408,0.001147303,9.4094E-06,0,0.019869204,267,40
D:1| T0: 0.10| T1: 515.00| I0: 350.0| I1: 100.0| WTP: 450000,1,0.096153846,515,450000,1,0.2,350,100,-1456046314,1604932531,13319.00724,790095952.1,79009595.21,4,94892,4067,764,2213,1449,764,94892,1449,2213,253.65,3.76,10.935,33670.975,1394.895,14.74,98553.945,0.33912986,0.014029531,0.000149718,0.654767284,0.023321249,29,8
D:1| T0: 0.10| T1: 515.00| I0: 350.0| I1: 100.0| WTP: 450000,1,0.096153846,515,450000,1,0.2,350,100,-1368832810,539051477,11601.00889,788782365.3,78878236.53,4,91936,4058,718,1927,1209,718,91936,1209,1927,224.8883929,3.107142857,8.446428571,42742.0625,2343.183036,11.64285714,98910.42857,0.429129865,0.02354521,0.000118658,0.627400104,0.020960233,32,8
D:1| T0: 0.10| T1: 515.00| I0: 350.0| I1: 100.0| WTP: 450000,1,0.096153846,515,450000,1,0.2,350,100,-3095805498,1743124675,6591.994254,2766205785,276620578.5,20,52575,2283,1095,1095,0,1095,52575,0,1095,22.8908046,0.689655172,0.689655172,68817.4647,146.0697865,1.593596059,99354.67323,0.692069037,0.00147007,1.80643E-05,0,0.020827389,174,31
D:1| T0: 0.10| T1: 515.00| I0: 350.0| I1: 100.0| WTP: 450000,1,0.096153846,515,450000,1,0.2,350,100,-1902714697,1965983789,8728.905623,1466269416,146626941.6,8,67867,2932,1120,1450,330,1120,67867,330,1450,55.7202473,1.647604328,2.142194745,47688.49304,610.4250386,3.874806801,98911.63524,0.480975201,0.006140139,3.99464E-05,0.227586207,0.021365632,93,16
D:1| T0: 0.10| T1: 515.00| I0: 350.0| I1: 100.0| WTP: 450000,1,0.096153846,515,450000,1,0.2,350,100,-3070279369,516774280,7693.347915,2685611973,268561197.3,16,61471,2619,1254,1278,24,1254,61471,24,1278,21.86492074,0.703652653,0.718125431,52456.47967,271.3955892,1.576154376,99020.68367,0.529187702,0.00273179,1.75502E-05,0.018779343,0.020790291,207,30
D:1| T0: 0.10| T1: 515.00| I0: 350.0| I1: 100.0| WTP: 450000,1,0.096153846,515,450000,1,0.2,350,100,-998389498.6,86603142,11251.91933,435793532.2,43579353.22,2,88466,3815,624,1869,1245,624,88466,1245,1869,285.6569767,3.534883721,10.72674419,32496.5407,1333.540698,14.31976744,98668.77907,0.32826279,0.013375069,0.000145509,0.666131621,0.021126999,25,4
D:1| T0: 0.10| T1: 515.00| I0: 350.0| I1: 100.0| WTP: 450000,1,0.096153846,515,450000,1,0.2,350,100,-5586198567,1431870609,7147.167731,5228840181,522884018.1,30,59515,2646,1187,1187,0,1187,59515,0,1187,16.27868045,0.408173314,0.408173314,62079.85229,202.1265387,0.983751846,99264.28656,0.624831634,0.002034531,1.17528E-05,0,0.019944552,291,59
D:1| T0: 0.10| T1: 515.00| I0: 350.0| I1: 100.0| WTP: 450000,1,0.096153846,515,450000,1,0.2,350,100,-1241929708,1592383984,9320.840289,775887694,77588769.4,4,75834,3394,816,1548,732,816,75834,732,1548,142.5348837,2.594684385,5.003322259,48621.0897,734.4053156,7.707641196,99004.48837,0.489411742,0.007375628,7.88586E-05,0.472868217,0.020413007,43,8
D:1| T0: 0.10| T1: 515.00| I0: 350.0| I1: 100.0| WTP: 450000,1,0.096153846,515,450000,1,0.2,350,100,-1525685022,1440183867,8176.73623,1116848210,111684821,6,67584,3004,1053,1358,305,1053,67584,305,1358,56.20637329,1.474962064,1.918057663,46558.82246,494.0622155,3.509863429,98949.02124,0.46969305,0.004968516,3.67834E-05,0.224594993,0.020093513,95,12
D:1| T0: 0.10| T1: 515.00| I0: 350.0| I1: 100.0| WTP: 450000,1,0.096153846,515,450000,1,0.2,350,100,-1810782143,1696510588,8680.208407,1376771723,137677172.3,8,66742,2845,1124,1442,318,1124,66742,318,1442,37.57234727,1.082529475,1.411575563,45265.28296,336.8263666,2.607717042,98833.71704,0.457192021,0.003391096,2.76751E-05,0.220527046,0.021605586,134,15
D:1| T0: 0.10| T1: 515.00| I0: 350.0| I1: 100.0| WTP: 450000,1,0.096153846,515,450000,1,0.2,350,100,-1377059077,895039877,11834.12517,785352818.9,78535281.89,4,89167,3768,700,1966,1266,700,89167,1266,1966,198.7037037,2.781893004,7.95473251,40717.83128,1933.230453,10.81893004,98795.68313,0.409387433,0.019434156,0.000110336,0.643947101,0.022048516,35,8
D:1| T0: 0.10| T1: 515.00| I0: 350.0| I1: 100.0| WTP: 450000,1,0.096153846,515,450000,1,0.2,350,100,-2265430852,129565953,9004.636664,1815199019,181519901.9,10,66524,2823,1253,1496,243,1253,66524,243,1496,38.05452563,1.264994547,1.521264995,45386.32279,512.2104689,2.895310796,98797.23119,0.458453647,0.005156351,3.01702E-05,0.162433155,0.022488125,130,20
D:1| T0: 0.10| T1: 515.00| I0: 350.0| I1: 100.0| WTP: 450000,1,0.096153846,515,450000,1,0.2,350,100,-2079317387,1902565669,7093.841058,1724625334,172462533.4,10,61964,2750,1056,1178,122,1056,61964,122,1178,38.34881087,1.032842582,1.164212911,52545.25028,270.3306908,2.346545866,99112.61268,0.529564482,0.002718502,2.54208E-05,0.103565365,0.019011039,127,19
D:1| T0: 0.10| T1: 515.00| I0: 350.0| I1: 100.0| WTP: 450000,1,0.096153846,515,450000,1,0.2,350,100,-4936307242,1984179288,8156.396219,4528487431,452848743.1,26,62944,2712,1354,1355,1,1354,62944,1,1355,17.14160207,0.508010336,0.508527132,57402.42067,246.5074935,1.200516796,99086.05323,0.578721617,0.002483173,1.40881E-05,0.000738007,0.021527756,277,51
D:1| T0: 0.10| T1: 515.00| I0: 350.0| I1: 100.0| WTP: 450000,1,0.096153846,515,450000,1,0.2,350,100,-1672883771,677377223,10776.64854,1134051344,113405134.4,6,84378,3760,982,1790,808,982,84378,808,1790,137.5146199,2.754385965,5.076023392,44094.5,2006.149123,7.964912281,98893.07018,0.443490911,0.020177447,8.15647E-05,0.451396648,0.021214061,48,12
D:1| T0: 0.10| T1: 515.00| I0: 350.0| I1: 100.0| WTP: 450000,1,0.096153846,515,450000,1,0.2,350,100,-1636446099,973583301,10114.98174,1130697012,113069701.2,6,83161,3652,1049,1680,631,1049,83161,631,1680,116.6813472,2.593264249,4.191709845,43396.62953,1753.088083,6.904145078,98924.07772,0.436575097,0.017627865,7.11207E-05,0.375595238,0.020201777,56,12
D:1| T0: 0.10| T1: 515.00| I0: 350.0| I1: 100.0| WTP: 450000,1,0.096153846,515,450000,1,0.2,350,100,-1856171829,781062938,7679.789883,1472182335,147218233.5,8,67209,3246,1026,1275,249,1026,67209,249,1275,49.92288557,1.143034826,1.446517413,45508.20274,385.210199,2.715174129,98990.48507,0.459033208,0.003873499,2.87656E-05,0.195294118,0.018970674,115,16
D:1| T0: 0.10| T1: 515.00| I0: 350.0| I1: 100.0| WTP: 450000,1,0.096153846,515,450000,1,0.2,350,100,-1955668869,338783425,9537.685585,1478784589,147878458.9,8,78335,3480,1117,1584,467,1117,78335,467,1584,112.8989637,2.764248705,3.917098446,51237.18135,1650.994819,6.821243523,99078.8057,0.515062453,0.016597431,7.03429E-05,0.294823232,0.020220846,56,16
D:1| T0: 0.10| T1: 515.00| I0: 350.0| I1: 100.0| WTP: 450000,1,0.096153846,515,450000,1,0.2,350,100,-5506956753,1027579040,7327.122686,5140600619,514060061.9,30,59413,2665,1217,1217,0,1217,59413,0,1217,15.86297376,0.408163265,0.408163265,59802.89796,216.3338192,1.001457726,99200.62536,0.602288686,0.002177622,1.18936E-05,0,0.020483733,293,58
D:1| T0: 0.10| T1: 515.00| I0: 350.0| I1: 100.0| WTP: 450000,1,0.096153846,515,450000,1,0.2,350,100,-1865931660,764973813,9607.924304,1385535445,138553544.5,8,73580,3157,1077,1596,519,1077,73580,519,1596,80.74096386,2.03815261,3.0562249,45614.82129,1007.618474,5.230923695,98867.01406,0.459869481,0.010135448,5.40057E-05,0.32518797,0.021690677,71,15
D:1| T0: 0.10| T1: 515.00| I0: 350.0| I1: 100.0| WTP: 450000,1,0.096153846,515,450000,1,0.2,350,100,-1636982850,1245753446,10126.8896,1130638370,113063837,6,82957,3589,791,1682,891,791,82957,891,1682,146.1483871,2.432258065,5.270967742,44432.0129,1834.8,7.822580645,98945.21935,0.446895393,0.018438291,8.02072E-05,0.529726516,0.020275809,45,12
D:1| T0: 0.10| T1: 515.00| I0: 350.0| I1: 100.0| WTP: 450000,1,0.096153846,515,450000,1,0.2,350,100,-1558974130,1013177794,8890.602571,1114444001,111444400.1,6,67359,2884,1090,1477,387,1090,67359,387,1477,54.01221374,1.523664122,2.097709924,46385.86107,428.5923664,3.766412214,98854.17252,0.468359867,0.004312399,3.94282E-05,0.262017603,0.021927285,94,12
D:1| T0: 0.10| T1: 515.00| I0: 350.0| I1: 100.0| WTP: 450000,1,0.096153846,515,450000,1,0.2,350,100,-4183140054,1395089249,7341.996507,3816040229,381604022.9,22,51903,2187,1220,1220,0,1220,51903,0,1220,16.28404908,0.53803681,0.53803681,69622.19816,166.302454,1.295705521,99297.03374,0.700530991,0.001674692,1.50519E-05,0,0.023506291,233,43
D:1| T0: 0.10| T1: 515.00| I0: 350.0| I1: 100.0| WTP: 450000,1,0.096153846,515,450000,1,0.2,350,100,-4433261168,1339545835,5489.623261,4158780005,415878000.5,24,42809,1822,912,912,0,912,42809,0,912,8.800311405,0.20358116,0.20358116,73220.61035,126.6220319,0.561697158,99434.97158,0.735967993,0.001274029,7.12976E-06,0,0.021303931,367,47
D:1| T0: 0.10| T1: 515.00| I0: 350.0| I1: 100.0| WTP: 450000,1,0.096153846,515,450000,1,0.2,350,100,-1332052832,219139554,10832.89656,790408004.2,79040800.42,4,90154,4019,758,1799,1041,758,90154,1041,1799,289.5,4.191011236,9.938202247,41275.98315,1331.713483,14.19101124,98921.76404,0.415222809,0.01335809,0.000144089,0.578654808,0.019954744,26,8
D:1| T0: 0.10| T1: 515.00| I0: 350.0| I1: 100.0| WTP: 450000,1,0.096153846,515,450000,1,0.2,350,100,-2374684297,1336508942,7801.578572,1984605369,198460536.9,12,60037,2566,1272,1296,24,1272,60037,24,1296,34.42562432,1.184581976,1.210640608,58515.18567,262.514658,2.605863192,99125.47883,0.589592407,0.002641545,2.80339E-05,0.018518519,0.021587407,132,22
D:1| T0: 0.10| T1: 515.00| I0: 350.0| I1: 100.0| WTP: 450000,1,0.096153846,515,450000,1,0.2,350,100,-5271783372,448559423,6474.779499,4948044397,494804439.7,28,42418,1763,1076,1076,0,1076,42418,0,1076,11.84040297,0.397136797,0.397136797,73520.59544,173.6648993,0.953340403,99338.71792,0.739655482,0.001747667,1.1466E-05,0,0.02536659,270,56
D:1| T0: 0.10| T1: 515.00| I0: 350.0| I1: 100.0| WTP: 450000,1,0.096153846,515,450000,1,0.2,350,100,-1911483973,2110028840,8879.417722,1467513087,146751308.7,8,69517,3061,1230,1475,245,1230,69517,245,1475,51.83779972,1.576868829,1.902679831,47762.10014,479.5430183,3.631875882,98924.52186,0.481801812,0.004825597,3.83819E-05,0.166101695,0.021217832,102,16
D:1| T0: 0.10| T1: 515.00| I0: 350.0| I1: 100.0| WTP: 450000,1,0.096153846,515,450000,1,0.2,350,100,-1967411288,1982030155,9996.479795,1467587298,146758729.8,8,71617,2963,1139,1661,522,1139,71617,522,1661,88.08192771,2.621686747,3.848192771,52236.53012,1148.144578,6.590361446,98944.50602,0.526119546,0.01155041,6.78709E-05,0.314268513,0.023192817,60,16
D:1| T0: 0.10| T1: 515.00| I0: 350.0| I1: 100.0| WTP: 450000,1,0.096153846,515,450000,1,0.2,350,100,-1409392462,696219407,9306.462171,944069353.5,94406935.35,6,70618,3115,722,1546,824,722,70618,824,1546,120.0093168,2.105590062,4.639751553,52791.51553,731.7670807,6.863354037,99014.2205,0.531473813,0.007349119,7.07552E-05,0.532988357,0.021892435,46,10
D:1| T0: 0.10| T1: 515.00| I0: 350.0| I1: 100.0| WTP: 450000,1,0.096153846,515,450000,1,0.2,350,100,-1324873222,1402539442,10665.09851,791618296.9,79161829.69,4,93537,4147,701,1771,1070,701,93537,1070,1771,257.9359606,3.359605911,8.586206897,42599.54187,2112.738916,12.03448276,99011.71921,0.427492934,0.021198924,0.000122191,0.60417843,0.018933684,29,8
D:1| T0: 0.10| T1: 515.00| I0: 350.0| I1: 100.0| WTP: 450000,1,0.096153846,515,450000,1,0.2,350,100,-1616951961,1319833493,11312.62624,1051320650,105132065,6,88806,3972,720,1879,1159,720,88806,1159,1879,214.6410256,2.948717949,7.858974359,43348.15812,2568.15812,10.91452991,98904.40598,0.435550006,0.025803612,0.000111646,0.616817456,0.021158719,34,11
D:1| T0: 0.10| T1: 515.00| I0: 350.0| I1: 100.0| WTP: 450000,1,0.096153846,515,450000,1,0.2,350,100,-2480422689,663608076,8079.190216,2076463178,207646317.8,12,62998,2764,1221,1342,121,1221,62998,121,1342,29.84829991,0.929380994,1.031386225,48456.82214,332.4655623,2.092414996,98916.38187,0.489225786,0.003346432,2.24763E-05,0.090163934,0.021302264,164,23
D:1| T0: 0.10| T1: 515.00| I0: 350.0| I1: 100.0| WTP: 450000,1,0.096153846,515,450000,1,0.2,350,100,-2424069989,414696500,7038.820313,2072128973,207212897.3,12,57621,2510,1160,1169,9,1160,57621,9,1169,25.66827309,0.786345382,0.79437751,56169.849,321.0562249,1.721285141,99121.99679,0.566027763,0.003229199,1.88012E-05,0.007698888,0.020287742,177,23
D:1| T0: 0.10| T1: 515.00| I0: 350.0| I1: 100.0| WTP: 450000,1,0.096153846,515,450000,1,0.2,350,100,-3221971904,1249738535,7390.323771,2852455715,285245571.5,16,51733,2155,1228,1228,0,1228,51733,0,1228,20.92163009,0.764106583,0.764106583,68305.46944,162.830721,1.735893417,99242.21003,0.687657464,0.001639723,1.93512E-05,0,0.023737266,183,32
D:1| T0: 0.10| T1: 515.00| I0: 350.0| I1: 100.0| WTP: 450000,1,0.096153846,515,450000,1,0.2,350,100,-2197090595,614415382,7729.944272,1810593381,181059338.1,10,59012,2604,1244,1284,40,1244,59012,40,1284,33.97283177,1.13061651,1.175548589,56600.69383,389.8171369,2.469174504,99075.22362,0.570515045,0.003921616,2.65585E-05,0.031152648,0.021758655,137,20
D:1| T0: 0.10| T1: 515.00| I0: 350.0| I1: 100.0| WTP: 450000,1,0.096153846,515,450000,1,0.2,350,100,-4542252344,524899953,5732.932996,4255605694,425560569.4,24,49316,2261,952,952,0,952,49316,0,952,16.25524476,0.393356643,0.393356643,66831.09965,166.0582751,0.943473193,99354.69755,0.672228212,0.001670283,1.11421E-05,0,0.01930408,246,48
D:1| T0: 0.10| T1: 515.00| I0: 350.0| I1: 100.0| WTP: 450000,1,0.096153846,515,450000,1,0.2,350,100,-1298416506,1338977757,11848.84101,705974455.5,70597445.55,4,93037,4177,742,1968,1226,742,93037,1226,1968,246.6805556,3.384259259,9,30919.31944,1130.555556,12.43518519,98616.37963,0.311861299,0.011361959,0.000126125,0.62296748,0.021152875,31,7
D:1| T0: 0.10| T1: 515.00| I0: 350.0| I1: 100.0| WTP: 450000,1,0.096153846,515,450000,1,0.2,350,100,-1591392250,341384587,9462.256,1118279450,111827945,6,71935,3085,865,1572,707,865,71935,707,1572,64.07445008,1.304568528,2.485617597,41714.67174,415.0203046,3.947546531,98747.12521,0.421626689,0.004177007,4.15014E-05,0.449745547,0.021853366,85,12
D:1| T0: 0.10| T1: 515.00| I0: 350.0| I1: 100.0| WTP: 450000,1,0.096153846,515,450000,1,0.2,350,100,-1939928387,2032000160,9355.371822,1472159796,147215979.6,8,73150,3178,1100,1554,454,1100,73150,454,1554,92.42757009,2.453271028,3.478971963,48971.89019,1159.079439,6.039719626,98962.89019,0.493264602,0.011655925,6.23514E-05,0.292149292,0.021244019,62,16
D:1| T0: 0.10| T1: 515.00| I0: 350.0| I1: 100.0| WTP: 450000,1,0.096153846,515,450000,1,0.2,350,100,-1397049287,779488939,12224.57154,785820710.3,78582071.03,4,91732,3912,625,2031,1406,625,91732,1406,2031,228.8679245,2.844339623,9.438679245,44968.23113,1638.759434,12.38207547,98888.78302,0.451296361,0.016466312,0.000125932,0.692269818,0.022140583,31,8
D:1| T0: 0.10| T1: 515.00| I0: 350.0| I1: 100.0| WTP: 450000,1,0.096153846,515,450000,1,0.2,350,100,-2244564411,1449019578,8655.180538,1811805384,181180538.4,10,63798,2665,1335,1438,103,1335,63798,103,1438,32.52169625,1.140039448,1.237672584,52205.38363,390.8619329,2.551282051,98937.75542,0.526853522,0.003935021,2.75182E-05,0.07162726,0.022539892,144,20
D:1| T0: 0.10| T1: 515.00| I0: 350.0| I1: 100.0| WTP: 450000,1,0.096153846,515,450000,1,0.2,350,100,-3915048738,351952211,5498.05839,3640145819,364014581.9,22,48339,2224,913,913,0,913,48339,0,913,15.30672748,0.350627138,0.350627138,68855.18586,122.1328392,0.878563284,99415.51824,0.69218021,0.001228755,1.04522E-05,0,0.018888222,251,41
D:1| T0: 0.10| T1: 515.00| I0: 350.0| I1: 100.0| WTP: 450000,1,0.096153846,515,450000,1,0.2,350,100,-3229707763,486595046,7440.078752,2857703825,285770382.5,16,57827,2468,1223,1236,13,1223,57827,13,1236,16.02847931,0.536270822,0.543256314,52880.67706,256.8581408,1.206878023,99002.81139,0.533567014,0.002585236,1.32881E-05,0.010517799,0.021374468,264,32
D:1| T0: 0.10| T1: 515.00| I0: 350.0| I1: 100.0| WTP: 450000,1,0.096153846,515,450000,1,0.2,350,100,-1825607656,296745624,8891.755235,1381019894,138101989.4,8,71097,3074,991,1477,486,991,71097,486,1477,69.36095764,1.703499079,2.572744015,44953.53591,642.8213628,4.405156538,98891.53223,0.45344578,0.006463983,4.57015E-05,0.329045362,0.020774435,78,15
D:1| T0: 0.10| T1: 515.00| I0: 350.0| I1: 100.0| WTP: 450000,1,0.096153846,515,450000,1,0.2,350,100,-3109613743,1671484194,6761.884836,2771519501,277151950.1,16,56503,2540,1120,1123,3,1120,56503,3,1123,23.38403614,0.658885542,0.660391566,60376.81777,219.3350904,1.506024096,99217.04593,0.60805507,0.002206724,1.69725E-05,0.002671416,0.019875051,190,31
D:1| T0: 0.10| T1: 515.00| I0: 350.0| I1: 100.0| WTP: 450000,1,0.096153846,515,450000,1,0.2,350,100,-1400656959,422157396,12131.22765,794095577.1,79409557.71,4,96591,4263,730,2015,1285,730,96591,1285,2015,303.9602273,4.085227273,11.3125,36754.43182,2040.965909,15.46022727,98801.69318,0.369351593,0.02049057,0.000156608,0.637717122,0.020861157,26,8
D:1| T0: 0.10| T1: 515.00| I0: 350.0| I1: 100.0| WTP: 450000,1,0.096153846,515,450000,1,0.2,350,100,-1402373523,1916599091,12202.70418,792238313.8,79223831.38,4,94779,4116,740,2027,1287,740,94779,1287,2027,278.4787234,3.877659574,10.63297872,35077.48936,1759.478723,14.56382979,98720.57979,0.353014342,0.017671537,0.000147862,0.634928466,0.021386594,27,8
D:1| T0: 0.10| T1: 515.00| I0: 350.0| I1: 100.0| WTP: 450000,1,0.096153846,515,450000,1,0.2,350,100,-1394522098,1005953941,12016.98896,793672650.1,79367265.01,4,96439,4253,739,1996,1257,739,96439,1257,1996,300.8587571,4.107344633,11.1299435,35529.49153,2208.711864,15.31638418,98792.36723,0.357169885,0.022171188,0.000155156,0.629759519,0.020697021,26,8
D:1| T0: 0.10| T1: 515.00| I0: 350.0| I1: 100.0| WTP: 450000,1,0.096153846,515,450000,1,0.2,350,100,-1351808627,1422765615,11418.30215,780893519.3,78089351.93,4,84828,3612,733,1897,1164,733,84828,1164,1897,138.1939394,2.115151515,5.615151515,35722.34242,890.2272727,7.851515152,98624.77576,0.360262854,0.008957915,8.01868E-05,0.613600422,0.022362899,48,8
D:1| T0: 0.10| T1: 515.00| I0: 350.0| I1: 100.0| WTP: 450000,1,0.096153846,515,450000,1,0.2,350,100,-4228123661,699740192,6524.677461,3901889787,390188978.7,22,47875,1996,1084,1084,0,1084,47875,0,1084,16.47122762,0.493606138,0.493606138,73489.03133,183.2525575,1.186061381,99419.09399,0.738662547,0.00184361,1.39285E-05,0,0.022642298,224,44
D:1| T0: 0.10| T1: 515.00| I0: 350.0| I1: 100.0| WTP: 450000,1,0.096153846,515,450000,1,0.2,350,100,-4707023400,240885764,5593.593165,4427343742,442734374.2,26,46201,2136,929,929,0,929,46201,0,929,13.84520621,0.324584896,0.324584896,71357.29834,151.0862346,0.811462239,99442.08677,0.717136761,0.001519341,9.99282E-06,0,0.02008658,267,50
D:1| T0: 0.10| T1: 515.00| I0: 350.0| I1: 100.0| WTP: 450000,1,0.096153846,515,450000,1,0.2,350,100,-1581553720,2023806564,9122.285902,1125439425,112543942.5,6,76148,3443,814,1515,701,814,76148,701,1515,91.77223427,1.650759219,3.15835141,39103.4859,691.2494577,4.934924078,98828.77007,0.394598588,0.006949047,5.07944E-05,0.462706271,0.019895989,66,12
D:1| T0: 0.10| T1: 515.00| I0: 350.0| I1: 100.0| WTP: 450000,1,0.096153846,515,450000,1,0.2,350,100,-3557687725,1907493879,7042.767173,3205549367,320554936.7,18,53151,2268,1170,1170,0,1170,53151,0,1170,16.79456907,0.522432113,0.522432113,61118.89315,196.4191263,1.216646989,99155.99055,0.615907552,0.00197704,1.38864E-05,0,0.022012756,241,36
D:1| T0: 0.10| T1: 515.00| I0: 350.0| I1: 100.0| WTP: 450000,1,0.096153846,515,450000,1,0.2,350,100,-2006116322,1565815291,10623.41755,1474945445,147494544.5,8,76751,3304,1108,1765,657,1108,76751,657,1765,121.8869048,3.175595238,5.077380952,53762.17857,1840.910714,8.375,99013.96131,0.540680734,0.018513514,8.60053E-05,0.37223796,0.022996443,48,16
D:1| T0: 0.10| T1: 515.00| I0: 350.0| I1: 100.0| WTP: 450000,1,0.096153846,515,450000,1,0.2,350,100,-4205690363,784442364,6009.252836,3905227721,390522772.1,22,50954,2269,998,998,0,998,50954,0,998,17.99034749,0.451093951,0.451093951,69793.39575,173.1589447,1.092664093,99417.48198,0.701555278,0.001741625,1.29003E-05,0,0.019586294,221,44
D:1| T0: 0.10| T1: 515.00| I0: 350.0| I1: 100.0| WTP: 450000,1,0.096153846,515,450000,1,0.2,350,100,-1328696419,206369745,10808.1209,788290373.8,78829037.38,4,89831,3978,651,1795,1144,651,89831,1144,1795,221.8854626,2.748898678,7.735682819,43566.67401,1652.828194,10.59911894,98966.01322,0.437483646,0.016592473,0.000108216,0.637325905,0.019981966,33,8
D:1| T0: 0.10| T1: 515.00| I0: 350.0| I1: 100.0| WTP: 450000,1,0.096153846,515,450000,1,0.2,350,100,-1399854953,2087235992,12154.60119,792124894.1,79212489.41,4,96085,4163,716,2019,1303,716,96085,1303,2019,244.4439252,3.271028037,9.299065421,35212.33178,1958.341121,12.64485981,98751.13084,0.353717758,0.019681409,0.000128441,0.645368995,0.021012645,31,8
D:1| T0: 0.10| T1: 515.00| I0: 350.0| I1: 100.0| WTP: 450000,1,0.096153846,515,450000,1,0.2,350,100,-1888918648,1019092536,8428.974663,1467469915,146746991.5,8,68486,3012,1175,1400,225,1175,68486,225,1400,47.73514212,1.351421189,1.630490956,47432.21189,489.2596899,3.147286822,98953.3553,0.478391663,0.004922074,3.34598E-05,0.160714286,0.020442433,111,16
D:1| T0: 0.10| T1: 515.00| I0: 350.0| I1: 100.0| WTP: 450000,1,0.096153846,515,450000,1,0.2,350,100,-1516146340,1885906113,8126.405233,1109826079,110982607.9,6,62004,2636,1026,1350,324,1026,62004,324,1350,66.26868687,1.884848485,2.525252525,53878.5596,383.0848485,4.612121212,99027.85657,0.543218206,0.00385044,4.82333E-05,0.24,0.021774545,71,12
D:1| T0: 0.10| T1: 515.00| I0: 350.0| I1: 100.0| WTP: 450000,1,0.096153846,515,450000,1,0.2,350,100,-3777405918,2028637200,7630.231721,3395894332,339589433.2,22,63138,2920,1266,1267,1,1266,63138,1,1267,28.79230769,0.767692308,0.768461538,58184.86385,187.8684615,1.743846154,99169.40385,0.586073225,0.001891695,1.95935E-05,0.000789266,0.02006779,186,38
D:1| T0: 0.10| T1: 515.00| I0: 350.0| I1: 100.0| WTP: 450000,1,0.096153846,515,450000,1,0.2,350,100,-1348419305,181476086,11216.21996,787608306.9,78760830.69,4,90943,4062,602,1863,1261,602,90943,1261,1863,222.6339286,2.558035714,8.147321429,41150.10714,1895.102679,10.85267857,98895.33036,0.413318973,0.019025792,0.000110546,0.676865271,0.020485359,32,8
D:1| T0: 0.10| T1: 515.00| I0: 350.0| I1: 100.0| WTP: 450000,1,0.096153846,515,450000,1,0.2,350,100,-1373254053,2097578470,11685.14698,788996704.4,78899670.44,4,89677,4071,709,1941,1232,709,89677,1232,1941,204.465587,2.761133603,7.71659919,39028.49798,1979.57085,10.57894737,98772.87449,0.392509754,0.019896899,0.00010786,0.634724369,0.021644346,36,8
D:1| T0: 0.10| T1: 515.00| I0: 350.0| I1: 100.0| WTP: 450000,1,0.096153846,515,450000,1,0.2,350,100,-1912530852,119646392,8909.355244,1467063090,146706309,8,66475,2877,1148,1480,332,1148,66475,332,1480,80.0372807,2.401315789,3.10745614,54870.66009,920.9802632,5.61622807,99036.08114,0.55261572,0.009258779,5.79312E-05,0.224324324,0.022264009,66,16
D:1| T0: 0.10| T1: 515.00| I0: 350.0| I1: 100.0| WTP: 450000,1,0.096153846,515,450000,1,0.2,350,100,-1370247682,1298895859,11601.48818,790173272.4,79017327.24,4,93306,4115,776,1927,1151,776,93306,1151,1927,241.3113208,3.566037736,8.938679245,37637.36321,1834.410377,12.61320755,98806.64151,0.378343302,0.018428409,0.000128055,0.597301505,0.020652477,31,8
D:1| T0: 0.10| T1: 515.00| I0: 350.0| I1: 100.0| WTP: 450000,1,0.096153846,515,450000,1,0.2,350,100,-1281086956,1489316290,10024.69192,779852360.3,77985236.03,4,79345,3565,660,1665,1005,660,79345,1005,1665,180.0277778,2.492063492,6.44047619,46518.76587,1094.714286,9.075396825,98935.94841,0.468242795,0.010993592,9.26423E-05,0.603603604,0.020984309,36,8
D:1| T0: 0.10| T1: 515.00| I0: 350.0| I1: 100.0| WTP: 450000,1,0.096153846,515,450000,1,0.2,350,100,-1452302520,855602142,13311.86476,786709281.5,78670928.15,4,96804,3861,655,2212,1557,655,96804,1557,2212,211.2857143,2.761904762,9.454545455,32627.65368,1496.593074,12.29004329,98553.32468,0.327857515,0.015056015,0.000124876,0.703887884,0.022850295,33,8
D:1| T0: 0.10| T1: 515.00| I0: 350.0| I1: 100.0| WTP: 450000,1,0.096153846,515,450000,1,0.2,350,100,-1814548709,1438649896,8640.058816,1382545768,138254576.8,8,69989,3087,1053,1435,382,1053,69989,382,1435,62.58995138,1.585089141,2.196110211,45529.67585,577.2155592,3.904376013,98911.89465,0.459269985,0.00580605,4.0552E-05,0.266202091,0.020503222,88,15
D:1| T0: 0.10| T1: 515.00| I0: 350.0| I1: 100.0| WTP: 450000,1,0.096153846,515,450000,1,0.2,350,100,-4978624815,952489126,7474.110567,4604919287,460491928.7,26,54345,2203,1242,1242,0,1242,54345,0,1242,13.66683831,0.452626159,0.452626159,64239.90062,214.3424305,1.083419156,99200.48095,0.647009671,0.002157902,1.28642E-05,0,0.022853988,278,52
D:1| T0: 0.10| T1: 515.00| I0: 350.0| I1: 100.0| WTP: 450000,1,0.096153846,515,450000,1,0.2,350,100,-1139908859,1550779155,10709.2349,604447113.9,60444711.39,4,84344,3554,549,1779,1230,549,84344,1230,1779,228.5606061,2.666666667,8.833333333,31327.41919,1191.515152,11.61616162,98631.5101,0.317057843,0.011953381,0.00011807,0.691399663,0.021092194,29,6
D:1| T0: 0.10| T1: 515.00| I0: 350.0| I1: 100.0| WTP: 450000,1,0.096153846,515,450000,1,0.2,350,100,-4411035585,607323321,6651.187282,4078476221,407847622.1,24,50277,2173,1105,1105,0,1105,50277,0,1105,15.6771327,0.466824645,0.466824645,67523.05569,143.9994076,1.115521327,99292.17654,0.679557676,0.001449751,1.31573E-05,0,0.021978241,242,46
D:1| T0: 0.10| T1: 515.00| I0: 350.0| I1: 100.0| WTP: 450000,1,0.096153846,515,450000,1,0.2,350,100,-1508441244,2103646485,7946.611489,1111110670,111111067,6,62287,2719,864,1320,456,864,62287,456,1320,63.35084428,1.491557223,2.335834897,50390.0863,351.3320826,3.943714822,98970.16135,0.508481349,0.003531716,4.11747E-05,0.345454545,0.021192223,77,12
D:1| T0: 0.10| T1: 515.00| I0: 350.0| I1: 100.0| WTP: 450000,1,0.096153846,515,450000,1,0.2,350,100,-1187916302,258120157,9816.134032,697109600.8,69710960.08,4,86490,3877,765,1630,865,765,86490,865,1630,274.125,4.25,9.079545455,37882.96023,1249.409091,13.42045455,98913.35227,0.38198227,0.012523214,0.000136465,0.530674847,0.018846109,26,7
D:1| T0: 0.10| T1: 515.00| I0: 350.0| I1: 100.0| WTP: 450000,1,0.096153846,515,450000,1,0.2,350,100,-2805862157,1068951401,7568.809567,2427421678,242742167.8,16,63049,2859,1222,1257,35,1222,63049,35,1257,33.89030362,1.016650343,1.05093046,55004.72184,240.7277179,2.240940255,99116.79824,0.554311012,0.002422399,2.44099E-05,0.027844073,0.019937191,146,27
D:1| T0: 0.10| T1: 515.00| I0: 350.0| I1: 100.0| WTP: 450000,1,0.096153846,515,450000,1,0.2,350,100,-2213380924,635956235,8012.909379,1812735455,181273545.5,10,61976,2736,1223,1331,108,1223,61976,108,1331,28.34062237,0.923465097,1.015138772,48376.36838,396.2842725,2.047098402,98906.68966,0.488402099,0.003987702,2.1605E-05,0.081141998,0.021476055,169,20
D:1| T0: 0.10| T1: 515.00| I0: 350.0| I1: 100.0| WTP: 450000,1,0.096153846,515,450000,1,0.2,350,100,-4274168659,1346693470,5743.095969,3987013860,398701386,24,46286,2001,954,954,0,954,46286,0,954,15.67200512,0.420884049,0.420884049,73704.0583,151.9212044,1.028827675,99462.6829,0.740602794,0.001528039,1.22736E-05,0,0.020610984,223,45
D:1| T0: 0.10| T1: 515.00| I0: 350.0| I1: 100.0| WTP: 450000,1,0.096153846,515,450000,1,0.2,350,100,-1436811384,847102011,12905.10747,791556010.2,79155601.02,4,96205,4107,751,2144,1393,751,96205,1393,2144,273.8465608,3.899470899,11.17989418,35680.60317,1746.306878,15.15873016,98687.22751,0.35874908,0.017551088,0.000153949,0.649720149,0.022285744,27,8
D:1| T0: 0.10| T1: 515.00| I0: 350.0| I1: 100.0| WTP: 450000,1,0.096153846,515,450000,1,0.2,350,100,-1714735427,812083272,11705.96907,1129436974,112943697.4,6,83229,3514,929,1945,1016,929,83229,1016,1945,144.9046053,2.927631579,6.226973684,47286.86513,1685.930921,9.289473684,98850.78289,0.475603073,0.016966441,9.51709E-05,0.522365039,0.023369258,44,12
D:1| T0: 0.10| T1: 515.00| I0: 350.0| I1: 100.0| WTP: 450000,1,0.096153846,515,450000,1,0.2,350,100,-1329200586,2146825809,10784.68261,789966455.8,78996645.58,4,92017,4213,791,1791,1000,791,92017,1000,1791,304.4285714,4.642857143,10.5,37555.85714,1728.714286,15.19642857,98890.13095,0.378191999,0.017334485,0.000154162,0.558347292,0.019463795,24,8
D:1| T0: 0.10| T1: 515.00| I0: 350.0| I1: 100.0| WTP: 450000,1,0.096153846,515,450000,1,0.2,350,100,-1422160518,226186520,12664.04666,788958184.6,78895818.46,4,95343,4023,741,2104,1363,741,95343,1363,2104,260.0829016,3.797927461,10.79274611,37185.46114,1436.834197,14.62176166,98720.09845,0.373754352,0.014436702,0.00014812,0.647813688,0.022067692,28,8
D:1| T0: 0.10| T1: 515.00| I0: 350.0| I1: 100.0| WTP: 450000,1,0.096153846,515,450000,1,0.2,350,100,-1671403457,1110225441,10793.9403,1131706442,113170644.2,6,83782,3620,1052,1793,741,1052,83782,741,1793,109.9299517,2.446859903,4.200483092,41402.09903,1563.417874,6.734299517,98811.07971,0.416752734,0.015736354,6.91861E-05,0.413273843,0.021400778,60,12
D:1| T0: 0.10| T1: 515.00| I0: 350.0| I1: 100.0| WTP: 450000,1,0.096153846,515,450000,1,0.2,350,100,-1549218757,1190767082,8438.31671,1127302922,112730292.2,6,76949,3602,948,1401,453,948,76949,453,1401,118.9835616,2.449315068,3.660273973,47656.75068,1125.112329,6.265753425,99097.87671,0.479408559,0.011297258,6.46439E-05,0.323340471,0.018206864,53,12
D:1| T0: 0.10| T1: 515.00| I0: 350.0| I1: 100.0| WTP: 450000,1,0.096153846,515,450000,1,0.2,350,100,-2435448421,2108234095,7385.219293,2066187457,206618745.7,12,55530,2286,1169,1227,58,1169,55530,58,1227,23.82895851,0.857747671,0.904318374,55397.91194,287.1193903,1.900931414,99024.49111,0.558900773,0.002888462,2.03958E-05,0.047269764,0.022096164,169,23
D:1| T0: 0.10| T1: 515.00| I0: 350.0| I1: 100.0| WTP: 450000,1,0.096153846,515,450000,1,0.2,350,100,-1427185703,465621985,12659.72959,794199223.5,79419922.35,4,95321,4277,739,2103,1364,739,95321,1364,2103,254.4666667,3.428571429,9.880952381,29536.09524,1563.871429,13.39047619,98550.21429,0.297670185,0.015724434,0.000136115,0.648597242,0.022062295,30,8
D:1| T0: 0.10| T1: 515.00| I0: 350.0| I1: 100.0| WTP: 450000,1,0.096153846,515,450000,1,0.2,350,100,-2041278679,1487072553,7960.73609,1643241875,164324187.5,10,65231,2997,1217,1322,105,1217,65231,105,1322,51.45655172,1.499310345,1.63862069,54990.30345,322.5186207,3.313103448,99088.80414,0.554205933,0.003244994,3.52069E-05,0.079425113,0.020267681,104,18
D:1| T0: 0.10| T1: 515.00| I0: 350.0| I1: 100.0| WTP: 450000,1,0.096153846,515,450000,1,0.2,350,100,-1585188215,1213733847,9300.804262,1120148002,112014800.2,6,70532,3040,894,1545,651,894,70532,651,1545,119.8707692,2.618461538,4.593846154,51998.73538,921.44,7.335384615,99000.21846,0.523719141,0.009257401,7.54013E-05,0.421359223,0.021904951,47,12
D:1| T0: 0.10| T1: 515.00| I0: 350.0| I1: 100.0| WTP: 450000,1,0.096153846,515,450000,1,0.2,350,100,-1284823097,2003658337,10197.28708,774958743.2,77495874.32,4,78538,3342,749,1694,945,749,78538,945,1694,140.7766667,2.353333333,5.473333333,47004.39,1069.653333,7.96,98919.34667,0.473175567,0.010748333,8.18436E-05,0.55785124,0.021570001,43,8
D:1| T0: 0.10| T1: 515.00| I0: 350.0| I1: 100.0| WTP: 450000,1,0.096153846,515,450000,1,0.2,350,100,-4938267776,1170868072,6621.997933,4607167879,460716787.9,28,54286,2359,1100,1100,0,1100,54286,0,1100,14.33383992,0.367781155,0.367781155,65993.7695,159.6236069,0.93414387,99322.43364,0.663876083,0.001606751,1.12008E-05,0,0.020263051,282,52
D:1| T0: 0.10| T1: 515.00| I0: 350.0| I1: 100.0| WTP: 450000,1,0.096153846,515,450000,1,0.2,350,100,-1248387758,569919592,10946.42582,701066467.4,70106646.74,4,90927,4036,754,1818,1064,754,90927,1064,1818,253.4723618,3.698492462,8.979899497,30524.05528,1191.648241,12.79396985,98700.54774,0.30818856,0.011961138,0.000129833,0.585258526,0.019994061,29,7
D:1| T0: 0.10| T1: 515.00| I0: 350.0| I1: 100.0| WTP: 450000,1,0.096153846,515,450000,1,0.2,350,100,-1536052886,1833180623,8233.200098,1124392881,112439288.1,6,73609,3467,1010,1367,357,1010,73609,357,1367,94.02031603,2.119638826,2.898419865,46665.58916,775.4740406,5.162528217,99053.39278,0.469996077,0.007789716,5.39094E-05,0.261155816,0.018571099,64,12
D:1| T0: 0.10| T1: 515.00| I0: 350.0| I1: 100.0| WTP: 450000,1,0.096153846,515,450000,1,0.2,350,100,-1449906411,1123666637,13169.32017,791440402.2,79144040.22,4,93680,4045,755,2188,1433,755,93680,1433,2188,305.5621302,4.384615385,12.77514793,40612.14201,1667.100592,17.24260355,98739.3432,0.408409567,0.01674863,0.000174963,0.654936015,0.023356106,25,8
D:1| T0: 0.10| T1: 515.00| I0: 350.0| I1: 100.0| WTP: 450000,1,0.096153846,515,450000,1,0.2,350,100,-1704109548,1682024981,11412.92154,1133463471,113346347.1,6,89643,3842,764,1896,1132,764,89643,1132,1896,188.3951613,2.943548387,7.475806452,45053.7621,2954.197581,10.55241935,98945.47581,0.452364142,0.029691437,0.000107839,0.597046414,0.021150564,35,12
D:1| T0: 0.10| T1: 515.00| I0: 350.0| I1: 100.0| WTP: 450000,1,0.096153846,515,450000,1,0.2,350,100,-1614347386,1687523543,9853.780441,1121658364,112165836.4,6,73916,3191,910,1637,727,910,73916,727,1637,121.412844,2.660550459,4.856269113,51852.32722,863.6544343,7.617737003,98992.85015,0.521887287,0.008680329,7.82927E-05,0.44410507,0.02214736,47,12
D:1| T0: 0.10| T1: 515.00| I0: 350.0| I1: 100.0| WTP: 450000,1,0.096153846,515,450000,1,0.2,350,100,-1345635842,178034412,11156.26963,787822360.1,78782236.01,4,88629,4029,653,1853,1200,653,88629,1200,1853,261.5811518,3.287958115,9.523560209,46469.73822,1635.806283,12.93717277,98981.01571,0.466733283,0.016413064,0.000131658,0.647598489,0.020907378,28,8
D:1| T0: 0.10| T1: 515.00| I0: 350.0| I1: 100.0| WTP: 450000,1,0.096153846,515,450000,1,0.2,350,100,-1343632261,739490003,11055.20661,790871930.9,79087193.09,4,91593,4084,689,1836,1147,689,91593,1147,1836,260.4773869,3.376884422,9.085427136,41796.68844,1289.628141,12.54271357,98924.0804,0.419874794,0.012941805,0.00012734,0.624727669,0.0200452,29,8
D:1| T0: 0.10| T1: 515.00| I0: 350.0| I1: 100.0| WTP: 450000,1,0.096153846,515,450000,1,0.2,350,100,-1553233087,178482706,10405.85626,1032940274,103294027.4,6,74832,3109,748,1729,981,748,74832,981,1729,105.8054054,1.886486486,4.510810811,44486.69189,865.7702703,6.52972973,98771.49189,0.44878558,0.008704529,6.73512E-05,0.567379988,0.023105397,53,11
D:1| T0: 0.10| T1: 515.00| I0: 350.0| I1: 100.0| WTP: 450000,1,0.096153846,515,450000,1,0.2,350,100,-1531958326,1919366370,9979.550375,1032980808,103298080.8,6,71648,3083,914,1658,744,914,71648,744,1658,65.85016835,1.427609428,2.668350168,41756.26263,416.1902357,4.19023569,98679.4899,0.422029262,0.004190934,4.35861E-05,0.448733414,0.023140911,85,11
D:1| T0: 0.10| T1: 515.00| I0: 350.0| I1: 100.0| WTP: 450000,1,0.096153846,515,450000,1,0.2,350,100,-1350194507,1819796913,11110.46298,794671358.1,79467135.81,4,96556,4424,693,1845,1152,693,96556,1152,1845,305.4971751,3.858757062,10.31638418,39525.46893,2242.305085,14.22033898,98959.40113,0.396708982,0.022489033,0.000143838,0.624390244,0.019108082,26,8
D:1| T0: 0.10| T1: 515.00| I0: 350.0| I1: 100.0| WTP: 450000,1,0.096153846,515,450000,1,0.2,350,100,-1687407474,1866591913,11129.97502,1130908723,113090872.3,6,83745,3646,1088,1849,761,1088,83745,761,1849,108.7070218,2.520581114,4.319612591,44543.16949,1673.42615,6.96125908,98850.49395,0.448054997,0.016843643,7.16161E-05,0.411573824,0.02207893,59,12
D:1| T0: 0.10| T1: 515.00| I0: 350.0| I1: 100.0| WTP: 450000,1,0.096153846,515,450000,1,0.2,350,100,-1283167706,1219425989,11643.03443,701015984.6,70101598.46,4,90737,4104,792,1934,1142,792,90737,1142,1934,271.2054054,4.194594595,10.29189189,32771.8973,1265.313514,14.56216216,98674.60541,0.330799664,0.012702179,0.000148043,0.590486039,0.021314348,27,7
D:1| T0: 0.10| T1: 515.00| I0: 350.0| I1: 100.0| WTP: 450000,1,0.096153846,515,450000,1,0.2,350,100,-1375186767,502409586,11691.69309,790602112.6,79060211.26,4,94589,4132,740,1942,1202,740,94589,1202,1942,234.9086758,3.292237443,8.716894977,35365.22374,1740.424658,12.12328767,98775.38813,0.355504956,0.017480772,0.000123025,0.618949537,0.020530929,32,8
D:1| T0: 0.10| T1: 515.00| I0: 350.0| I1: 100.0| WTP: 450000,1,0.096153846,515,450000,1,0.2,350,100,-1298231005,1405887957,10390.66199,778697905.8,77869790.58,4,81475,3596,731,1726,995,731,81475,995,1726,190.7467811,3.017167382,7.253218884,47510.91416,1061.261803,10.39484979,98959.02575,0.477923174,0.010656147,0.000105861,0.576477404,0.021184412,34,8
D:1| T0: 0.10| T1: 515.00| I0: 350.0| I1: 100.0| WTP: 450000,1,0.096153846,515,450000,1,0.2,350,100,-1310750888,283033753,10772.86618,772107578.5,77210757.85,4,78441,3243,736,1790,1054,736,78441,1054,1790,159.4703557,2.754940711,6.865612648,46613.99605,821.6679842,9.794466403,98849.01581,0.469582242,0.008255853,0.000100309,0.588826816,0.022819699,37,8
D:1| T0: 0.10| T1: 515.00| I0: 350.0| I1: 100.0| WTP: 450000,1,0.096153846,515,450000,1,0.2,350,100,-1631707308,1083157068,10178.47526,1122783545,112278354.5,6,75552,3236,1104,1691,587,1104,75552,587,1691,82.34836066,2.096311475,3.266393443,42607.33607,785.3504098,5.540983607,98773.31967,0.429969257,0.007901423,5.76564E-05,0.347131875,0.022381936,70,12
D:1| T0: 0.10| T1: 515.00| I0: 350.0| I1: 100.0| WTP: 450000,1,0.096153846,515,450000,1,0.2,350,100,-1575601853,1988704626,9315.465025,1109828602,110982860.2,6,64252,2684,1092,1548,456,1092,64252,456,1548,52.1364366,1.566613162,2.290529695,49615.64045,264.8988764,4.048154093,98808.39647,0.501301032,0.002667251,4.26434E-05,0.294573643,0.024092635,89,12
D:1| T0: 0.10| T1: 515.00| I0: 350.0| I1: 100.0| WTP: 450000,1,0.096153846,515,450000,1,0.2,350,100,-1235553535,884761309,10818.19661,694643704,69464370.4,4,83967,3749,680,1797,1117,680,83967,1117,1797,191.8065844,2.703703704,7.279835391,29886.15226,898.345679,10.08230453,98566.96708,0.302686556,0.009023984,0.000102489,0.621591541,0.02140152,35,7
D:1| T0: 0.10| T1: 515.00| I0: 350.0| I1: 100.0| WTP: 450000,1,0.096153846,515,450000,1,0.2,350,100,-2432904109,533485933,7106.619591,2077573130,207757313,14,61168,2859,1166,1180,14,1166,61168,14,1180,32.8639329,0.910531221,0.923578751,55016.88537,154.5442684,1.996272134,99146.40541,0.554352644,0.001555458,2.19729E-05,0.011864407,0.019291133,154,23
D:1| T0: 0.10| T1: 515.00| I0: 350.0| I1: 100.0| WTP: 450000,1,0.096153846,515,450000,1,0.2,350,100,-2133594086,632196071,8204.503103,1723368931,172336893.1,12,63010,2699,1278,1363,85,1278,63010,85,1363,39.55946602,1.356796117,1.455097087,55219.78519,197.9575243,3.008495146,99043.29612,0.55683503,0.001993238,3.22337E-05,0.062362436,0.021633547,118,19
D:1| T0: 0.10| T1: 515.00| I0: 350.0| I1: 100.0| WTP: 450000,1,0.096153846,515,450000,1,0.2,350,100,-1367451527,393400457,11482.34108,793334472.9,79333447.29,4,94442,4189,581,1907,1326,581,94442,1326,1907,266.935,2.815,9.385,40691.735,1473.695,12.275,98891.985,0.408448052,0.014792933,0.000124897,0.695332984,0.020192287,29,8
D:1| T0: 0.10| T1: 515.00| I0: 350.0| I1: 100.0| WTP: 450000,1,0.096153846,515,450000,1,0.2,350,100,-1308958325,398973227,10671.83767,775366441.6,77536644.16,4,79252,3307,687,1773,1086,687,79252,1086,1773,156.6273063,2.420664207,6.383763838,44968.54613,876.2804428,8.915129151,98833.99631,0.453017302,0.00880499,9.123E-05,0.612521151,0.02237224,39,8
D:1| T0: 0.10| T1: 515.00| I0: 350.0| I1: 100.0| WTP: 450000,1,0.096153846,515,450000,1,0.2,350,100,-1632435487,1402256491,10019.10245,1131480364,113148036.4,6,81489,3659,898,1664,766,898,81489,766,1664,145.1238095,2.720634921,5.126984127,46008.50794,1633.187302,7.984126984,98967.87302,0.462769249,0.016412544,8.17556E-05,0.460336538,0.020419934,45,12
D:1| T0: 0.10| T1: 515.00| I0: 350.0| I1: 100.0| WTP: 450000,1,0.096153846,515,450000,1,0.2,350,100,-1417702314,2102527413,12585.78621,788413003.6,78841300.36,4,91625,3900,698,2091,1393,698,91625,1393,2091,198.4365079,2.662698413,8.154761905,39848.72619,2102.353175,10.92063492,98734.33333,0.400390378,0.021147796,0.000111369,0.666188427,0.022821282,36,8
D:1| T0: 0.10| T1: 515.00| I0: 350.0| I1: 100.0| WTP: 450000,1,0.096153846,515,450000,1,0.2,350,100,-1376646080,1748031099,11822.1405,785539054.7,78553905.47,4,91504,3881,672,1964,1292,672,91504,1292,1964,205.0805085,2.737288136,8.177966102,38983.5339,2100.516949,11.00847458,98797.72458,0.39176593,0.021109395,0.000112304,0.657841141,0.021464012,34,8
D:1| T0: 0.10| T1: 515.00| I0: 350.0| I1: 100.0| WTP: 450000,1,0.096153846,515,450000,1,0.2,350,100,-1893686662,1946754629,8578.23922,1464774701,146477470.1,8,65190,2894,1192,1425,233,1192,65190,233,1425,45.28791774,1.367609254,1.650385604,50899.08098,322.033419,3.176092545,98944.10283,0.513580407,0.003241133,3.38349E-05,0.163508772,0.021859181,112,16
D:1| T0: 0.10| T1: 515.00| I0: 350.0| I1: 100.0| WTP: 450000,1,0.096153846,515,450000,1,0.2,350,100,-1513576986,2097712204,8013.258541,1112914059,111291405.9,6,64921,2912,1013,1331,318,1013,64921,318,1331,62.7920434,1.638336347,2.198915009,51456.95118,366.3562387,4.048824593,99031.05606,0.518807863,0.003683309,4.25992E-05,0.238918107,0.020501841,79,12
D:1| T0: 0.10| T1: 515.00| I0: 350.0| I1: 100.0| WTP: 450000,1,0.096153846,515,450000,1,0.2,350,100,-1885383761,1198827119,8427.924174,1463987552,146398755.2,8,61458,2695,1235,1400,165,1235,61458,165,1400,46.82479784,1.517520216,1.735849057,54867.54582,532.3989218,3.396226415,98998.42453,0.553175636,0.005355092,3.57125E-05,0.117857143,0.022779785,106,16
D:1| T0: 0.10| T1: 515.00| I0: 350.0| I1: 100.0| WTP: 450000,1,0.096153846,515,450000,1,0.2,350,100,-4865291188,109253198,5428.574096,4593862483,459386248.3,26,40701,1752,902,902,0,902,40701,0,902,9.925084582,0.274528758,0.274528758,74247.00338,137.717738,0.708071532,99435.79894,0.74630868,0.001385172,8.75441E-06,0,0.022161618,295,52
D:1| T0: 0.10| T1: 515.00| I0: 350.0| I1: 100.0| WTP: 450000,1,0.096153846,515,450000,1,0.2,350,100,-2886381156,314481292,7501.520441,2511305134,251130513.4,18,60334,2675,1241,1246,5,1241,60334,5,1246,32.58568548,1.046370968,1.050403226,62055.66835,181.1582661,2.307459677,99221.42641,0.624778738,0.001823539,2.52021E-05,0.004012841,0.020651706,142,28
D:1| T0: 0.10| T1: 515.00| I0: 350.0| I1: 125.0| WTP: 500000,1,0.096153846,515,500000,1,0.2,350,125,-3882571484,1178568022,8149.93095,3475074936,347507493.6,22,59933,2564,1354,1354,0,1354,59933,0,1354,21.25761589,0.68410596,0.68410596,61174.40464,205.0622517,1.586092715,99127.72715,0.616394964,0.00206582,1.80439E-05,0,0.022593779,215,39
D:1| T0: 0.10| T1: 515.00| I0: 350.0| I1: 125.0| WTP: 500000,1,0.096153846,515,500000,1,0.2,350,125,-1383520751,2029998696,11830.2407,792008715.4,79200871.54,4,94945,4164,648,1965,1317,648,94945,1317,1965,230.8502203,2.753303965,8.524229075,35657.04846,1414.511013,11.37444934,98757.2467,0.358235323,0.014213002,0.00011567,0.670229008,0.020696193,33,8
D:1| T0: 0.10| T1: 515.00| I0: 350.0| I1: 125.0| WTP: 500000,1,0.096153846,515,500000,1,0.2,350,125,-1413972414,776062361,12590.52504,784446162.6,78444616.26,4,92374,3822,796,2092,1296,796,92374,1296,2092,176.2304833,2.862453532,7.643122677,39223.80669,2136.762082,10.60594796,98727.87361,0.394065151,0.021505698,0.000108069,0.619502868,0.022647065,38,8
D:1| T0: 0.10| T1: 515.00| I0: 350.0| I1: 125.0| WTP: 500000,1,0.096153846,515,500000,1,0.2,350,125,-3691201622,1813046880,7802.049657,3301099139,330109913.9,20,58348,2611,1290,1296,6,1290,58348,6,1296,21.66666667,0.652887139,0.656167979,58548.18176,242.5485564,1.519685039,99082.25984,0.59027888,0.002442426,1.70678E-05,0.00462963,0.022211558,218,37
D:1| T0: 0.10| T1: 515.00| I0: 350.0| I1: 125.0| WTP: 500000,1,0.096153846,515,500000,1,0.2,350,125,-2176929607,2032407216,7286.145106,1812622351,181262235.1,12,61110,2762,1105,1210,105,1105,61110,105,1210,41.94691358,1.183950617,1.307407407,53944.56914,263.9111111,2.665432099,99113.3642,0.543662067,0.002653487,2.87191E-05,0.08677686,0.019801332,116,20
D:1| T0: 0.10| T1: 515.00| I0: 350.0| I1: 125.0| WTP: 500000,1,0.096153846,515,500000,1,0.2,350,125,-5141627676,1507873352,7263.291043,4778463124,477846312.4,28,51265,2151,1207,1207,0,1207,51265,0,1207,11.73318078,0.366132723,0.366132723,71924.5135,170.0173913,0.922196796,99349.02929,0.723293723,0.001712182,1.111E-05,0,0.023544328,312,54
D:1| T0: 0.10| T1: 515.00| I0: 350.0| I1: 125.0| WTP: 500000,1,0.096153846,515,500000,1,0.2,350,125,-2812637561,1855899401,6183.696536,2503452734,250345273.4,16,49973,2245,1027,1027,0,1027,49973,0,1027,22.97632653,0.648979592,0.648979592,67076.44245,151.435102,1.48244898,99330.26694,0.674819211,0.001523402,1.684E-05,0,0.020551098,175,28
D:1| T0: 0.10| T1: 515.00| I0: 350.0| I1: 125.0| WTP: 500000,1,0.096153846,515,500000,1,0.2,350,125,-1281892609,1819459251,10172.70203,773257507.6,77325750.76,4,76418,3302,742,1690,948,742,76418,948,1690,125.5731707,2.131097561,4.987804878,45077.6372,836.4054878,7.237804878,98842.49695,0.454341786,0.008406084,7.45449E-05,0.560946746,0.022116077,47,8
D:1| T0: 0.10| T1: 515.00| I0: 350.0| I1: 125.0| WTP: 500000,1,0.096153846,515,500000,1,0.2,350,125,-2746055993,909791748,6533.20815,2419395585,241939558.5,20,51497,2334,1085,1085,0,1085,51497,0,1085,24.10039841,0.675697211,0.675697211,66093.56255,132.8167331,1.555378486,99292.05259,0.665074488,0.001336912,1.73711E-05,0,0.021069188,180,27
D:1| T0: 0.10| T1: 515.00| I0: 350.0| I1: 125.0| WTP: 500000,1,0.096153846,515,500000,1,0.2,350,125,-1476838419,1339092841,9063.685199,1023654159,102365415.9,6,65749,2721,812,1506,694,812,65749,694,1506,89.15915119,2.068965517,3.888594164,51412.98674,627.1883289,6.031830239,98925.66048,0.518515701,0.006302596,6.17803E-05,0.460823373,0.02290564,54,11
D:1| T0: 0.10| T1: 515.00| I0: 350.0| I1: 125.0| WTP: 500000,1,0.096153846,515,500000,1,0.2,350,125,-1403507233,1365866345,12208.93929,793060268.4,79306026.84,4,95855,4267,715,2028,1313,715,95855,1313,2028,219.3112033,2.887966805,8.298755187,32980.77593,1247.344398,11.24481328,98667.9917,0.331489792,0.0125414,0.000114431,0.647435897,0.021156956,35,8
D:1| T0: 0.10| T1: 515.00| I0: 350.0| I1: 125.0| WTP: 500000,1,0.096153846,515,500000,1,0.2,350,125,-1572425539,825453433,8912.60515,1126795282,112679528.2,6,75128,3348,899,1480,581,899,75128,581,1480,106.8044554,2.094059406,3.514851485,45192.02475,946.3836634,5.747524752,98971.0198,0.455215944,0.009507945,5.91903E-05,0.392567568,0.019699712,58,12
D:1| T0: 0.10| T1: 515.00| I0: 350.0| I1: 125.0| WTP: 500000,1,0.096153846,515,500000,1,0.2,350,125,-1392680308,939711378,11974.9893,793930842.6,79393084.26,4,96951,4287,640,1989,1349,640,96951,1349,1989,232.7434783,2.726086957,8.539130435,32911.42174,1656.417391,11.30434783,98717.07391,0.330585224,0.016642516,0.000114881,0.678230266,0.020515518,33,8
D:1| T0: 0.10| T1: 515.00| I0: 350.0| I1: 125.0| WTP: 500000,1,0.096153846,515,500000,1,0.2,350,125,-1894952660,638950699,8430.951515,1473405084,147340508.4,8,70609,3151,1087,1400,313,1087,70609,313,1400,69.30204778,1.747440273,2.262798635,45785.31399,760.7542662,4.126279863,98958.57167,0.461567767,0.007648648,4.26643E-05,0.223571429,0.019827501,84,16
D:1| T0: 0.10| T1: 515.00| I0: 350.0| I1: 125.0| WTP: 500000,1,0.096153846,515,500000,1,0.2,350,125,-2354616088,938699148,7381.462919,1985542942,198554294.2,12,60459,2688,1144,1226,82,1144,60459,82,1226,38.03399766,1.162954279,1.254396249,55235.80422,239.5615475,2.594372802,99107.3177,0.556682235,0.002409807,2.79233E-05,0.066938776,0.020263341,122,22
D:1| T0: 0.10| T1: 515.00| I0: 350.0| I1: 125.0| WTP: 500000,1,0.096153846,515,500000,1,0.2,350,125,-4083880009,121790188,6924.635036,3737648258,373764825.8,22,57454,2643,1150,1150,0,1150,57454,0,1150,20.04841713,0.531346989,0.531346989,62228.35692,256.5766605,1.245189323,99262.89323,0.62630827,0.002581127,1.43504E-05,0,0.020016013,230,42
D:1| T0: 0.10| T1: 515.00| I0: 350.0| I1: 125.0| WTP: 500000,1,0.096153846,515,500000,1,0.2,350,125,-1532557605,1331335240,11366.86569,964214320.1,96421432.01,6,90780,3925,725,1888,1163,725,90780,1163,1888,215.2085106,2.953191489,7.85106383,42999.01702,2546.085106,10.92765957,98927.48085,0.43176248,0.025577976,0.000111758,0.615995763,0.020797532,34,10
D:1| T0: 0.10| T1: 515.00| I0: 350.0| I1: 125.0| WTP: 500000,1,0.096153846,515,500000,1,0.2,350,125,-1344883793,470935411,12850.55476,702356055.6,70235605.56,4,93723,3995,728,2135,1407,728,93723,1407,2135,299.1823529,4.194117647,12.37647059,34795.56471,1426.711765,16.67058824,98640.10588,0.350554058,0.014330058,0.000169245,0.659016393,0.022779894,25,7
D:1| T0: 0.10| T1: 515.00| I0: 350.0| I1: 125.0| WTP: 500000,1,0.096153846,515,500000,1,0.2,350,125,-1605330363,823434397,9785.986436,1116031041,111603104.1,6,69486,2888,1189,1626,437,1189,69486,437,1626,59.44059406,1.836633663,2.537953795,46806.24092,586.9438944,4.491749175,98788.86469,0.472555394,0.005908499,4.67626E-05,0.268757688,0.023400734,87,12
D:1| T0: 0.10| T1: 515.00| I0: 350.0| I1: 125.0| WTP: 500000,1,0.096153846,515,500000,1,0.2,350,125,-2337348262,493045351,6997.74925,1987460799,198746079.9,14,58539,2662,1162,1162,0,1162,58539,0,1162,40.61177885,1.181490385,1.181490385,66365.65505,178.6358173,2.567307692,99361.375,0.667216756,0.001796818,2.80618E-05,0,0.019850693,119,22
D:1| T0: 0.10| T1: 515.00| I0: 350.0| I1: 125.0| WTP: 500000,1,0.096153846,515,500000,1,0.2,350,125,-1755128038,1700216563,7439.205727,1383167752,138316775.2,8,65454,3003,988,1235,247,988,65454,247,1235,94.81204819,2.262650602,2.83373494,57538.34458,847.0433735,5.207228916,99240.98795,0.578572346,0.008501784,5.37672E-05,0.2,0.018868213,60,15
D:1| T0: 0.10| T1: 515.00| I0: 350.0| I1: 125.0| WTP: 500000,1,0.096153846,515,500000,1,0.2,350,125,-1666401474,1744119059,7515.62985,1290619981,129061998.1,8,63484,2929,1104,1248,144,1104,63484,144,1248,57.51980983,1.54199683,1.762282092,53094.49287,277.1838352,3.527733756,99098.68621,0.535165969,0.002786896,3.74521E-05,0.115384615,0.019658497,91,14
D:1| T0: 0.10| T1: 515.00| I0: 350.0| I1: 125.0| WTP: 500000,1,0.096153846,515,500000,1,0.2,350,125,-2815679369,2036906360,7914.665008,2419946119,241994611.9,14,59671,2534,1293,1315,22,1293,59671,22,1315,19.18309859,0.671574904,0.685659411,52409.25864,265.6741357,1.521766965,98967.95391,0.528908008,0.002674854,1.6796E-05,0.016730038,0.022037506,223,27
D:1| T0: 0.10| T1: 515.00| I0: 350.0| I1: 125.0| WTP: 500000,1,0.096153846,515,500000,1,0.2,350,125,-1877769364,809704121,8171.308232,1469203953,146920395.3,8,67694,3069,1009,1357,348,1009,67694,348,1357,91.42925659,2.278177458,3.09352518,55503.19664,838.7889688,5.51558753,99149.98561,0.558406623,0.008424791,5.69833E-05,0.256448047,0.02004609,59,16
D:1| T0: 0.10| T1: 515.00| I0: 350.0| I1: 125.0| WTP: 500000,1,0.096153846,515,500000,1,0.2,350,125,-1700234090,1219866412,11258.06692,1137330744,113733074.4,6,89654,3951,801,1870,1069,801,89654,1069,1870,186.7528517,2.923954373,6.950570342,40127.79468,2798.513308,9.992395437,98855.30798,0.403365863,0.028130056,0.000102118,0.571657754,0.020857965,38,12
D:1| T0: 0.10| T1: 515.00| I0: 350.0| I1: 125.0| WTP: 500000,1,0.096153846,515,500000,1,0.2,350,125,-4466643664,843498920,7638.1543,4084735949,408473594.9,30,55316,2388,1269,1269,0,1269,55316,0,1269,18.1464891,0.559322034,0.559322034,67817.12167,161.5780872,1.320823245,99275.13923,0.682414026,0.001627328,1.54519E-05,0,0.022940921,236,46
D:1| T0: 0.10| T1: 515.00| I0: 350.0| I1: 125.0| WTP: 500000,1,0.096153846,515,500000,1,0.2,350,125,-1981660987,107351963,10326.07949,1465357012,146535701.2,8,71840,2807,1295,1716,421,1295,71840,421,1716,48.4813278,1.64868603,2.215767635,44824.26694,690.9377593,3.987551867,98718.40387,0.452727074,0.006959652,4.19493E-05,0.245337995,0.023886414,104,16
D:1| T0: 0.10| T1: 515.00| I0: 350.0| I1: 125.0| WTP: 500000,1,0.096153846,515,500000,1,0.2,350,125,-1938570457,773789021,9313.572893,1472891812,147289181.2,8,69960,3174,1120,1547,427,1120,69960,427,1547,80.8989899,2.125252525,2.965656566,51247.27879,958.0060606,5.22020202,98966.28485,0.516321658,0.009635197,5.41865E-05,0.2760181,0.022112636,71,16
D:1| T0: 0.10| T1: 515.00| I0: 350.0| I1: 125.0| WTP: 500000,1,0.096153846,515,500000,1,0.2,350,125,-1618199969,850936611,10020.55179,1117172380,111717238,6,69867,2894,1127,1665,538,1127,69867,538,1665,57.07142857,1.641304348,2.448757764,44639.63509,575.613354,4.187888199,98709.67081,0.451028243,0.005796502,4.36564E-05,0.323123123,0.023830993,92,12
D:1| T0: 0.10| T1: 515.00| I0: 350.0| I1: 125.0| WTP: 500000,1,0.096153846,515,500000,1,0.2,350,125,-1568445633,1701318364,8982.293752,1119330945,111933094.5,6,70496,3025,1075,1492,417,1075,70496,417,1492,60.82250396,1.580031696,2.228209192,42821.13154,470.340729,3.93977813,98808.25674,0.43253079,0.004732987,4.09292E-05,0.279490617,0.021164321,91,12
D:1| T0: 0.10| T1: 515.00| I0: 350.0| I1: 125.0| WTP: 500000,1,0.096153846,515,500000,1,0.2,350,125,-3525259050,778708269,6411.891239,3204664488,320466448.8,18,50071,2231,1065,1065,0,1065,50071,0,1065,16.29895713,0.463499421,0.463499421,62562.87428,223.608343,1.082271147,99212.04925,0.630150115,0.002248852,1.23993E-05,0,0.021269797,247,36
D:1| T0: 0.10| T1: 515.00| I0: 350.0| I1: 125.0| WTP: 500000,1,0.096153846,515,500000,1,0.2,350,125,-2928674867,1391938506,8395.595245,2508895104,250889510.4,18,58504,2448,1349,1395,46,1349,58504,46,1395,20.81552076,0.77195371,0.802586794,54033.32267,142.5200817,1.724982982,98907.87951,0.545714522,0.001436706,1.87983E-05,0.03297491,0.023845746,210,28
D:1| T0: 0.10| T1: 515.00| I0: 350.0| I1: 125.0| WTP: 500000,1,0.096153846,515,500000,1,0.2,350,125,-4223592049,43418681,6458.160771,3900684011,390068401.1,24,48556,2041,1073,1073,0,1073,48556,0,1073,13.22760801,0.37776607,0.37776607,69524.72076,144.5684932,0.957323498,99334.7313,0.699434673,0.001455093,1.13616E-05,0,0.022098196,272,44
D:1| T0: 0.10| T1: 515.00| I0: 350.0| I1: 125.0| WTP: 500000,1,0.096153846,515,500000,1,0.2,350,125,-1417547193,817384966,12692.12962,782940711.9,78294071.19,4,90602,3756,789,2109,1320,789,90602,1320,2109,252.4456522,4.195652174,11.2826087,40878.88587,1341.407609,15.5923913,98743.14674,0.411496812,0.013472938,0.000158227,0.625889047,0.023277632,27,8
D:1| T0: 0.10| T1: 515.00| I0: 350.0| I1: 125.0| WTP: 500000,1,0.096153846,515,500000,1,0.2,350,125,-1329680087,762053968,10908.90403,784234885.7,78423488.57,4,89409,3903,706,1812,1106,706,89409,1106,1812,233.9460784,3.362745098,8.730392157,42878.75,1366.02451,12.18627451,98936.04902,0.430944848,0.013709946,0.000123882,0.610375276,0.020266416,30,8
D:1| T0: 0.10| T1: 515.00| I0: 350.0| I1: 125.0| WTP: 500000,1,0.096153846,515,500000,1,0.2,350,125,-2203774780,1692506311,7726.122047,1817468677,181746867.7,10,67031,3056,1176,1283,107,1176,67031,107,1283,37.49795918,1.047959184,1.154081633,47771.57347,453.5826531,2.357142857,99020.71122,0.481665051,0.004562278,2.5228E-05,0.083398285,0.019140398,139,20
D:1| T0: 0.10| T1: 515.00| I0: 350.0| I1: 125.0| WTP: 500000,1,0.096153846,515,500000,1,0.2,350,125,-3320519295,1037620300,5953.358383,3022851376,302285137.6,20,46154,1977,989,989,0,989,46154,0,989,17.56521739,0.546376812,0.546376812,68947.16304,139.8369565,1.255072464,99343.50725,0.693572474,0.001406704,1.4394E-05,0,0.021428262,198,34
D:1| T0: 0.10| T1: 515.00| I0: 350.0| I1: 125.0| WTP: 500000,1,0.096153846,515,500000,1,0.2,350,125,-2875609100,301400999,7320.768238,2509570688,250957068.8,16,58776,2516,1216,1216,0,1216,58776,0,1216,26.8956373,0.834901625,0.834901625,58547.02566,207.974337,1.879384089,99160.75021,0.589893481,0.002092784,2.09131E-05,0,0.020688716,167,28
D:1| T0: 0.10| T1: 515.00| I0: 350.0| I1: 125.0| WTP: 500000,1,0.096153846,515,500000,1,0.2,350,125,-1333353780,1868336855,11034.19698,781643931.1,78164393.11,4,85024,3691,738,1833,1095,738,85024,1095,1833,181.6062992,2.767716535,7.05511811,45113.5,1305.53937,9.94488189,98904.12598,0.453593972,0.013117366,0.000101749,0.597381342,0.021558619,37,8
D:1| T0: 0.10| T1: 515.00| I0: 350.0| I1: 125.0| WTP: 500000,1,0.096153846,515,500000,1,0.2,350,125,-1328426135,1868498144,11020.78071,777387099.5,77738709.95,4,83064,3574,738,1831,1093,738,83064,1093,1831,154.2624113,2.468085106,6.308510638,43508.91489,1229.22695,8.946808511,98828.9078,0.437946382,0.012357932,9.15984E-05,0.596941562,0.022043244,41,8
D:1| T0: 0.10| T1: 515.00| I0: 350.0| I1: 125.0| WTP: 500000,1,0.096153846,515,500000,1,0.2,350,125,-2703922217,2101566889,7404.659392,2333689247,233368924.7,14,57168,2502,1224,1230,6,1224,57168,6,1230,24.34588235,0.774901961,0.779607843,57960.41647,254.3356863,1.745882353,99101.42588,0.584298676,0.00255968,1.93507E-05,0.004878049,0.021515533,183,26
D:1| T0: 0.10| T1: 515.00| I0: 350.0| I1: 125.0| WTP: 500000,1,0.096153846,515,500000,1,0.2,350,125,-1326607715,1665097450,12466.49921,703282753.9,70328275.39,4,95376,4092,712,2071,1359,712,95376,1359,2071,268.265625,3.651041667,10.65625,33922.08333,1700.838542,14.359375,98663.69271,0.341408236,0.017091824,0.000145674,0.656204732,0.021714058,28,7
D:1| T0: 0.10| T1: 515.00| I0: 350.0| I1: 125.0| WTP: 500000,1,0.096153846,515,500000,1,0.2,350,125,-1337506518,1716179948,10775.50476,798731279.7,79873127.97,4,97436,4498,713,1789,1076,713,97436,1076,1789,304.7365591,3.747311828,9.478494624,36982.23118,1808.892473,13.31182796,98946.6129,0.371245615,0.018147954,0.000134933,0.601453326,0.01836077,27,8
D:1| T0: 0.10| T1: 515.00| I0: 350.0| I1: 125.0| WTP: 500000,1,0.096153846,515,500000,1,0.2,350,125,-2891134144,1560278715,7828.053695,2499731459,249973145.9,16,51869,2046,1301,1301,0,1301,51869,0,1301,19.00452148,0.785229842,0.785229842,62986.40618,133.5470987,1.776186888,99086.05727,0.635093951,0.001345525,1.97214E-05,0,0.025082903,189,28
D:1| T0: 0.10| T1: 515.00| I0: 350.0| I1: 125.0| WTP: 500000,1,0.096153846,515,500000,1,0.2,350,125,-1400544680,991019385,12343.8999,783349685.4,78334968.54,4,90105,3827,713,2051,1338,713,90105,1338,2051,176.2255639,2.560150376,7.567669173,38985.35338,2004.496241,10.26691729,98708.37218,0.392013411,0.020164468,0.000104562,0.6523647,0.022762333,38,8
D:1| T0: 0.10| T1: 515.00| I0: 350.0| I1: 125.0| WTP: 500000,1,0.096153846,515,500000,1,0.2,350,125,-1350120201,118052103,11293.66053,785437174.6,78543717.46,4,87357,3891,765,1876,1111,765,87357,1111,1876,180.4701493,2.720149254,6.824626866,45449.93657,1649.537313,9.701492537,98919.63433,0.456590564,0.016581293,9.90906E-05,0.592217484,0.021475096,39,8
D:1| T0: 0.10| T1: 515.00| I0: 350.0| I1: 125.0| WTP: 500000,1,0.096153846,515,500000,1,0.2,350,125,-1405055439,1209758844,12434.00238,783355320.1,78335532.01,4,89402,3728,691,2066,1375,691,89402,1375,2066,240.5179487,3.441025641,10.44102564,45146.83077,1345.369231,13.96410256,98835.05128,0.45362038,0.013515966,0.000142049,0.66553727,0.023109103,28,8
D:1| T0: 0.10| T1: 515.00| I0: 350.0| I1: 125.0| WTP: 500000,1,0.096153846,515,500000,1,0.2,350,125,-4895606311,70671723,7469.684806,4522122071,452212207.1,28,57482,2379,1241,1241,0,1241,57482,0,1241,14.81453634,0.438095238,0.438095238,62624.8015,177.3558897,1.062155388,99200.73183,0.630689848,0.001786356,1.25125E-05,0,0.021589367,285,51
D:1| T0: 0.10| T1: 515.00| I0: 350.0| I1: 125.0| WTP: 500000,1,0.096153846,515,500000,1,0.2,350,125,-2989990432,1722612191,6154.785544,2682251155,268225115.5,16,52315,2349,1022,1022,0,1022,52315,0,1022,20.27885257,0.50700467,0.50700467,63420.70981,192.3362241,1.195463642,99295.08472,0.638224103,0.001934285,1.36965E-05,0,0.019535506,214,30
D:1| T0: 0.10| T1: 515.00| I0: 350.0| I1: 125.0| WTP: 500000,1,0.096153846,515,500000,1,0.2,350,125,-2977305598,1968291596,5902.540694,2682178564,268217856.4,16,51731,2342,980,980,0,980,51731,0,980,24.80831974,0.603588907,0.603588907,66954.1615,168.6076672,1.402120718,99376.55139,0.673245964,0.001695594,1.60524E-05,0,0.018944153,176,30
D:1| T0: 0.10| T1: 515.00| I0: 350.0| I1: 125.0| WTP: 500000,1,0.096153846,515,500000,1,0.2,350,125,-1449474365,1877569084,13169.17406,791015662.1,79101566.21,4,96488,4069,745,2188,1443,745,96488,1443,2188,266.1295337,3.813471503,11.21243523,35133.56995,1600.093264,15.05181347,98644.61658,0.353250926,0.016087307,0.00015278,0.659506399,0.022676395,28,8
D:1| T0: 0.10| T1: 515.00| I0: 350.0| I1: 125.0| WTP: 500000,1,0.096153846,515,500000,1,0.2,350,125,-1400909269,1726322189,12190.40189,791389174.1,79138917.41,4,95421,4151,742,2025,1283,742,95421,1283,2025,268.4352332,3.777202073,10.33678756,36894.84456,1673.772021,14.19170984,98778.33161,0.370759373,0.0168105,0.000144015,0.633580247,0.021221744,28,8
D:1| T0: 0.10| T1: 515.00| I0: 350.0| I1: 125.0| WTP: 500000,1,0.096153846,515,500000,1,0.2,350,125,-1390977632,307848836,12063.07059,787824102.3,78782410.23,4,91431,4027,613,2004,1391,613,91431,1391,2004,231.5627907,2.772093023,9.195348837,41100.16744,1495.390698,12.03255814,98811.69767,0.412902006,0.015021828,0.000122332,0.694111776,0.021918168,31,8
D:1| T0: 0.10| T1: 515.00| I0: 350.0| I1: 125.0| WTP: 500000,1,0.096153846,515,500000,1,0.2,350,125,-1256273041,1154000220,11067.13265,702916408,70291640.8,4,91009,4125,749,1838,1089,749,91009,1089,1838,280.1630435,3.983695652,9.836956522,33230.30978,1286.51087,13.89673913,98752.70652,0.335189924,0.012907515,0.000141173,0.592491839,0.020195805,27,7
D:1| T0: 0.10| T1: 515.00| I0: 350.0| I1: 125.0| WTP: 500000,1,0.096153846,515,500000,1,0.2,350,125,-4486592606,2028661055,6369.561423,4168114534,416811453.4,28,50983,2255,1058,1058,0,1058,50983,0,1058,15.71355932,0.418079096,0.418079096,66700.88023,150.7728814,1.016384181,99312.04859,0.671111451,0.001517465,1.20115E-05,0,0.020752015,253,47
D:1| T0: 0.10| T1: 515.00| I0: 350.0| I1: 125.0| WTP: 500000,1,0.096153846,515,500000,1,0.2,350,125,-1881607245,1629114640,9872.933435,1387960573,138796057.3,8,77706,3400,1070,1640,570,1070,77706,570,1640,121.5146199,3.005847953,4.622807018,50148.26608,1410.076023,7.748538012,99020.85965,0.504481775,0.014172465,7.96657E-05,0.347560976,0.021105463,49,15
D:1| T0: 0.10| T1: 515.00| I0: 350.0| I1: 125.0| WTP: 500000,1,0.096153846,515,500000,1,0.2,350,125,-1448079271,1439048174,13026.9009,796734226.2,79673422.62,4,96599,4308,746,2164,1418,746,96599,1418,2164,300.1748634,4,11.66666667,38851.43169,2247.836066,15.75956284,98756.08743,0.390137629,0.022590817,0.000159786,0.655268022,0.022401888,27,8
D:1| T0: 0.10| T1: 515.00| I0: 350.0| I1: 125.0| WTP: 500000,1,0.096153846,515,500000,1,0.2,350,125,-1292416835,865227006,11976.89732,693571969.4,69357196.94,4,88440,3679,705,1990,1285,705,88440,1285,1990,275.0722892,4.120481928,11.79518072,34329.10843,1429.783133,16.08433735,98636.85542,0.346731923,0.014345885,0.000163076,0.645728643,0.02250164,24,7
D:1| T0: 0.10| T1: 515.00| I0: 350.0| I1: 125.0| WTP: 500000,1,0.096153846,515,500000,1,0.2,350,125,-1691078570,890479738,11095.6054,1136298300,113629830,6,88008,3838,815,1843,1028,815,88008,1028,1843,149.7808642,2.416666667,5.552469136,37508.04012,1938.632716,8.074074074,98771.28395,0.377419917,0.019499109,8.25542E-05,0.557786218,0.020941278,47,12
D:1| T0: 0.10| T1: 515.00| I0: 350.0| I1: 125.0| WTP: 500000,1,0.096153846,515,500000,1,0.2,350,125,-3205543793,1017049163,6930.015712,2859043008,285904300.8,22,57211,2570,1150,1151,1,1150,57211,1,1151,25.47398844,0.761354253,0.762180017,60631.20562,168.7349298,1.714285714,99226.06854,0.610483868,0.00169801,1.90948E-05,0.00086881,0.020118509,173,32
D:1| T0: 0.10| T1: 515.00| I0: 350.0| I1: 125.0| WTP: 500000,1,0.096153846,515,500000,1,0.2,350,125,-3801405197,1707305064,6587.465241,3472031935,347203193.5,20,54234,2480,1094,1094,0,1094,54234,0,1094,20.55740988,0.541388518,0.541388518,64062.52403,190.8738318,1.276368491,99283.11081,0.644706575,0.001920471,1.46765E-05,0,0.020171848,214,39
D:1| T0: 0.10| T1: 515.00| I0: 350.0| I1: 125.0| WTP: 500000,1,0.096153846,515,500000,1,0.2,350,125,-1286251020,400145663,11803.58029,696072005.8,69607200.58,4,86942,3738,730,1961,1231,730,86942,1231,1961,245.9270833,3.723958333,10.078125,32762.4375,1214.723958,13.875,98577.98958,0.331264071,0.012196606,0.000140896,0.627740948,0.022555267,28,7
D:1| T0: 0.10| T1: 515.00| I0: 350.0| I1: 125.0| WTP: 500000,1,0.096153846,515,500000,1,0.2,350,125,-3607116576,1662654181,7779.572712,3218137940,321813794,22,62857,2860,1288,1292,4,1288,62857,4,1292,26.93684211,0.771428571,0.773684211,58932.25789,193.8992481,1.745864662,99181.29624,0.593450273,0.001952074,1.95098E-05,0.003095975,0.020554592,190,36
D:1| T0: 0.10| T1: 515.00| I0: 350.0| I1: 125.0| WTP: 500000,1,0.096153846,515,500000,1,0.2,350,125,-1362182916,182136456,11380.26596,793169618,79316961.8,4,95282,4251,770,1890,1120,770,95282,1120,1890,282.1489362,4.037234043,9.909574468,37686.44149,1749.590426,14,98864.92021,0.378761919,0.017562797,0.000142007,0.592592593,0.019835856,27,8
D:1| T0: 0.10| T1: 515.00| I0: 350.0| I1: 125.0| WTP: 500000,1,0.096153846,515,500000,1,0.2,350,125,-4193963817,979575387,5851.83282,3901372176,390137217.6,22,47470,2139,972,972,0,972,47470,0,972,13.22525773,0.342783505,0.342783505,66300.75361,163.1969072,0.839175258,99318.96753,0.667184734,0.001641476,1.00643E-05,0,0.02047609,278,44
D:1| T0: 0.10| T1: 515.00| I0: 350.0| I1: 125.0| WTP: 500000,1,0.096153846,515,500000,1,0.2,350,125,-1414555815,2142525414,12519.76766,788567431.6,78856743.16,4,93670,3990,711,2080,1369,711,93670,1369,2080,256.7384615,3.523076923,10.48717949,45475.51282,1895.589744,14.17435897,98908.51282,0.456217912,0.019047371,0.000143821,0.658173077,0.022205615,28,8
D:1| T0: 0.10| T1: 515.00| I0: 350.0| I1: 125.0| WTP: 500000,1,0.096153846,515,500000,1,0.2,350,125,-1308353211,1464057597,10553.45839,780680291.3,78068029.13,4,83440,3665,765,1753,988,765,83440,988,1753,168.3247232,2.6900369,6.287822878,47638.99262,1154.653137,9.103321033,98981.90406,0.478795989,0.011598857,9.33721E-05,0.563605248,0.021010116,39,8
D:1| T0: 0.10| T1: 515.00| I0: 350.0| I1: 125.0| WTP: 500000,1,0.096153846,515,500000,1,0.2,350,125,-1363136256,364562610,11575.53304,784359603.8,78435960.38,4,90373,3854,667,1923,1256,667,90373,1256,1923,239.7939698,3.246231156,9.497487437,43443.79899,1533.854271,12.86432161,98892.47739,0.436426742,0.015401995,0.000130688,0.653146126,0.021278479,29,8
D:1| T0: 0.10| T1: 515.00| I0: 350.0| I1: 125.0| WTP: 500000,1,0.096153846,515,500000,1,0.2,350,125,-1378858728,40350784,11893.77738,784169859.3,78416985.93,4,90261,3748,686,1976,1290,686,90261,1290,1976,227.5502392,3.148325359,9.267942584,45322.52632,1657.406699,12.54545455,98905.97608,0.455083565,0.016649277,0.000127961,0.652834008,0.021892069,30,8
D:1| T0: 0.10| T1: 515.00| I0: 350.0| I1: 125.0| WTP: 500000,1,0.096153846,515,500000,1,0.2,350,125,-1265754340,804064356,9606.088596,785449910.1,78544991.01,4,84018,3843,543,1595,1052,543,84018,1052,1595,237.9466019,2.524271845,7.59223301,49044.34466,1179.524272,10.21359223,99108.40291,0.492538805,0.011823978,0.00010408,0.659561129,0.018984253,30,8
D:1| T0: 0.10| T1: 515.00| I0: 350.0| I1: 125.0| WTP: 500000,1,0.096153846,515,500000,1,0.2,350,125,-2158681309,2125493986,8667.553069,1725303656,172530365.6,12,64843,2727,1243,1440,197,1243,64843,197,1440,45.62652233,1.48308525,1.742895805,53031.13532,277.8755074,3.423545332,98963.46008,0.535088482,0.002797895,3.65228E-05,0.136805556,0.022207828,106,19
D:1| T0: 0.10| T1: 515.00| I0: 350.0| I1: 125.0| WTP: 500000,1,0.096153846,515,500000,1,0.2,350,125,-1238899457,23154253,9166.195974,780589658.5,78058965.85,4,78757,3560,713,1522,809,713,78757,809,1522,180.2627451,2.670588235,5.815686275,47154.9451,824.9607843,8.62745098,99039.89804,0.474417196,0.0082769,8.79372E-05,0.531537451,0.019325266,37,8
D:1| T0: 0.10| T1: 515.00| I0: 350.0| I1: 125.0| WTP: 500000,1,0.096153846,515,500000,1,0.2,350,125,-2512999207,1391367689,7145.580203,2155720197,215572019.7,14,54475,2405,1187,1187,0,1187,54475,0,1187,26.02300885,0.87699115,0.87699115,62117.24779,162.7858407,1.917699115,99188.44779,0.62569895,0.001638466,2.11153E-05,0,0.021771455,162,24
D:1| T0: 0.10| T1: 515.00| I0: 350.0| I1: 125.0| WTP: 500000,1,0.096153846,515,500000,1,0.2,350,125,-1552896132,574142276,8711.360882,1117328088,111732808.8,6,68260,3027,1028,1447,419,1028,68260,419,1447,58.45525903,1.489795918,2.128728414,45664.82418,492.7974882,3.739403454,98876.81319,0.460916927,0.004956339,3.90818E-05,0.289564616,0.021198359,91,12
D:1| T0: 0.10| T1: 515.00| I0: 350.0| I1: 125.0| WTP: 500000,1,0.096153846,515,500000,1,0.2,350,125,-4750178646,898736779,6357.922412,4432282525,443228252.5,26,50431,2212,1056,1056,0,1056,50431,0,1056,15.56616052,0.375813449,0.375813449,68412.49403,201.9718004,0.958785249,99340.65835,0.688180216,0.002031863,1.15079E-05,0,0.020939917,264,50
D:1| T0: 0.10| T1: 515.00| I0: 350.0| I1: 125.0| WTP: 500000,1,0.096153846,515,500000,1,0.2,350,125,-1506516216,346473503,9138.095581,1049611437,104961143.7,6,83832,4006,710,1517,807,710,83832,807,1517,186.7067669,2.522556391,5.522556391,47172.19925,1789.176692,8.19924812,99116.6015,0.473840971,0.017954444,8.40425E-05,0.531970995,0.018095715,38,11
D:1| T0: 0.10| T1: 515.00| I0: 350.0| I1: 125.0| WTP: 500000,1,0.096153846,515,500000,1,0.2,350,125,-1614837646,445552282,9771.244653,1126275413,112627541.3,6,74932,3334,1023,1623,600,1023,74932,600,1623,92.79039301,2.100436681,3.390829694,44598.56332,935.5764192,5.626637555,98843.41703,0.449686464,0.009411044,5.81305E-05,0.369685767,0.021659638,65,12
D:1| T0: 0.10| T1: 515.00| I0: 350.0| I1: 125.0| WTP: 500000,1,0.096153846,515,500000,1,0.2,350,125,-1270786973,911758476,11284.51619,706561163.2,70656116.32,4,92449,4212,736,1874,1138,736,92449,1138,1874,252.5492958,3.384976526,8.638497653,28949.4554,1215.075117,12.10798122,98646.93427,0.292196282,0.012203292,0.000123144,0.607257204,0.020270636,31,7
D:1| T0: 0.10| T1: 515.00| I0: 350.0| I1: 125.0| WTP: 500000,1,0.096153846,515,500000,1,0.2,350,125,-1381815226,1464197940,11687.88935,797420758.4,79742075.84,4,96108,4386,679,1941,1262,679,96108,1262,1941,277.2636816,3.278606965,9.527363184,38605.37313,2774.383085,12.90547264,98875.17413,0.387457565,0.027857109,0.000130907,0.650180319,0.020196029,29,8
D:1| T0: 0.10| T1: 515.00| I0: 350.0| I1: 125.0| WTP: 500000,1,0.096153846,515,500000,1,0.2,350,125,-2144976943,500405854,8397.253504,1725114268,172511426.8,10,63488,2732,1271,1395,124,1271,63488,124,1395,38.88786127,1.293641618,1.428901734,52241.42081,295.7109827,2.90867052,98963.54682,0.527145099,0.00297687,3.10022E-05,0.088888889,0.021973002,124,19
D:1| T0: 0.10| T1: 515.00| I0: 350.0| I1: 125.0| WTP: 500000,1,0.096153846,515,500000,1,0.2,350,125,-1367557469,772037341,11777.84409,778665265.1,77866526.51,4,84909,3608,627,1957,1330,627,84909,1330,1957,214.6699029,2.917475728,9.32038835,47682.80583,1350.533981,12.36893204,98881.03398,0.47935571,0.013564432,0.000125993,0.67961165,0.023048205,30,8
D:1| T0: 0.10| T1: 515.00| I0: 350.0| I1: 125.0| WTP: 500000,1,0.096153846,515,500000,1,0.2,350,125,-3603306868,1543158763,6302.418146,3288185960,328818596,22,49642,2141,1047,1047,0,1047,49642,0,1047,19.32352941,0.582202112,0.582202112,73682.03997,181.5874811,1.369532428,99447.27677,0.74039855,0.001826691,1.58629E-05,0,0.021091437,190,37
D:1| T0: 0.10| T1: 515.00| I0: 350.0| I1: 125.0| WTP: 500000,1,0.096153846,515,500000,1,0.2,350,125,-1367589056,1604932531,13312.83604,701947253.7,70194725.37,4,94923,4067,763,2212,1449,763,94923,1449,2212,277.0054945,4.131868132,12.01648352,36485.52747,1533.351648,16.18681319,98629.94505,0.367242845,0.015414737,0.000164333,0.655063291,0.023303098,26,7
D:1| T0: 0.10| T1: 515.00| I0: 350.0| I1: 125.0| WTP: 500000,1,0.096153846,515,500000,1,0.2,350,125,-1368832810,539051477,11601.00889,788782365.3,78878236.53,4,91936,4058,718,1927,1209,718,91936,1209,1927,224.8883929,3.107142857,8.446428571,42742.0625,2343.183036,11.64285714,98910.42857,0.429129865,0.02354521,0.000118658,0.627400104,0.020960233,32,8
D:1| T0: 0.10| T1: 515.00| I0: 350.0| I1: 125.0| WTP: 500000,1,0.096153846,515,500000,1,0.2,350,125,-2912160517,1743124675,6435.675552,2590376740,259037674,22,50622,2239,1069,1069,0,1069,50622,0,1069,20.56026786,0.604910714,0.604910714,66480.44792,127.1034226,1.415922619,99299.8378,0.668957916,0.001279425,1.59812E-05,0,0.021117301,192,29
D:1| T0: 0.10| T1: 515.00| I0: 350.0| I1: 125.0| WTP: 500000,1,0.096153846,515,500000,1,0.2,350,125,-1902714697,1965983789,8728.905623,1466269416,146626941.6,8,67867,2932,1120,1450,330,1120,67867,330,1450,55.7202473,1.647604328,2.142194745,47688.49304,610.4250386,3.874806801,98911.63524,0.480975201,0.006140139,3.99464E-05,0.227586207,0.021365632,93,16
D:1| T0: 0.10| T1: 515.00| I0: 350.0| I1: 125.0| WTP: 500000,1,0.096153846,515,500000,1,0.2,350,125,-2998993285,516774280,7988.152285,2599585671,259958567.1,16,62326,2652,1303,1327,24,1303,62326,24,1327,25.21003861,0.814671815,0.830888031,53272.15444,308.3042471,1.843243243,99021.84865,0.537338185,0.003103298,2.04288E-05,0.018085908,0.021291275,184,29
D:1| T0: 0.10| T1: 515.00| I0: 350.0| I1: 125.0| WTP: 500000,1,0.096153846,515,500000,1,0.2,350,125,-998389498.6,86603142,11251.91933,435793532.2,43579353.22,2,88466,3815,624,1869,1245,624,88466,1245,1869,285.6569767,3.534883721,10.72674419,32496.5407,1333.540698,14.31976744,98668.77907,0.32826279,0.013375069,0.000145509,0.666131621,0.021126999,25,4
D:1| T0: 0.10| T1: 515.00| I0: 350.0| I1: 125.0| WTP: 500000,1,0.096153846,515,500000,1,0.2,350,125,-5665338894,1431870609,7038.046006,5313436593,531343659.3,32,57369,2532,1169,1169,0,1169,57369,0,1169,14.73656927,0.371347785,0.371347785,61573.84731,186.4288407,0.918473139,99240.82375,0.619899033,0.001876471,1.10774E-05,0,0.020376859,304,60
D:1| T0: 0.10| T1: 515.00| I0: 350.0| I1: 125.0| WTP: 500000,1,0.096153846,515,500000,1,0.2,350,125,-1241929708,1592383984,9320.840289,775887694,77588769.4,4,75834,3394,816,1548,732,816,75834,732,1548,142.5348837,2.594684385,5.003322259,48621.0897,734.4053156,7.707641196,99004.48837,0.489411742,0.007375628,7.88586E-05,0.472868217,0.020413007,43,8
D:1| T0: 0.10| T1: 515.00| I0: 350.0| I1: 125.0| WTP: 500000,1,0.096153846,515,500000,1,0.2,350,125,-1525685022,1440183867,8176.73623,1116848210,111684821,6,67584,3004,1053,1358,305,1053,67584,305,1358,56.20637329,1.474962064,1.918057663,46558.82246,494.0622155,3.509863429,98949.02124,0.46969305,0.004968516,3.67834E-05,0.224594993,0.020093513,95,12
D:1| T0: 0.10| T1: 515.00| I0: 350.0| I1: 125.0| WTP: 500000,1,0.096153846,515,500000,1,0.2,350,125,-1810782143,1696510588,8680.208407,1376771723,137677172.3,8,66742,2845,1124,1442,318,1124,66742,318,1442,37.57234727,1.082529475,1.411575563,45265.28296,336.8263666,2.607717042,98833.71704,0.457192021,0.003391096,2.76751E-05,0.220527046,0.021605586,134,15
D:1| T0: 0.10| T1: 515.00| I0: 350.0| I1: 125.0| WTP: 500000,1,0.096153846,515,500000,1,0.2,350,125,-1377059077,895039877,11834.12517,785352818.9,78535281.89,4,89167,3768,700,1966,1266,700,89167,1266,1966,198.7037037,2.781893004,7.95473251,40717.83128,1933.230453,10.81893004,98795.68313,0.409387433,0.019434156,0.000110336,0.643947101,0.022048516,35,8
D:1| T0: 0.10| T1: 515.00| I0: 350.0| I1: 125.0| WTP: 500000,1,0.096153846,515,500000,1,0.2,350,125,-2184347627,129565953,9119.012996,1728396978,172839697.8,10,67575,2872,1272,1515,243,1272,67575,243,1515,35.59356137,1.179074447,1.415492958,43962.55332,480.4114688,2.701207243,98764.73843,0.444221021,0.004837497,2.82231E-05,0.16039604,0.022419534,141,19
D:1| T0: 0.10| T1: 515.00| I0: 350.0| I1: 125.0| WTP: 500000,1,0.096153846,515,500000,1,0.2,350,125,-1925148831,1902565669,7449.296966,1552683983,155268398.3,10,63517,2827,1115,1237,122,1115,63517,122,1237,47.39470199,1.299337748,1.452980132,53431.4,323.807947,2.915231788,99123.76556,0.538303776,0.003255669,3.13047E-05,0.098625707,0.019475101,108,17
D:1| T0: 0.10| T1: 515.00| I0: 350.0| I1: 125.0| WTP: 500000,1,0.096153846,515,500000,1,0.2,350,125,-4651782128,1984179288,7812.662728,4261148991,426114899.1,26,59701,2522,1297,1298,1,1297,59701,1,1298,15.96812957,0.495820272,0.496342738,57395.72727,235.0496343,1.175026123,99080.2675,0.578700012,0.002367059,1.36393E-05,0.000770416,0.021741679,274,48
D:1| T0: 0.10| T1: 515.00| I0: 350.0| I1: 125.0| WTP: 500000,1,0.096153846,515,500000,1,0.2,350,125,-1672883771,677377223,10776.64854,1134051344,113405134.4,6,84378,3760,982,1790,808,982,84378,808,1790,137.5146199,2.754385965,5.076023392,44094.5,2006.149123,7.964912281,98893.07018,0.443490911,0.020177447,8.15647E-05,0.451396648,0.021214061,48,12
D:1| T0: 0.10| T1: 515.00| I0: 350.0| I1: 125.0| WTP: 500000,1,0.096153846,515,500000,1,0.2,350,125,-1636446099,973583301,10114.98174,1130697012,113069701.2,6,83161,3652,1049,1680,631,1049,83161,631,1680,116.6813472,2.593264249,4.191709845,43396.62953,1753.088083,6.904145078,98924.07772,0.436575097,0.017627865,7.11207E-05,0.375595238,0.020201777,56,12
D:1| T0: 0.10| T1: 515.00| I0: 350.0| I1: 125.0| WTP: 500000,1,0.096153846,515,500000,1,0.2,350,125,-1778166004,781062938,7830.615225,1386635243,138663524.3,8,69101,3331,1051,1300,249,1051,69101,249,1300,55.09986684,1.251664447,1.576564581,45458.21704,424.4647137,2.962716378,98994.90013,0.458428814,0.004268442,3.14665E-05,0.191538462,0.018813042,108,15
D:1| T0: 0.10| T1: 515.00| I0: 350.0| I1: 125.0| WTP: 500000,1,0.096153846,515,500000,1,0.2,350,125,-1955668869,338783425,9537.685585,1478784589,147878458.9,8,78335,3480,1117,1584,467,1117,78335,467,1584,112.8989637,2.764248705,3.917098446,51237.18135,1650.994819,6.821243523,99078.8057,0.515062453,0.016597431,7.03429E-05,0.294823232,0.020220846,56,16
D:1| T0: 0.10| T1: 515.00| I0: 350.0| I1: 125.0| WTP: 500000,1,0.096153846,515,500000,1,0.2,350,125,-5594894643,1027579040,7327.205516,5228534367,522853436.7,32,59774,2709,1217,1217,0,1217,59774,0,1217,15.59648289,0.397813688,0.397813688,58821.39211,213.6463878,0.979562738,99178.21008,0.592506017,0.002150815,1.16337E-05,0,0.020360023,300,59
D:1| T0: 0.10| T1: 515.00| I0: 350.0| I1: 125.0| WTP: 500000,1,0.096153846,515,500000,1,0.2,350,125,-1865931660,764973813,9607.924304,1385535445,138553544.5,8,73580,3157,1077,1596,519,1077,73580,519,1596,80.74096386,2.03815261,3.0562249,45614.82129,1007.618474,5.230923695,98867.01406,0.459869481,0.010135448,5.40057E-05,0.32518797,0.021690677,71,15
D:1| T0: 0.10| T1: 515.00| I0: 350.0| I1: 125.0| WTP: 500000,1,0.096153846,515,500000,1,0.2,350,125,-1636982850,1245753446,10126.8896,1130638370,113063837,6,82957,3589,791,1682,891,791,82957,891,1682,146.1483871,2.432258065,5.270967742,44432.0129,1834.8,7.822580645,98945.21935,0.446895393,0.018438291,8.02072E-05,0.529726516,0.020275809,45,12
D:1| T0: 0.10| T1: 515.00| I0: 350.0| I1: 125.0| WTP: 500000,1,0.096153846,515,500000,1,0.2,350,125,-1558974130,1013177794,8890.602571,1114444001,111444400.1,6,67359,2884,1090,1477,387,1090,67359,387,1477,54.01221374,1.523664122,2.097709924,46385.86107,428.5923664,3.766412214,98854.17252,0.468359867,0.004312399,3.94282E-05,0.262017603,0.021927285,94,12
D:1| T0: 0.10| T1: 515.00| I0: 350.0| I1: 125.0| WTP: 500000,1,0.096153846,515,500000,1,0.2,350,125,-4079878410,1395089249,7065.186574,3726619081,372661908.1,22,52086,2109,1174,1174,0,1174,52086,0,1174,17.63416321,0.597510373,0.597510373,71625.51591,188.5733057,1.417012448,99362.19571,0.720267437,0.00189819,1.63224E-05,0,0.022539646,207,42
D:1| T0: 0.10| T1: 515.00| I0: 350.0| I1: 125.0| WTP: 500000,1,0.096153846,515,500000,1,0.2,350,125,-4268889100,1339545835,5652.696456,3986254277,398625427.7,24,44515,1940,939,939,0,939,44515,0,939,10.90675676,0.254954955,0.254954955,74308.15315,152.5545045,0.668918919,99469.58964,0.746613758,0.001534456,8.4955E-06,0,0.021094013,318,45
D:1| T0: 0.10| T1: 515.00| I0: 350.0| I1: 125.0| WTP: 500000,1,0.096153846,515,500000,1,0.2,350,125,-1332052832,219139554,10832.89656,790408004.2,79040800.42,4,90154,4019,758,1799,1041,758,90154,1041,1799,289.5,4.191011236,9.938202247,41275.98315,1331.713483,14.19101124,98921.76404,0.415222809,0.01335809,0.000144089,0.578654808,0.019954744,26,8
D:1| T0: 0.10| T1: 515.00| I0: 350.0| I1: 125.0| WTP: 500000,1,0.096153846,515,500000,1,0.2,350,125,-2374684297,1336508942,7801.578572,1984605369,198460536.9,12,60037,2566,1272,1296,24,1272,60037,24,1296,34.42562432,1.184581976,1.210640608,58515.18567,262.514658,2.605863192,99125.47883,0.589592407,0.002641545,2.80339E-05,0.018518519,0.021587407,132,22
D:1| T0: 0.10| T1: 515.00| I0: 350.0| I1: 125.0| WTP: 500000,1,0.096153846,515,500000,1,0.2,350,125,-5175259859,448559423,6294.657385,4860526989,486052698.9,28,42293,1775,1046,1046,0,1046,42293,0,1046,12.42588496,0.403207965,0.403207965,74154.56139,180.5331858,0.969579646,99358.72124,0.745895549,0.001816551,1.16251E-05,0,0.024732225,259,55
D:1| T0: 0.10| T1: 515.00| I0: 350.0| I1: 125.0| WTP: 500000,1,0.096153846,515,500000,1,0.2,350,125,-1911483973,2110028840,8879.417722,1467513087,146751308.7,8,69517,3061,1230,1475,245,1230,69517,245,1475,51.83779972,1.576868829,1.902679831,47762.10014,479.5430183,3.631875882,98924.52186,0.481801812,0.004825597,3.83819E-05,0.166101695,0.021217832,102,16
D:1| T0: 0.10| T1: 515.00| I0: 350.0| I1: 125.0| WTP: 500000,1,0.096153846,515,500000,1,0.2,350,125,-1880253901,1982030155,10008.45454,1379831174,137983117.4,8,71774,2961,1141,1663,522,1141,71774,522,1663,85.25,2.542056075,3.731308411,51459.83645,1115.469626,6.397196262,98925.57009,0.51839322,0.011222821,6.5909E-05,0.313890559,0.02316995,62,15
D:1| T0: 0.10| T1: 515.00| I0: 350.0| I1: 125.0| WTP: 500000,1,0.096153846,515,500000,1,0.2,350,125,-1409392462,696219407,9306.462171,944069353.5,94406935.35,6,70618,3115,722,1546,824,722,70618,824,1546,120.0093168,2.105590062,4.639751553,52791.51553,731.7670807,6.863354037,99014.2205,0.531473813,0.007349119,7.07552E-05,0.532988357,0.021892435,46,10
D:1| T0: 0.10| T1: 515.00| I0: 350.0| I1: 125.0| WTP: 500000,1,0.096153846,515,500000,1,0.2,350,125,-1324873222,1402539442,10665.09851,791618296.9,79161829.69,4,93537,4147,701,1771,1070,701,93537,1070,1771,257.9359606,3.359605911,8.586206897,42599.54187,2112.738916,12.03448276,99011.71921,0.427492934,0.021198924,0.000122191,0.60417843,0.018933684,29,8
D:1| T0: 0.10| T1: 515.00| I0: 350.0| I1: 125.0| WTP: 500000,1,0.096153846,515,500000,1,0.2,350,125,-1616951961,1319833493,11312.62624,1051320650,105132065,6,88806,3972,720,1879,1159,720,88806,1159,1879,214.6410256,2.948717949,7.858974359,43348.15812,2568.15812,10.91452991,98904.40598,0.435550006,0.025803612,0.000111646,0.616817456,0.021158719,34,11
D:1| T0: 0.10| T1: 515.00| I0: 350.0| I1: 125.0| WTP: 500000,1,0.096153846,515,500000,1,0.2,350,125,-2155707796,663608076,8554.324959,1727991548,172799154.8,10,65953,2887,1300,1421,121,1300,65953,121,1421,41.6360424,1.339222615,1.477031802,50908.62426,468.1861013,3.003533569,98973.66667,0.513479412,0.004711456,3.22411E-05,0.085151302,0.021545646,122,19
D:1| T0: 0.10| T1: 515.00| I0: 350.0| I1: 125.0| WTP: 500000,1,0.096153846,515,500000,1,0.2,350,125,-2424069989,414696500,7038.820313,2072128973,207212897.3,12,57621,2510,1160,1169,9,1160,57621,9,1169,25.66827309,0.786345382,0.79437751,56169.849,321.0562249,1.721285141,99121.99679,0.566027763,0.003229199,1.88012E-05,0.007698888,0.020287742,177,23
D:1| T0: 0.10| T1: 515.00| I0: 350.0| I1: 125.0| WTP: 500000,1,0.096153846,515,500000,1,0.2,350,125,-3183480093,1249738535,6722.021034,2847379042,284737904.2,18,47346,1950,1117,1117,0,1117,47346,0,1117,17.68148148,0.633333333,0.633333333,68309.29333,139.8555556,1.472592593,99249.20593,0.687764155,0.001407987,1.66286E-05,0,0.02359477,193,32
D:1| T0: 0.10| T1: 515.00| I0: 350.0| I1: 125.0| WTP: 500000,1,0.096153846,515,500000,1,0.2,350,125,-2197090595,614415382,7729.944272,1810593381,181059338.1,10,59012,2604,1244,1284,40,1244,59012,40,1284,33.97283177,1.13061651,1.175548589,56600.69383,389.8171369,2.469174504,99075.22362,0.570515045,0.003921616,2.65585E-05,0.031152648,0.021758655,137,20
D:1| T0: 0.10| T1: 515.00| I0: 350.0| I1: 125.0| WTP: 500000,1,0.096153846,515,500000,1,0.2,350,125,-4050440301,524899953,6334.790121,3733700795,373370079.5,22,53727,2479,1052,1052,0,1052,53727,0,1052,19.59895833,0.497395833,0.497395833,66986.84115,202.0846354,1.177083333,99355.45638,0.673674841,0.002032807,1.37613E-05,0,0.019580472,220,42
D:1| T0: 0.10| T1: 515.00| I0: 350.0| I1: 125.0| WTP: 500000,1,0.096153846,515,500000,1,0.2,350,125,-1298416506,1338977757,11848.84101,705974455.5,70597445.55,4,93037,4177,742,1968,1226,742,93037,1226,1968,246.6805556,3.384259259,9,30919.31944,1130.555556,12.43518519,98616.37963,0.311861299,0.011361959,0.000126125,0.62296748,0.021152875,31,7
D:1| T0: 0.10| T1: 515.00| I0: 350.0| I1: 125.0| WTP: 500000,1,0.096153846,515,500000,1,0.2,350,125,-1509472910,341384587,9564.561546,1031244833,103124483.3,6,72362,3090,882,1589,707,882,72362,707,1589,69.08679928,1.430379747,2.692585895,41771.97288,445.8191682,4.289330922,98747.48463,0.422125918,0.004486588,4.49716E-05,0.444933921,0.021959039,79,11
D:1| T0: 0.10| T1: 515.00| I0: 350.0| I1: 125.0| WTP: 500000,1,0.096153846,515,500000,1,0.2,350,125,-1850855691,2032000160,9331.27625,1384291879,138429187.9,8,73252,3177,1096,1550,454,1096,73252,454,1550,97.6039604,2.589108911,3.675742574,50245.84653,1229.831683,6.383663366,98994.06188,0.505922606,0.012365755,6.58456E-05,0.292903226,0.021160121,58,15
D:1| T0: 0.10| T1: 515.00| I0: 350.0| I1: 125.0| WTP: 500000,1,0.096153846,515,500000,1,0.2,350,125,-1397049287,779488939,12224.57154,785820710.3,78582071.03,4,91732,3912,625,2031,1406,625,91732,1406,2031,228.8679245,2.844339623,9.438679245,44968.23113,1638.759434,12.38207547,98888.78302,0.451296361,0.016466312,0.000125932,0.692269818,0.022140583,31,8
D:1| T0: 0.10| T1: 515.00| I0: 350.0| I1: 125.0| WTP: 500000,1,0.096153846,515,500000,1,0.2,350,125,-2383630282,1449019578,8034.91051,1981884757,198188475.7,12,60204,2452,1232,1335,103,1232,60204,103,1335,29.00774443,1.044530494,1.140367861,52893.89545,362.2613746,2.328170378,98963.34463,0.533773207,0.003645721,2.49923E-05,0.077153558,0.022174606,147,22
D:1| T0: 0.10| T1: 515.00| I0: 350.0| I1: 125.0| WTP: 500000,1,0.096153846,515,500000,1,0.2,350,125,-3737051713,351952211,5361.296492,3468986889,346898688.9,24,48898,2362,890,890,0,890,48898,0,890,18.86858974,0.391025641,0.391025641,69638.29551,139.0416667,0.967948718,99442.36795,0.699842584,0.001398411,1.14538E-05,0,0.018201153,223,39
D:1| T0: 0.10| T1: 515.00| I0: 350.0| I1: 125.0| WTP: 500000,1,0.096153846,515,500000,1,0.2,350,125,-3229707763,486595046,7440.078752,2857703825,285770382.5,16,57827,2468,1223,1236,13,1223,57827,13,1236,16.02847931,0.536270822,0.543256314,52880.67706,256.8581408,1.206878023,99002.81139,0.533567014,0.002585236,1.32881E-05,0.010517799,0.021374468,264,32
D:1| T0: 0.10| T1: 515.00| I0: 350.0| I1: 125.0| WTP: 500000,1,0.096153846,515,500000,1,0.2,350,125,-1735691716,296745624,8849.667205,1293208356,129320835.6,8,71515,3071,984,1470,486,984,71515,486,1470,77.77846791,1.913043478,2.890269151,46705.36025,727.010352,4.931677019,98938.50518,0.470830937,0.007308844,5.10734E-05,0.330612245,0.020555128,69,14
D:1| T0: 0.10| T1: 515.00| I0: 350.0| I1: 125.0| WTP: 500000,1,0.096153846,515,500000,1,0.2,350,125,-2947313134,1671484194,7008.365998,2596894834,259689483.4,16,56865,2546,1161,1164,3,1161,56865,3,1164,29.11431227,0.870817844,0.87267658,62291.70539,272.3215613,1.95260223,99244.81041,0.627085139,0.0027389,2.17139E-05,0.00257732,0.020470253,154,29
D:1| T0: 0.10| T1: 515.00| I0: 350.0| I1: 125.0| WTP: 500000,1,0.096153846,515,500000,1,0.2,350,125,-1400656959,422157396,12131.22765,794095577.1,79409557.71,4,96591,4263,730,2015,1285,730,96591,1285,2015,303.9602273,4.085227273,11.3125,36754.43182,2040.965909,15.46022727,98801.69318,0.369351593,0.02049057,0.000156608,0.637717122,0.020861157,26,8
D:1| T0: 0.10| T1: 515.00| I0: 350.0| I1: 125.0| WTP: 500000,1,0.096153846,515,500000,1,0.2,350,125,-1314413236,1916599091,12196.69492,704578489.8,70457848.98,4,94800,4122,739,2026,1287,739,94800,1287,2026,306.1169591,4.263157895,11.69005848,38038.8655,1935.216374,16.00584795,98795.16374,0.382568431,0.019426391,0.000162357,0.635241856,0.021371308,25,7
D:1| T0: 0.10| T1: 515.00| I0: 350.0| I1: 125.0| WTP: 500000,1,0.096153846,515,500000,1,0.2,350,125,-1394522098,1005953941,12016.98896,793672650.1,79367265.01,4,96439,4253,739,1996,1257,739,96439,1257,1996,300.8587571,4.107344633,11.1299435,35529.49153,2208.711864,15.31638418,98792.36723,0.357169885,0.022171188,0.000155156,0.629759519,0.020697021,26,8
D:1| T0: 0.10| T1: 515.00| I0: 350.0| I1: 125.0| WTP: 500000,1,0.096153846,515,500000,1,0.2,350,125,-1351808627,1422765615,11418.30215,780893519.3,78089351.93,4,84828,3612,733,1897,1164,733,84828,1164,1897,138.1939394,2.115151515,5.615151515,35722.34242,890.2272727,7.851515152,98624.77576,0.360262854,0.008957915,8.01868E-05,0.613600422,0.022362899,48,8
D:1| T0: 0.10| T1: 515.00| I0: 350.0| I1: 125.0| WTP: 500000,1,0.096153846,515,500000,1,0.2,350,125,-4228123661,699740192,6524.677461,3901889787,390188978.7,22,47875,1996,1084,1084,0,1084,47875,0,1084,16.47122762,0.493606138,0.493606138,73489.03133,183.2525575,1.186061381,99419.09399,0.738662547,0.00184361,1.39285E-05,0,0.022642298,224,44
D:1| T0: 0.10| T1: 515.00| I0: 350.0| I1: 125.0| WTP: 500000,1,0.096153846,515,500000,1,0.2,350,125,-4372479122,240885764,5852.846749,4079836784,407983678.4,24,50320,2239,972,972,0,972,50320,0,972,16.65924142,0.386514148,0.386514148,72505.66045,185.3160747,0.964479229,99482.08489,0.728352697,0.001863451,1.17538E-05,0,0.019316375,238,46
D:1| T0: 0.10| T1: 515.00| I0: 350.0| I1: 125.0| WTP: 500000,1,0.096153846,515,500000,1,0.2,350,125,-1581553720,2023806564,9122.285902,1125439425,112543942.5,6,76148,3443,814,1515,701,814,76148,701,1515,91.77223427,1.650759219,3.15835141,39103.4859,691.2494577,4.934924078,98828.77007,0.394598588,0.006949047,5.07944E-05,0.462706271,0.019895989,66,12
D:1| T0: 0.10| T1: 515.00| I0: 350.0| I1: 125.0| WTP: 500000,1,0.096153846,515,500000,1,0.2,350,125,-3455488868,1907493879,6778.116575,3116583040,311658304,18,52096,2219,1126,1126,0,1126,52096,0,1126,17.64859694,0.558673469,0.558673469,61851.46365,207.7576531,1.279336735,99175.3463,0.623157985,0.002090665,1.44342E-05,0,0.021613943,223,35
D:1| T0: 0.10| T1: 515.00| I0: 350.0| I1: 125.0| WTP: 500000,1,0.096153846,515,500000,1,0.2,350,125,-2006116322,1565815291,10623.41755,1474945445,147494544.5,8,76751,3304,1108,1765,657,1108,76751,657,1765,121.8869048,3.175595238,5.077380952,53762.17857,1840.910714,8.375,99013.96131,0.540680734,0.018513514,8.60053E-05,0.37223796,0.022996443,48,16
D:1| T0: 0.10| T1: 515.00| I0: 350.0| I1: 125.0| WTP: 500000,1,0.096153846,515,500000,1,0.2,350,125,-3920734716,784442364,5641.747109,3638647360,363864736,22,47810,2094,937,937,0,937,47810,0,937,17.96453408,0.461752434,0.461752434,71455.62587,174.4874826,1.102920723,99452.22184,0.718083713,0.001754275,1.30841E-05,0,0.01959882,205,41
D:1| T0: 0.10| T1: 515.00| I0: 350.0| I1: 125.0| WTP: 500000,1,0.096153846,515,500000,1,0.2,350,125,-1328696419,206369745,10808.1209,788290373.8,78829037.38,4,89831,3978,651,1795,1144,651,89831,1144,1795,221.8854626,2.748898678,7.735682819,43566.67401,1652.828194,10.59911894,98966.01322,0.437483646,0.016592473,0.000108216,0.637325905,0.019981966,33,8
D:1| T0: 0.10| T1: 515.00| I0: 350.0| I1: 125.0| WTP: 500000,1,0.096153846,515,500000,1,0.2,350,125,-1399854953,2087235992,12154.60119,792124894.1,79212489.41,4,96085,4163,716,2019,1303,716,96085,1303,2019,244.4439252,3.271028037,9.299065421,35212.33178,1958.341121,12.64485981,98751.13084,0.353717758,0.019681409,0.000128441,0.645368995,0.021012645,31,8
D:1| T0: 0.10| T1: 515.00| I0: 350.0| I1: 125.0| WTP: 500000,1,0.096153846,515,500000,1,0.2,350,125,-1888918648,1019092536,8428.974663,1467469915,146746991.5,8,68486,3012,1175,1400,225,1175,68486,225,1400,47.73514212,1.351421189,1.630490956,47432.21189,489.2596899,3.147286822,98953.3553,0.478391663,0.004922074,3.34598E-05,0.160714286,0.020442433,111,16
D:1| T0: 0.10| T1: 515.00| I0: 350.0| I1: 125.0| WTP: 500000,1,0.096153846,515,500000,1,0.2,350,125,-1516146340,1885906113,8126.405233,1109826079,110982607.9,6,62004,2636,1026,1350,324,1026,62004,324,1350,66.26868687,1.884848485,2.525252525,53878.5596,383.0848485,4.612121212,99027.85657,0.543218206,0.00385044,4.82333E-05,0.24,0.021774545,71,12
D:1| T0: 0.10| T1: 515.00| I0: 350.0| I1: 125.0| WTP: 500000,1,0.096153846,515,500000,1,0.2,350,125,-3842334794,2028637200,7209.283156,3481870636,348187063.6,24,61659,2866,1196,1197,1,1196,61659,1,1197,24.97540984,0.636612022,0.637295082,55957.9515,163.6687158,1.450136612,99145.38866,0.563811547,0.001648091,1.64326E-05,0.000835422,0.019413224,210,39
D:1| T0: 0.10| T1: 515.00| I0: 350.0| I1: 125.0| WTP: 500000,1,0.096153846,515,500000,1,0.2,350,125,-1348419305,181476086,11216.21996,787608306.9,78760830.69,4,90943,4062,602,1863,1261,602,90943,1261,1863,222.6339286,2.558035714,8.147321429,41150.10714,1895.102679,10.85267857,98895.33036,0.413318973,0.019025792,0.000110546,0.676865271,0.020485359,32,8
D:1| T0: 0.10| T1: 515.00| I0: 350.0| I1: 125.0| WTP: 500000,1,0.096153846,515,500000,1,0.2,350,125,-1373254053,2097578470,11685.14698,788996704.4,78899670.44,4,89677,4071,709,1941,1232,709,89677,1232,1941,204.465587,2.761133603,7.71659919,39028.49798,1979.57085,10.57894737,98772.87449,0.392509754,0.019896899,0.00010786,0.634724369,0.021644346,36,8
D:1| T0: 0.10| T1: 515.00| I0: 350.0| I1: 125.0| WTP: 500000,1,0.096153846,515,500000,1,0.2,350,125,-1912530852,119646392,8909.355244,1467063090,146706309,8,66475,2877,1148,1480,332,1148,66475,332,1480,80.0372807,2.401315789,3.10745614,54870.66009,920.9802632,5.61622807,99036.08114,0.55261572,0.009258779,5.79312E-05,0.224324324,0.022264009,66,16
D:1| T0: 0.10| T1: 515.00| I0: 350.0| I1: 125.0| WTP: 500000,1,0.096153846,515,500000,1,0.2,350,125,-1370247682,1298895859,11601.48818,790173272.4,79017327.24,4,93306,4115,776,1927,1151,776,93306,1151,1927,241.3113208,3.566037736,8.938679245,37637.36321,1834.410377,12.61320755,98806.64151,0.378343302,0.018428409,0.000128055,0.597301505,0.020652477,31,8
D:1| T0: 0.10| T1: 515.00| I0: 350.0| I1: 125.0| WTP: 500000,1,0.096153846,515,500000,1,0.2,350,125,-1281086956,1489316290,10024.69192,779852360.3,77985236.03,4,79345,3565,660,1665,1005,660,79345,1005,1665,180.0277778,2.492063492,6.44047619,46518.76587,1094.714286,9.075396825,98935.94841,0.468242795,0.010993592,9.26423E-05,0.603603604,0.020984309,36,8
D:1| T0: 0.10| T1: 515.00| I0: 350.0| I1: 125.0| WTP: 500000,1,0.096153846,515,500000,1,0.2,350,125,-1452302520,855602142,13311.86476,786709281.5,78670928.15,4,96804,3861,655,2212,1557,655,96804,1557,2212,211.2857143,2.761904762,9.454545455,32627.65368,1496.593074,12.29004329,98553.32468,0.327857515,0.015056015,0.000124876,0.703887884,0.022850295,33,8
D:1| T0: 0.10| T1: 515.00| I0: 350.0| I1: 125.0| WTP: 500000,1,0.096153846,515,500000,1,0.2,350,125,-1814548709,1438649896,8640.058816,1382545768,138254576.8,8,69989,3087,1053,1435,382,1053,69989,382,1435,62.58995138,1.585089141,2.196110211,45529.67585,577.2155592,3.904376013,98911.89465,0.459269985,0.00580605,4.0552E-05,0.266202091,0.020503222,88,15
D:1| T0: 0.10| T1: 515.00| I0: 350.0| I1: 125.0| WTP: 500000,1,0.096153846,515,500000,1,0.2,350,125,-5121195407,952489126,6884.533894,4776968713,477696871.3,28,50520,2067,1144,1144,0,1144,50520,0,1144,11.0623039,0.372478709,0.372478709,62934.23398,173.6974451,0.871358135,99170.12819,0.634122724,0.001748364,1.03098E-05,0,0.022644497,319,54
D:1| T0: 0.10| T1: 515.00| I0: 350.0| I1: 125.0| WTP: 500000,1,0.096153846,515,500000,1,0.2,350,125,-1139908859,1550779155,10709.2349,604447113.9,60444711.39,4,84344,3554,549,1779,1230,549,84344,1230,1779,228.5606061,2.666666667,8.833333333,31327.41919,1191.515152,11.61616162,98631.5101,0.317057843,0.011953381,0.00011807,0.691399663,0.021092194,29,6
D:1| T0: 0.10| T1: 515.00| I0: 350.0| I1: 125.0| WTP: 500000,1,0.096153846,515,500000,1,0.2,350,125,-4169725672,607323321,7006.779399,3819386702,381938670.2,24,52294,2302,1164,1164,0,1164,52294,0,1164,18.35782748,0.533546326,0.533546326,67605.67732,161.3865815,1.284345048,99282.28562,0.680388979,0.001624889,1.49528E-05,0,0.022258768,224,43
D:1| T0: 0.10| T1: 515.00| I0: 350.0| I1: 125.0| WTP: 500000,1,0.096153846,515,500000,1,0.2,350,125,-1508441244,2103646485,7946.611489,1111110670,111111067,6,62287,2719,864,1320,456,864,62287,456,1320,63.35084428,1.491557223,2.335834897,50390.0863,351.3320826,3.943714822,98970.16135,0.508481349,0.003531716,4.11747E-05,0.345454545,0.021192223,77,12
D:1| T0: 0.10| T1: 515.00| I0: 350.0| I1: 125.0| WTP: 500000,1,0.096153846,515,500000,1,0.2,350,125,-1187916302,258120157,9816.134032,697109600.8,69710960.08,4,86490,3877,765,1630,865,765,86490,865,1630,274.125,4.25,9.079545455,37882.96023,1249.409091,13.42045455,98913.35227,0.38198227,0.012523214,0.000136465,0.530674847,0.018846109,26,7
D:1| T0: 0.10| T1: 515.00| I0: 350.0| I1: 125.0| WTP: 500000,1,0.096153846,515,500000,1,0.2,350,125,-2730667859,1068951401,7797.35494,2340800112,234080011.2,16,64005,2876,1260,1295,35,1260,64005,35,1295,32.51478743,0.980591497,1.012939002,53582.44455,230.9205176,2.173752311,99075.65619,0.540160704,0.002324312,2.37458E-05,0.027027027,0.02023311,155,26
D:1| T0: 0.10| T1: 515.00| I0: 350.0| I1: 125.0| WTP: 500000,1,0.096153846,515,500000,1,0.2,350,125,-2113796242,635956235,7825.906036,1722500940,172250094,10,60149,2645,1192,1300,108,1192,60149,108,1300,50.9207607,1.724247227,1.896988906,57611.18542,724.2044374,3.790808241,99114.56577,0.580202646,0.007278538,3.96863E-05,0.083076923,0.021612994,90,19
D:1| T0: 0.10| T1: 515.00| I0: 350.0| I1: 125.0| WTP: 500000,1,0.096153846,515,500000,1,0.2,350,125,-3965211913,1346693470,6571.947598,3636614533,363661453.3,22,48436,2030,1092,1092,0,1092,48436,0,1092,16.52419905,0.536468984,0.536468984,73078.25699,170.2324472,1.286298569,99399.38787,0.73468744,0.001712914,1.4959E-05,0,0.02254568,210,41
D:1| T0: 0.10| T1: 515.00| I0: 350.0| I1: 125.0| WTP: 500000,1,0.096153846,515,500000,1,0.2,350,125,-1436811384,847102011,12905.10747,791556010.2,79155601.02,4,96205,4107,751,2144,1393,751,96205,1393,2144,273.8465608,3.899470899,11.17989418,35680.60317,1746.306878,15.15873016,98687.22751,0.35874908,0.017551088,0.000153949,0.649720149,0.022285744,27,8
D:1| T0: 0.10| T1: 515.00| I0: 350.0| I1: 125.0| WTP: 500000,1,0.096153846,515,500000,1,0.2,350,125,-1714735427,812083272,11705.96907,1129436974,112943697.4,6,83229,3514,929,1945,1016,929,83229,1016,1945,144.9046053,2.927631579,6.226973684,47286.86513,1685.930921,9.289473684,98850.78289,0.475603073,0.016966441,9.51709E-05,0.522365039,0.023369258,44,12
D:1| T0: 0.10| T1: 515.00| I0: 350.0| I1: 125.0| WTP: 500000,1,0.096153846,515,500000,1,0.2,350,125,-1329200586,2146825809,10784.68261,789966455.8,78996645.58,4,92017,4213,791,1791,1000,791,92017,1000,1791,304.4285714,4.642857143,10.5,37555.85714,1728.714286,15.19642857,98890.13095,0.378191999,0.017334485,0.000154162,0.558347292,0.019463795,24,8
D:1| T0: 0.10| T1: 515.00| I0: 350.0| I1: 125.0| WTP: 500000,1,0.096153846,515,500000,1,0.2,350,125,-1422160518,226186520,12664.04666,788958184.6,78895818.46,4,95343,4023,741,2104,1363,741,95343,1363,2104,260.0829016,3.797927461,10.79274611,37185.46114,1436.834197,14.62176166,98720.09845,0.373754352,0.014436702,0.00014812,0.647813688,0.022067692,28,8
D:1| T0: 0.10| T1: 515.00| I0: 350.0| I1: 125.0| WTP: 500000,1,0.096153846,515,500000,1,0.2,350,125,-1671403457,1110225441,10793.9403,1131706442,113170644.2,6,83782,3620,1052,1793,741,1052,83782,741,1793,109.9299517,2.446859903,4.200483092,41402.09903,1563.417874,6.734299517,98811.07971,0.416752734,0.015736354,6.91861E-05,0.413273843,0.021400778,60,12
D:1| T0: 0.10| T1: 515.00| I0: 350.0| I1: 125.0| WTP: 500000,1,0.096153846,515,500000,1,0.2,350,125,-1549218757,1190767082,8438.31671,1127302922,112730292.2,6,76949,3602,948,1401,453,948,76949,453,1401,118.9835616,2.449315068,3.660273973,47656.75068,1125.112329,6.265753425,99097.87671,0.479408559,0.011297258,6.46439E-05,0.323340471,0.018206864,53,12
D:1| T0: 0.10| T1: 515.00| I0: 350.0| I1: 125.0| WTP: 500000,1,0.096153846,515,500000,1,0.2,350,125,-2435448421,2108234095,7385.219293,2066187457,206618745.7,12,55530,2286,1169,1227,58,1169,55530,58,1227,23.82895851,0.857747671,0.904318374,55397.91194,287.1193903,1.900931414,99024.49111,0.558900773,0.002888462,2.03958E-05,0.047269764,0.022096164,169,23
D:1| T0: 0.10| T1: 515.00| I0: 350.0| I1: 125.0| WTP: 500000,1,0.096153846,515,500000,1,0.2,350,125,-1427185703,465621985,12659.72959,794199223.5,79419922.35,4,95321,4277,739,2103,1364,739,95321,1364,2103,254.4666667,3.428571429,9.880952381,29536.09524,1563.871429,13.39047619,98550.21429,0.297670185,0.015724434,0.000136115,0.648597242,0.022062295,30,8
D:1| T0: 0.10| T1: 515.00| I0: 350.0| I1: 125.0| WTP: 500000,1,0.096153846,515,500000,1,0.2,350,125,-2041278679,1487072553,7960.73609,1643241875,164324187.5,10,65231,2997,1217,1322,105,1217,65231,105,1322,51.45655172,1.499310345,1.63862069,54990.30345,322.5186207,3.313103448,99088.80414,0.554205933,0.003244994,3.52069E-05,0.079425113,0.020267681,104,18
D:1| T0: 0.10| T1: 515.00| I0: 350.0| I1: 125.0| WTP: 500000,1,0.096153846,515,500000,1,0.2,350,125,-1585188215,1213733847,9300.804262,1120148002,112014800.2,6,70532,3040,894,1545,651,894,70532,651,1545,119.8707692,2.618461538,4.593846154,51998.73538,921.44,7.335384615,99000.21846,0.523719141,0.009257401,7.54013E-05,0.421359223,0.021904951,47,12
D:1| T0: 0.10| T1: 515.00| I0: 350.0| I1: 125.0| WTP: 500000,1,0.096153846,515,500000,1,0.2,350,125,-1284823097,2003658337,10197.28708,774958743.2,77495874.32,4,78538,3342,749,1694,945,749,78538,945,1694,140.7766667,2.353333333,5.473333333,47004.39,1069.653333,7.96,98919.34667,0.473175567,0.010748333,8.18436E-05,0.55785124,0.021570001,43,8
D:1| T0: 0.10| T1: 515.00| I0: 350.0| I1: 125.0| WTP: 500000,1,0.096153846,515,500000,1,0.2,350,125,-4934846278,1170868072,6567.725755,4606459990,460645999,30,53365,2317,1091,1091,0,1091,53365,0,1091,14.70659631,0.382585752,0.382585752,66850.50185,163.4612137,0.959894459,99331.70976,0.672474871,0.001645104,1.15715E-05,0,0.020444111,271,52
D:1| T0: 0.10| T1: 515.00| I0: 350.0| I1: 125.0| WTP: 500000,1,0.096153846,515,500000,1,0.2,350,125,-1248387758,569919592,10946.42582,701066467.4,70106646.74,4,90927,4036,754,1818,1064,754,90927,1064,1818,253.4723618,3.698492462,8.979899497,30524.05528,1191.648241,12.79396985,98700.54774,0.30818856,0.011961138,0.000129833,0.585258526,0.019994061,29,7
D:1| T0: 0.10| T1: 515.00| I0: 350.0| I1: 125.0| WTP: 500000,1,0.096153846,515,500000,1,0.2,350,125,-1536052886,1833180623,8233.200098,1124392881,112439288.1,6,73609,3467,1010,1367,357,1010,73609,357,1367,94.02031603,2.119638826,2.898419865,46665.58916,775.4740406,5.162528217,99053.39278,0.469996077,0.007789716,5.39094E-05,0.261155816,0.018571099,64,12
D:1| T0: 0.10| T1: 515.00| I0: 350.0| I1: 125.0| WTP: 500000,1,0.096153846,515,500000,1,0.2,350,125,-1449906411,1123666637,13169.32017,791440402.2,79144040.22,4,93680,4045,755,2188,1433,755,93680,1433,2188,305.5621302,4.384615385,12.77514793,40612.14201,1667.100592,17.24260355,98739.3432,0.408409567,0.01674863,0.000174963,0.654936015,0.023356106,25,8
D:1| T0: 0.10| T1: 515.00| I0: 350.0| I1: 125.0| WTP: 500000,1,0.096153846,515,500000,1,0.2,350,125,-1704109548,1682024981,11412.92154,1133463471,113346347.1,6,89643,3842,764,1896,1132,764,89643,1132,1896,188.3951613,2.943548387,7.475806452,45053.7621,2954.197581,10.55241935,98945.47581,0.452364142,0.029691437,0.000107839,0.597046414,0.021150564,35,12
D:1| T0: 0.10| T1: 515.00| I0: 350.0| I1: 125.0| WTP: 500000,1,0.096153846,515,500000,1,0.2,350,125,-1614347386,1687523543,9853.780441,1121658364,112165836.4,6,73916,3191,910,1637,727,910,73916,727,1637,121.412844,2.660550459,4.856269113,51852.32722,863.6544343,7.617737003,98992.85015,0.521887287,0.008680329,7.82927E-05,0.44410507,0.02214736,47,12
D:1| T0: 0.10| T1: 515.00| I0: 350.0| I1: 125.0| WTP: 500000,1,0.096153846,515,500000,1,0.2,350,125,-1345635842,178034412,11156.26963,787822360.1,78782236.01,4,88629,4029,653,1853,1200,653,88629,1200,1853,261.5811518,3.287958115,9.523560209,46469.73822,1635.806283,12.93717277,98981.01571,0.466733283,0.016413064,0.000131658,0.647598489,0.020907378,28,8
D:1| T0: 0.10| T1: 515.00| I0: 350.0| I1: 125.0| WTP: 500000,1,0.096153846,515,500000,1,0.2,350,125,-1343632261,739490003,11055.20661,790871930.9,79087193.09,4,91593,4084,689,1836,1147,689,91593,1147,1836,260.4773869,3.376884422,9.085427136,41796.68844,1289.628141,12.54271357,98924.0804,0.419874794,0.012941805,0.00012734,0.624727669,0.0200452,29,8
D:1| T0: 0.10| T1: 515.00| I0: 350.0| I1: 125.0| WTP: 500000,1,0.096153846,515,500000,1,0.2,350,125,-1553233087,178482706,10405.85626,1032940274,103294027.4,6,74832,3109,748,1729,981,748,74832,981,1729,105.8054054,1.886486486,4.510810811,44486.69189,865.7702703,6.52972973,98771.49189,0.44878558,0.008704529,6.73512E-05,0.567379988,0.023105397,53,11
D:1| T0: 0.10| T1: 515.00| I0: 350.0| I1: 125.0| WTP: 500000,1,0.096153846,515,500000,1,0.2,350,125,-1531958326,1919366370,9979.550375,1032980808,103298080.8,6,71648,3083,914,1658,744,914,71648,744,1658,65.85016835,1.427609428,2.668350168,41756.26263,416.1902357,4.19023569,98679.4899,0.422029262,0.004190934,4.35861E-05,0.448733414,0.023140911,85,11
D:1| T0: 0.10| T1: 515.00| I0: 350.0| I1: 125.0| WTP: 500000,1,0.096153846,515,500000,1,0.2,350,125,-1350194507,1819796913,11110.46298,794671358.1,79467135.81,4,96556,4424,693,1845,1152,693,96556,1152,1845,305.4971751,3.858757062,10.31638418,39525.46893,2242.305085,14.22033898,98959.40113,0.396708982,0.022489033,0.000143838,0.624390244,0.019108082,26,8
D:1| T0: 0.10| T1: 515.00| I0: 350.0| I1: 125.0| WTP: 500000,1,0.096153846,515,500000,1,0.2,350,125,-1687407474,1866591913,11129.97502,1130908723,113090872.3,6,83745,3646,1088,1849,761,1088,83745,761,1849,108.7070218,2.520581114,4.319612591,44543.16949,1673.42615,6.96125908,98850.49395,0.448054997,0.016843643,7.16161E-05,0.411573824,0.02207893,59,12
D:1| T0: 0.10| T1: 515.00| I0: 350.0| I1: 125.0| WTP: 500000,1,0.096153846,515,500000,1,0.2,350,125,-1283167706,1219425989,11643.03443,701015984.6,70101598.46,4,90737,4104,792,1934,1142,792,90737,1142,1934,271.2054054,4.194594595,10.29189189,32771.8973,1265.313514,14.56216216,98674.60541,0.330799664,0.012702179,0.000148043,0.590486039,0.021314348,27,7
D:1| T0: 0.10| T1: 515.00| I0: 350.0| I1: 125.0| WTP: 500000,1,0.096153846,515,500000,1,0.2,350,125,-1375186767,502409586,11691.69309,790602112.6,79060211.26,4,94589,4132,740,1942,1202,740,94589,1202,1942,234.9086758,3.292237443,8.716894977,35365.22374,1740.424658,12.12328767,98775.38813,0.355504956,0.017480772,0.000123025,0.618949537,0.020530929,32,8
D:1| T0: 0.10| T1: 515.00| I0: 350.0| I1: 125.0| WTP: 500000,1,0.096153846,515,500000,1,0.2,350,125,-1298231005,1405887957,10390.66199,778697905.8,77869790.58,4,81475,3596,731,1726,995,731,81475,995,1726,190.7467811,3.017167382,7.253218884,47510.91416,1061.261803,10.39484979,98959.02575,0.477923174,0.010656147,0.000105861,0.576477404,0.021184412,34,8
D:1| T0: 0.10| T1: 515.00| I0: 350.0| I1: 125.0| WTP: 500000,1,0.096153846,515,500000,1,0.2,350,125,-1310750888,283033753,10772.86618,772107578.5,77210757.85,4,78441,3243,736,1790,1054,736,78441,1054,1790,159.4703557,2.754940711,6.865612648,46613.99605,821.6679842,9.794466403,98849.01581,0.469582242,0.008255853,0.000100309,0.588826816,0.022819699,37,8
D:1| T0: 0.10| T1: 515.00| I0: 350.0| I1: 125.0| WTP: 500000,1,0.096153846,515,500000,1,0.2,350,125,-1631707308,1083157068,10178.47526,1122783545,112278354.5,6,75552,3236,1104,1691,587,1104,75552,587,1691,82.34836066,2.096311475,3.266393443,42607.33607,785.3504098,5.540983607,98773.31967,0.429969257,0.007901423,5.76564E-05,0.347131875,0.022381936,70,12
D:1| T0: 0.10| T1: 515.00| I0: 350.0| I1: 125.0| WTP: 500000,1,0.096153846,515,500000,1,0.2,350,125,-1575601853,1988704626,9315.465025,1109828602,110982860.2,6,64252,2684,1092,1548,456,1092,64252,456,1548,52.1364366,1.566613162,2.290529695,49615.64045,264.8988764,4.048154093,98808.39647,0.501301032,0.002667251,4.26434E-05,0.294573643,0.024092635,89,12
D:1| T0: 0.10| T1: 515.00| I0: 350.0| I1: 125.0| WTP: 500000,1,0.096153846,515,500000,1,0.2,350,125,-1235553535,884761309,10818.19661,694643704,69464370.4,4,83967,3749,680,1797,1117,680,83967,1117,1797,191.8065844,2.703703704,7.279835391,29886.15226,898.345679,10.08230453,98566.96708,0.302686556,0.009023984,0.000102489,0.621591541,0.02140152,35,7
D:1| T0: 0.10| T1: 515.00| I0: 350.0| I1: 125.0| WTP: 500000,1,0.096153846,515,500000,1,0.2,350,125,-2352531316,533485933,7215.347288,1991763952,199176395.2,14,62686,2925,1184,1198,14,1184,62686,14,1198,37.23384615,1.045128205,1.059487179,55407.94872,174.9579487,2.258461538,99157.82051,0.558159142,0.001760585,2.45524E-05,0.011686144,0.019111125,140,22
D:1| T0: 0.10| T1: 515.00| I0: 350.0| I1: 125.0| WTP: 500000,1,0.096153846,515,500000,1,0.2,350,125,-2031311622,632196071,7951.619571,1633730644,163373064.4,12,61062,2615,1236,1321,85,1236,61062,85,1321,42.06818182,1.446524064,1.554812834,56791.55214,210.6737968,3.207219251,99079.67781,0.572498551,0.002120235,3.43677E-05,0.064393939,0.021621622,107,18
D:1| T0: 0.10| T1: 515.00| I0: 350.0| I1: 125.0| WTP: 500000,1,0.096153846,515,500000,1,0.2,350,125,-1367451527,393400457,11482.34108,793334472.9,79333447.29,4,94442,4189,581,1907,1326,581,94442,1326,1907,266.935,2.815,9.385,40691.735,1473.695,12.275,98891.985,0.408448052,0.014792933,0.000124897,0.695332984,0.020192287,29,8
D:1| T0: 0.10| T1: 515.00| I0: 350.0| I1: 125.0| WTP: 500000,1,0.096153846,515,500000,1,0.2,350,125,-1308958325,398973227,10671.83767,775366441.6,77536644.16,4,79252,3307,687,1773,1086,687,79252,1086,1773,156.6273063,2.420664207,6.383763838,44968.54613,876.2804428,8.915129151,98833.99631,0.453017302,0.00880499,9.123E-05,0.612521151,0.02237224,39,8
D:1| T0: 0.10| T1: 515.00| I0: 350.0| I1: 125.0| WTP: 500000,1,0.096153846,515,500000,1,0.2,350,125,-1632435487,1402256491,10019.10245,1131480364,113148036.4,6,81489,3659,898,1664,766,898,81489,766,1664,145.1238095,2.720634921,5.126984127,46008.50794,1633.187302,7.984126984,98967.87302,0.462769249,0.016412544,8.17556E-05,0.460336538,0.020419934,45,12
D:1| T0: 0.10| T1: 515.00| I0: 350.0| I1: 125.0| WTP: 500000,1,0.096153846,515,500000,1,0.2,350,125,-1417702314,2102527413,12585.78621,788413003.6,78841300.36,4,91625,3900,698,2091,1393,698,91625,1393,2091,198.4365079,2.662698413,8.154761905,39848.72619,2102.353175,10.92063492,98734.33333,0.400390378,0.021147796,0.000111369,0.666188427,0.022821282,36,8
D:1| T0: 0.10| T1: 515.00| I0: 350.0| I1: 125.0| WTP: 500000,1,0.096153846,515,500000,1,0.2,350,125,-1376646080,1748031099,11822.1405,785539054.7,78553905.47,4,91504,3881,672,1964,1292,672,91504,1292,1964,205.0805085,2.737288136,8.177966102,38983.5339,2100.516949,11.00847458,98797.72458,0.39176593,0.021109395,0.000112304,0.657841141,0.021464012,34,8
D:1| T0: 0.10| T1: 515.00| I0: 350.0| I1: 125.0| WTP: 500000,1,0.096153846,515,500000,1,0.2,350,125,-1815205527,1946754629,8758.466225,1377282216,137728221.6,8,66108,2908,1222,1455,233,1222,66108,233,1455,47.11497326,1.467914439,1.762032086,50121.11096,339.5935829,3.394385027,98927.35294,0.505714593,0.003417865,3.60028E-05,0.160137457,0.022010438,107,15
D:1| T0: 0.10| T1: 515.00| I0: 350.0| I1: 125.0| WTP: 500000,1,0.096153846,515,500000,1,0.2,350,125,-1513576986,2097712204,8013.258541,1112914059,111291405.9,6,64921,2912,1013,1331,318,1013,64921,318,1331,62.7920434,1.638336347,2.198915009,51456.95118,366.3562387,4.048824593,99031.05606,0.518807863,0.003683309,4.25992E-05,0.238918107,0.020501841,79,12
D:1| T0: 0.10| T1: 515.00| I0: 350.0| I1: 125.0| WTP: 500000,1,0.096153846,515,500000,1,0.2,350,125,-1885383761,1198827119,8427.924174,1463987552,146398755.2,8,61458,2695,1235,1400,165,1235,61458,165,1400,46.82479784,1.517520216,1.735849057,54867.54582,532.3989218,3.396226415,98998.42453,0.553175636,0.005355092,3.57125E-05,0.117857143,0.022779785,106,16
D:1| T0: 0.10| T1: 515.00| I0: 350.0| I1: 125.0| WTP: 500000,1,0.096153846,515,500000,1,0.2,350,125,-4805373657,109253198,5898.370688,4510455123,451045512.3,26,44080,1926,980,980,0,980,44080,0,980,10.11950791,0.267574692,0.267574692,72086.21002,135.7913005,0.695957821,99385.44244,0.724887089,0.001366413,8.65017E-06,0,0.022232305,325,51
D:1| T0: 0.10| T1: 515.00| I0: 350.0| I1: 125.0| WTP: 500000,1,0.096153846,515,500000,1,0.2,350,125,-2801333452,314481292,7614.635597,2420601672,242060167.2,18,59143,2514,1260,1265,5,1260,59143,5,1265,30.27462687,1.04278607,1.046766169,61269.94428,175.2855721,2.315422886,99182.91244,0.617068887,0.001764634,2.5259E-05,0.003952569,0.021388837,144,27
D:1| T0: 0.10| T1: 515.00| I0: 400.0| I1: 75.0| WTP: 600000,1,0.096153846,515,600000,1,0.2,400,75,-3603639915,1178568022,7896.636302,3208808099,320880809.9,18,59234,2503,1312,1312,0,1312,59234,0,1312,19.75921053,0.681578947,0.681578947,60022.95461,199.9256579,1.532894737,99122.60658,0.604880848,0.002013773,1.73655E-05,0,0.022149441,217,36
D:1| T0: 0.10| T1: 515.00| I0: 400.0| I1: 75.0| WTP: 600000,1,0.096153846,515,600000,1,0.2,400,75,-1383520751,2029998696,11830.2407,792008715.4,79200871.54,4,94945,4164,648,1965,1317,648,94945,1317,1965,230.8502203,2.753303965,8.524229075,35657.04846,1414.511013,11.37444934,98757.2467,0.358235323,0.014213002,0.00011567,0.670229008,0.020696193,33,8
D:1| T0: 0.10| T1: 515.00| I0: 400.0| I1: 75.0| WTP: 600000,1,0.096153846,515,600000,1,0.2,400,75,-1413972414,776062361,12590.52504,784446162.6,78444616.26,4,92374,3822,796,2092,1296,796,92374,1296,2092,176.2304833,2.862453532,7.643122677,39223.80669,2136.762082,10.60594796,98727.87361,0.394065151,0.021505698,0.000108069,0.619502868,0.022647065,38,8
D:1| T0: 0.10| T1: 515.00| I0: 400.0| I1: 75.0| WTP: 600000,1,0.096153846,515,600000,1,0.2,400,75,-3615887381,1813046880,8054.207821,3213176990,321317699,18,59021,2632,1332,1338,6,1332,59021,6,1338,23.01688951,0.737508797,0.741027445,59178.40113,263.1013371,1.694581281,99088.18578,0.596549104,0.0026493,1.89027E-05,0.004484305,0.022669897,203,36
D:1| T0: 0.10| T1: 515.00| I0: 400.0| I1: 75.0| WTP: 600000,1,0.096153846,515,600000,1,0.2,400,75,-2105309265,2032407216,7563.107386,1727153896,172715389.6,10,63774,2844,1151,1256,105,1151,63774,105,1256,42.35817308,1.188701923,1.308894231,53134.13822,268.0961538,2.689903846,99098.81611,0.535527463,0.002696444,2.90788E-05,0.083665339,0.019679483,119,19
D:1| T0: 0.10| T1: 515.00| I0: 400.0| I1: 75.0| WTP: 600000,1,0.096153846,515,600000,1,0.2,400,75,-5259165051,1507873352,6204.732487,4948928427,494892842.7,28,46312,1952,1031,1031,0,1031,46312,0,1031,8.945631068,0.255533981,0.255533981,70181.05864,130.2842718,0.657864078,99336.2532,0.705997496,0.001311641,8.0461E-06,0,0.022262049,367,56
D:1| T0: 0.10| T1: 515.00| I0: 400.0| I1: 75.0| WTP: 600000,1,0.096153846,515,600000,1,0.2,400,75,-2837573786,1855899401,6634.900785,2505828746,250582874.6,14,51159,2336,1102,1102,0,1102,51159,0,1102,25.6127067,0.753698869,0.753698869,68187.16362,165.3516101,1.700609225,99334.80592,0.685925385,0.001663487,1.92712E-05,0,0.021540687,165,28
D:1| T0: 0.10| T1: 515.00| I0: 400.0| I1: 75.0| WTP: 600000,1,0.096153846,515,600000,1,0.2,400,75,-1281892609,1819459251,10172.70203,773257507.6,77325750.76,4,76418,3302,742,1690,948,742,76418,948,1690,125.5731707,2.131097561,4.987804878,45077.6372,836.4054878,7.237804878,98842.49695,0.454341786,0.008406084,7.45449E-05,0.560946746,0.022116077,47,8
D:1| T0: 0.10| T1: 515.00| I0: 400.0| I1: 75.0| WTP: 600000,1,0.096153846,515,600000,1,0.2,400,75,-3191595794,909791748,6760.043144,2853593637,285359363.7,18,51995,2241,1123,1123,0,1123,51995,0,1123,17.97666883,0.539209332,0.539209332,65936.60596,108.9727803,1.268956578,99274.31367,0.663629445,0.001097773,1.46286E-05,0,0.021598646,221,32
D:1| T0: 0.10| T1: 515.00| I0: 400.0| I1: 75.0| WTP: 600000,1,0.096153846,515,600000,1,0.2,400,75,-1476838419,1339092841,9063.685199,1023654159,102365415.9,6,65749,2721,812,1506,694,812,65749,694,1506,89.15915119,2.068965517,3.888594164,51412.98674,627.1883289,6.031830239,98925.66048,0.518515701,0.006302596,6.17803E-05,0.460823373,0.02290564,54,11
D:1| T0: 0.10| T1: 515.00| I0: 400.0| I1: 75.0| WTP: 600000,1,0.096153846,515,600000,1,0.2,400,75,-1403507233,1365866345,12208.93929,793060268.4,79306026.84,4,95855,4267,715,2028,1313,715,95855,1313,2028,219.3112033,2.887966805,8.298755187,32980.77593,1247.344398,11.24481328,98667.9917,0.331489792,0.0125414,0.000114431,0.647435897,0.021156956,35,8
D:1| T0: 0.10| T1: 515.00| I0: 400.0| I1: 75.0| WTP: 600000,1,0.096153846,515,600000,1,0.2,400,75,-1572425539,825453433,8912.60515,1126795282,112679528.2,6,75128,3348,899,1480,581,899,75128,581,1480,106.8044554,2.094059406,3.514851485,45192.02475,946.3836634,5.747524752,98971.0198,0.455215944,0.009507945,5.91903E-05,0.392567568,0.019699712,58,12
D:1| T0: 0.10| T1: 515.00| I0: 400.0| I1: 75.0| WTP: 600000,1,0.096153846,515,600000,1,0.2,400,75,-1392680308,939711378,11974.9893,793930842.6,79393084.26,4,96951,4287,640,1989,1349,640,96951,1349,1989,232.7434783,2.726086957,8.539130435,32911.42174,1656.417391,11.30434783,98717.07391,0.330585224,0.016642516,0.000114881,0.678230266,0.020515518,33,8
D:1| T0: 0.10| T1: 515.00| I0: 400.0| I1: 75.0| WTP: 600000,1,0.096153846,515,600000,1,0.2,400,75,-1894952660,638950699,8430.951515,1473405084,147340508.4,8,70609,3151,1087,1400,313,1087,70609,313,1400,69.30204778,1.747440273,2.262798635,45785.31399,760.7542662,4.126279863,98958.57167,0.461567767,0.007648648,4.26643E-05,0.223571429,0.019827501,84,16
D:1| T0: 0.10| T1: 515.00| I0: 400.0| I1: 75.0| WTP: 600000,1,0.096153846,515,600000,1,0.2,400,75,-2044818313,938699148,8056.404785,1641998074,164199807.4,10,65703,2965,1259,1338,79,1259,65703,79,1338,46.52101911,1.405095541,1.496815287,53485.68408,280.8509554,3.100636943,99071.22038,0.53914998,0.002826195,3.32647E-05,0.059043348,0.020364367,113,18
D:1| T0: 0.10| T1: 515.00| I0: 400.0| I1: 75.0| WTP: 600000,1,0.096153846,515,600000,1,0.2,400,75,-3884003155,121790188,6438.102574,3562098026,356209802.6,20,56679,2623,1069,1069,0,1069,56679,0,1069,20.35390428,0.498110831,0.498110831,61657.86713,256.8457179,1.176322418,99283.08186,0.620499608,0.002583134,1.35271E-05,0,0.018860601,226,40
D:1| T0: 0.10| T1: 515.00| I0: 400.0| I1: 75.0| WTP: 600000,1,0.096153846,515,600000,1,0.2,400,75,-1618858892,1331335240,11336.8885,1052014467,105201446.7,6,90734,3926,720,1883,1163,720,90734,1163,1883,202.708,2.764,7.368,40985.628,2391.792,10.244,98879.656,0.41171151,0.024033941,0.000104673,0.617631439,0.02075297,36,11
D:1| T0: 0.10| T1: 515.00| I0: 400.0| I1: 75.0| WTP: 600000,1,0.096153846,515,600000,1,0.2,400,75,-1344883793,470935411,12850.55476,702356055.6,70235605.56,4,93723,3995,728,2135,1407,728,93723,1407,2135,299.1823529,4.194117647,12.37647059,34795.56471,1426.711765,16.67058824,98640.10588,0.350554058,0.014330058,0.000169245,0.659016393,0.022779894,25,7
D:1| T0: 0.10| T1: 515.00| I0: 400.0| I1: 75.0| WTP: 600000,1,0.096153846,515,600000,1,0.2,400,75,-1605330363,823434397,9785.986436,1116031041,111603104.1,6,69486,2888,1189,1626,437,1189,69486,437,1626,59.44059406,1.836633663,2.537953795,46806.24092,586.9438944,4.491749175,98788.86469,0.472555394,0.005908499,4.67626E-05,0.268757688,0.023400734,87,12
D:1| T0: 0.10| T1: 515.00| I0: 400.0| I1: 75.0| WTP: 600000,1,0.096153846,515,600000,1,0.2,400,75,-2682447651,493045351,6954.607451,2334717279,233471727.9,14,56330,2515,1155,1155,0,1155,56330,0,1155,32.16902834,0.971659919,0.971659919,65319.84211,144.9959514,2.125506073,99320.02935,0.656991942,0.001459115,2.34922E-05,0,0.020504172,142,26
D:1| T0: 0.10| T1: 515.00| I0: 400.0| I1: 75.0| WTP: 600000,1,0.096153846,515,600000,1,0.2,400,75,-1838661655,1700216563,7361.064812,1470608414,147060841.4,8,65144,3001,975,1222,247,975,65144,247,1222,88.37837838,2.094594595,2.628378378,56137.5518,787.8243243,4.81981982,99214.01126,0.564670987,0.007908486,4.96717E-05,0.20212766,0.018758731,64,16
D:1| T0: 0.10| T1: 515.00| I0: 400.0| I1: 75.0| WTP: 600000,1,0.096153846,515,600000,1,0.2,400,75,-1730984569,1744119059,7124.103118,1374779413,137477941.3,8,60673,2809,1039,1183,144,1039,60673,144,1183,47.4757953,1.2406639,1.432918396,53086.77593,230.8907331,2.87275242,99100.10927,0.535221416,0.002321487,3.08754E-05,0.121724429,0.019497964,104,15
D:1| T0: 0.10| T1: 515.00| I0: 400.0| I1: 75.0| WTP: 600000,1,0.096153846,515,600000,1,0.2,400,75,-2532250973,2036906360,7447.180971,2159891924,215989192.4,12,58820,2606,1221,1237,16,1221,58820,16,1237,22.45780591,0.695499297,0.708157525,53542.94726,287.1420534,1.565400844,99046.69339,0.540002808,0.00288975,1.73805E-05,0.012934519,0.021030262,203,24
D:1| T0: 0.10| T1: 515.00| I0: 400.0| I1: 75.0| WTP: 600000,1,0.096153846,515,600000,1,0.2,400,75,-1877769364,809704121,8171.308232,1469203953,146920395.3,8,67694,3069,1009,1357,348,1009,67694,348,1357,91.42925659,2.278177458,3.09352518,55503.19664,838.7889688,5.51558753,99149.98561,0.558406623,0.008424791,5.69833E-05,0.256448047,0.02004609,59,16
D:1| T0: 0.10| T1: 515.00| I0: 400.0| I1: 75.0| WTP: 600000,1,0.096153846,515,600000,1,0.2,400,75,-1700234090,1219866412,11258.06692,1137330744,113733074.4,6,89654,3951,801,1870,1069,801,89654,1069,1870,186.7528517,2.923954373,6.950570342,40127.79468,2798.513308,9.992395437,98855.30798,0.403365863,0.028130056,0.000102118,0.571657754,0.020857965,38,12
D:1| T0: 0.10| T1: 515.00| I0: 400.0| I1: 75.0| WTP: 600000,1,0.096153846,515,600000,1,0.2,400,75,-4788763714,843498920,7120.804483,4432723490,443272349,26,53422,2292,1183,1183,0,1183,53422,0,1183,15.74876033,0.461707989,0.461707989,66822.66006,141.984022,1.114049587,99285.2551,0.672401287,0.001429719,1.31061E-05,0,0.022144435,260,50
D:1| T0: 0.10| T1: 515.00| I0: 400.0| I1: 75.0| WTP: 600000,1,0.096153846,515,600000,1,0.2,400,75,-1981660987,107351963,10326.07949,1465357012,146535701.2,8,71840,2807,1295,1716,421,1295,71840,421,1716,48.4813278,1.64868603,2.215767635,44824.26694,690.9377593,3.987551867,98718.40387,0.452727074,0.006959652,4.19493E-05,0.245337995,0.023886414,104,16
D:1| T0: 0.10| T1: 515.00| I0: 400.0| I1: 75.0| WTP: 600000,1,0.096153846,515,600000,1,0.2,400,75,-1897380583,773789021,8608.970154,1466932075,146693207.5,8,69060,3016,1080,1430,350,1080,69060,350,1430,63.23529412,1.74567474,2.335640138,47481.24913,811.6816609,4.223183391,98946.90657,0.478726033,0.008161808,4.36655E-05,0.244755245,0.020706632,83,16
D:1| T0: 0.10| T1: 515.00| I0: 400.0| I1: 75.0| WTP: 600000,1,0.096153846,515,600000,1,0.2,400,75,-1618199969,850936611,10020.55179,1117172380,111717238,6,69867,2894,1127,1665,538,1127,69867,538,1665,57.07142857,1.641304348,2.448757764,44639.63509,575.613354,4.187888199,98709.67081,0.451028243,0.005796502,4.36564E-05,0.323123123,0.023830993,92,12
D:1| T0: 0.10| T1: 515.00| I0: 400.0| I1: 75.0| WTP: 600000,1,0.096153846,515,600000,1,0.2,400,75,-1568445633,1701318364,8982.293752,1119330945,111933094.5,6,70496,3025,1075,1492,417,1075,70496,417,1492,60.82250396,1.580031696,2.228209192,42821.13154,470.340729,3.93977813,98808.25674,0.43253079,0.004732987,4.09292E-05,0.279490617,0.021164321,91,12
D:1| T0: 0.10| T1: 515.00| I0: 400.0| I1: 75.0| WTP: 600000,1,0.096153846,515,600000,1,0.2,400,75,-3525584487,778708269,6394.292181,3205869878,320586987.8,18,50300,2259,1062,1062,0,1062,50300,0,1062,18.20770202,0.517676768,0.517676768,62806.15278,245.5625,1.193181818,99223.0202,0.632489342,0.002469286,1.34719E-05,0,0.02111332,227,36
D:1| T0: 0.10| T1: 515.00| I0: 400.0| I1: 75.0| WTP: 600000,1,0.096153846,515,600000,1,0.2,400,75,-3012906549,1391938506,8299.919938,2597910552,259791055.2,16,58194,2492,1354,1379,25,1354,58194,25,1379,21.14688129,0.737089202,0.752515091,54546.01945,139.3742455,1.661971831,98936.74178,0.550818492,0.001404795,1.84449E-05,0.018129079,0.023696601,213,29
D:1| T0: 0.10| T1: 515.00| I0: 400.0| I1: 75.0| WTP: 600000,1,0.096153846,515,600000,1,0.2,400,75,-3849497911,43418681,5995.62566,3549716628,354971662.8,20,46926,2049,996,996,0,996,46926,0,996,15.51272502,0.419615146,0.419615146,71119.00807,163.4034761,1.048417132,99388.88579,0.715123163,0.001643615,1.24191E-05,0,0.021224907,231,40
D:1| T0: 0.10| T1: 515.00| I0: 400.0| I1: 75.0| WTP: 600000,1,0.096153846,515,600000,1,0.2,400,75,-1417547193,817384966,12692.12962,782940711.9,78294071.19,4,90602,3756,789,2109,1320,789,90602,1320,2109,252.4456522,4.195652174,11.2826087,40878.88587,1341.407609,15.5923913,98743.14674,0.411496812,0.013472938,0.000158227,0.625889047,0.023277632,27,8
D:1| T0: 0.10| T1: 515.00| I0: 400.0| I1: 75.0| WTP: 600000,1,0.096153846,515,600000,1,0.2,400,75,-1329680087,762053968,10908.90403,784234885.7,78423488.57,4,89409,3903,706,1812,1106,706,89409,1106,1812,233.9460784,3.362745098,8.730392157,42878.75,1366.02451,12.18627451,98936.04902,0.430944848,0.013709946,0.000123882,0.610375276,0.020266416,30,8
D:1| T0: 0.10| T1: 515.00| I0: 400.0| I1: 75.0| WTP: 600000,1,0.096153846,515,600000,1,0.2,400,75,-1875569597,1692506311,8129.27901,1469105647,146910564.7,8,68062,3054,1210,1350,140,1210,68062,140,1350,47.73081761,1.38490566,1.553459119,47667.30189,568.436478,3.059119497,98987.66289,0.480621105,0.005717023,3.23789E-05,0.103703704,0.019835148,113,16
D:1| T0: 0.10| T1: 515.00| I0: 400.0| I1: 75.0| WTP: 600000,1,0.096153846,515,600000,1,0.2,400,75,-3167003264,1037620300,6303.097305,2851848399,285184839.9,16,49237,2132,1047,1047,0,1047,49237,0,1047,22.89982877,0.696061644,0.696061644,70975.29452,176.4760274,1.580479452,99394.03853,0.713578954,0.001774929,1.80068E-05,0,0.021265792,167,32
D:1| T0: 0.10| T1: 515.00| I0: 400.0| I1: 75.0| WTP: 600000,1,0.096153846,515,600000,1,0.2,400,75,-2904191271,301400999,7844.06808,2511987867,251198786.7,14,62192,2694,1303,1303,0,1303,62192,0,1303,28.55954466,0.955341506,0.955341506,57885.3021,225.4098074,2.073555166,99134.0035,0.583277049,0.00226903,2.29488E-05,0,0.020951248,164,28
D:1| T0: 0.10| T1: 515.00| I0: 400.0| I1: 75.0| WTP: 600000,1,0.096153846,515,600000,1,0.2,400,75,-1336895639,1868336855,11035.35716,785127780.7,78512778.07,4,88867,3905,818,1833,1015,818,88867,1015,1833,214.8928571,3.53125,8.035714286,45474.58482,1548.191964,11.6875,98973.66518,0.456759151,0.015547365,0.000118855,0.553737043,0.020626329,32,8
D:1| T0: 0.10| T1: 515.00| I0: 400.0| I1: 75.0| WTP: 600000,1,0.096153846,515,600000,1,0.2,400,75,-1328426135,1868498144,11020.78071,777387099.5,77738709.95,4,83064,3574,738,1831,1093,738,83064,1093,1831,154.2624113,2.468085106,6.308510638,43508.91489,1229.22695,8.946808511,98828.9078,0.437946382,0.012357932,9.15984E-05,0.596941562,0.022043244,41,8
D:1| T0: 0.10| T1: 515.00| I0: 400.0| I1: 75.0| WTP: 600000,1,0.096153846,515,600000,1,0.2,400,75,-2855609278,2101566889,7001.186154,2505549971,250554997.1,14,53562,2364,1157,1163,6,1157,53562,6,1163,23.62540717,0.779315961,0.784201954,59365.69951,248.4796417,1.73534202,99125.16205,0.598387687,0.002499824,1.89872E-05,0.005159071,0.02171356,176,28
D:1| T0: 0.10| T1: 515.00| I0: 400.0| I1: 75.0| WTP: 600000,1,0.096153846,515,600000,1,0.2,400,75,-1413178542,1665097450,12448.42765,790757159.4,79075715.94,4,95364,4084,709,2068,1359,709,95364,1359,2068,231.5315315,3.157657658,9.216216216,29969.05405,1471.099099,12.40540541,98565.62162,0.301893621,0.01479362,0.000125802,0.657156673,0.021685332,32,8
D:1| T0: 0.10| T1: 515.00| I0: 400.0| I1: 75.0| WTP: 600000,1,0.096153846,515,600000,1,0.2,400,75,-1337506518,1716179948,10775.50476,798731279.7,79873127.97,4,97436,4498,713,1789,1076,713,97436,1076,1789,304.7365591,3.747311828,9.478494624,36982.23118,1808.892473,13.31182796,98946.6129,0.371245615,0.018147954,0.000134933,0.601453326,0.01836077,27,8
D:1| T0: 0.10| T1: 515.00| I0: 400.0| I1: 75.0| WTP: 600000,1,0.096153846,515,600000,1,0.2,400,75,-2555717883,1560278715,8045.729016,2153431432,215343143.2,12,53750,2141,1326,1337,11,1326,53750,11,1337,29.77849462,1.209677419,1.223655914,66074.01075,196.716129,2.65483871,99168.96237,0.665656908,0.00198085,2.87961E-05,0.008227375,0.024874881,132,24
D:1| T0: 0.10| T1: 515.00| I0: 400.0| I1: 75.0| WTP: 600000,1,0.096153846,515,600000,1,0.2,400,75,-1400544680,991019385,12343.8999,783349685.4,78334968.54,4,90105,3827,713,2051,1338,713,90105,1338,2051,176.2255639,2.560150376,7.567669173,38985.35338,2004.496241,10.26691729,98708.37218,0.392013411,0.020164468,0.000104562,0.6523647,0.022762333,38,8
D:1| T0: 0.10| T1: 515.00| I0: 400.0| I1: 75.0| WTP: 600000,1,0.096153846,515,600000,1,0.2,400,75,-1350120201,118052103,11293.66053,785437174.6,78543717.46,4,87357,3891,765,1876,1111,765,87357,1111,1876,180.4701493,2.720149254,6.824626866,45449.93657,1649.537313,9.701492537,98919.63433,0.456590564,0.016581293,9.90906E-05,0.592217484,0.021475096,39,8
D:1| T0: 0.10| T1: 515.00| I0: 400.0| I1: 75.0| WTP: 600000,1,0.096153846,515,600000,1,0.2,400,75,-1405055439,1209758844,12434.00238,783355320.1,78335532.01,4,89402,3728,691,2066,1375,691,89402,1375,2066,240.5179487,3.441025641,10.44102564,45146.83077,1345.369231,13.96410256,98835.05128,0.45362038,0.013515966,0.000142049,0.66553727,0.023109103,28,8
D:1| T0: 0.10| T1: 515.00| I0: 400.0| I1: 75.0| WTP: 600000,1,0.096153846,515,600000,1,0.2,400,75,-4979158049,70671723,7367.943991,4610760849,461076084.9,26,56072,2392,1224,1224,0,1224,56072,0,1224,16.13108614,0.475655431,0.475655431,64640.25361,184.8020332,1.131621188,99241.31086,0.650791734,0.001860823,1.31715E-05,0,0.021829077,267,52
D:1| T0: 0.10| T1: 515.00| I0: 400.0| I1: 75.0| WTP: 600000,1,0.096153846,515,600000,1,0.2,400,75,-2841836380,1722612191,6659.903054,2508841227,250884122.7,14,55199,2488,1106,1106,0,1106,55199,0,1106,26.96721311,0.754961173,0.754961173,65582.39431,262.9974116,1.716134599,99329.13891,0.659608161,0.002644378,1.91747E-05,0,0.020036595,165,28
D:1| T0: 0.10| T1: 515.00| I0: 400.0| I1: 75.0| WTP: 600000,1,0.096153846,515,600000,1,0.2,400,75,-2811973997,1968291596,6088.944564,2507526769,250752676.9,14,53337,2427,1011,1011,0,1011,53337,0,1011,29.22116301,0.7607245,0.7607245,68510.72259,204.013346,1.721639657,99412.93136,0.688602737,0.002051086,1.93548E-05,0,0.018955302,150,28
D:1| T0: 0.10| T1: 515.00| I0: 400.0| I1: 75.0| WTP: 600000,1,0.096153846,515,600000,1,0.2,400,75,-1449474365,1877569084,13169.17406,791015662.1,79101566.21,4,96488,4069,745,2188,1443,745,96488,1443,2188,266.1295337,3.813471503,11.21243523,35133.56995,1600.093264,15.05181347,98644.61658,0.353250926,0.016087307,0.00015278,0.659506399,0.022676395,28,8
D:1| T0: 0.10| T1: 515.00| I0: 400.0| I1: 75.0| WTP: 600000,1,0.096153846,515,600000,1,0.2,400,75,-1400909269,1726322189,12190.40189,791389174.1,79138917.41,4,95421,4151,742,2025,1283,742,95421,1283,2025,268.4352332,3.777202073,10.33678756,36894.84456,1673.772021,14.19170984,98778.33161,0.370759373,0.0168105,0.000144015,0.633580247,0.021221744,28,8
D:1| T0: 0.10| T1: 515.00| I0: 400.0| I1: 75.0| WTP: 600000,1,0.096153846,515,600000,1,0.2,400,75,-1390977632,307848836,12063.07059,787824102.3,78782410.23,4,91431,4027,613,2004,1391,613,91431,1391,2004,231.5627907,2.772093023,9.195348837,41100.16744,1495.390698,12.03255814,98811.69767,0.412902006,0.015021828,0.000122332,0.694111776,0.021918168,31,8
D:1| T0: 0.10| T1: 515.00| I0: 400.0| I1: 75.0| WTP: 600000,1,0.096153846,515,600000,1,0.2,400,75,-1341668484,1154000220,11019.14034,790711467.3,79071146.73,4,90887,4116,741,1830,1089,741,90887,1089,1830,279.227027,3.940540541,9.762162162,33141.29189,1277.481081,13.76756757,98752.11351,0.33430677,0.012817088,0.000139538,0.595081967,0.020134893,27,8
D:1| T0: 0.10| T1: 515.00| I0: 400.0| I1: 75.0| WTP: 600000,1,0.096153846,515,600000,1,0.2,400,75,-4211695832,2028661055,6223.920269,3900499819,390049981.9,22,47448,2091,1034,1034,0,1034,47448,0,1034,16.15220207,0.477979275,0.477979275,68477.55829,160.6722798,1.155440415,99320.68653,0.68904253,0.001616473,1.34546E-05,0,0.021792737,221,44
D:1| T0: 0.10| T1: 515.00| I0: 400.0| I1: 75.0| WTP: 600000,1,0.096153846,515,600000,1,0.2,400,75,-1969113409,1629114640,9866.976405,1475764588,147576458.8,8,77650,3408,1069,1639,570,1069,77650,570,1639,116.0362117,2.857938719,4.398328691,48852.92201,1342.593315,7.381615599,98990.05014,0.491602052,0.013496319,7.58473E-05,0.347773032,0.021107534,52,16
D:1| T0: 0.10| T1: 515.00| I0: 400.0| I1: 75.0| WTP: 600000,1,0.096153846,515,600000,1,0.2,400,75,-1448079271,1439048174,13026.9009,796734226.2,79673422.62,4,96599,4308,746,2164,1418,746,96599,1418,2164,300.1748634,4,11.66666667,38851.43169,2247.836066,15.75956284,98756.08743,0.390137629,0.022590817,0.000159786,0.655268022,0.022401888,27,8
D:1| T0: 0.10| T1: 515.00| I0: 400.0| I1: 75.0| WTP: 600000,1,0.096153846,515,600000,1,0.2,400,75,-1292416835,865227006,11976.89732,693571969.4,69357196.94,4,88440,3679,705,1990,1285,705,88440,1285,1990,275.0722892,4.120481928,11.79518072,34329.10843,1429.783133,16.08433735,98636.85542,0.346731923,0.014345885,0.000163076,0.645728643,0.02250164,24,7
D:1| T0: 0.10| T1: 515.00| I0: 400.0| I1: 75.0| WTP: 600000,1,0.096153846,515,600000,1,0.2,400,75,-1621086639,890479738,11355.36228,1053318525,105331852.5,6,90197,3992,809,1886,1077,809,90197,1077,1886,218.5914894,3.310638298,7.846808511,44940.32766,2739.4,11.3106383,98964.15745,0.45120578,0.027521137,0.000115252,0.571049841,0.020909786,34,11
D:1| T0: 0.10| T1: 515.00| I0: 400.0| I1: 75.0| WTP: 600000,1,0.096153846,515,600000,1,0.2,400,75,-3311631874,1017049163,7260.93367,2948585191,294858519.1,18,59856,2627,1205,1206,1,1205,59856,1,1206,27.38250429,0.819897084,0.820754717,61734.3705,182.593482,1.849914237,99248.64065,0.621434263,0.001837568,2.07849E-05,0.000829876,0.020132322,167,33
D:1| T0: 0.10| T1: 515.00| I0: 400.0| I1: 75.0| WTP: 600000,1,0.096153846,515,600000,1,0.2,400,75,-3525124691,1707305064,6340.919541,3208078714,320807871.4,18,53097,2413,1053,1053,0,1053,53097,0,1053,21.83549784,0.564935065,0.564935065,65713.18615,200.7330447,1.336219336,99323.15152,0.661102099,0.002019018,1.52641E-05,0,0.019831629,198,36
D:1| T0: 0.10| T1: 515.00| I0: 400.0| I1: 75.0| WTP: 600000,1,0.096153846,515,600000,1,0.2,400,75,-1286251020,400145663,11803.58029,696072005.8,69607200.58,4,86942,3738,730,1961,1231,730,86942,1231,1961,245.9270833,3.723958333,10.078125,32762.4375,1214.723958,13.875,98577.98958,0.331264071,0.012196606,0.000140896,0.627740948,0.022555267,28,7
D:1| T0: 0.10| T1: 515.00| I0: 400.0| I1: 75.0| WTP: 600000,1,0.096153846,515,600000,1,0.2,400,75,-3242846837,1662654181,7615.676358,2862063019,286206301.9,18,58573,2619,1245,1265,20,1245,58573,20,1265,24.10178306,0.765973254,0.778603269,56576.27117,179.1270431,1.707280832,99076.31352,0.570450586,0.001803553,1.87527E-05,0.015810277,0.021596982,193,32
D:1| T0: 0.10| T1: 515.00| I0: 400.0| I1: 75.0| WTP: 600000,1,0.096153846,515,600000,1,0.2,400,75,-1362182916,182136456,11380.26596,793169618,79316961.8,4,95282,4251,770,1890,1120,770,95282,1120,1890,282.1489362,4.037234043,9.909574468,37686.44149,1749.590426,14,98864.92021,0.378761919,0.017562797,0.000142007,0.592592593,0.019835856,27,8
D:1| T0: 0.10| T1: 515.00| I0: 400.0| I1: 75.0| WTP: 600000,1,0.096153846,515,600000,1,0.2,400,75,-3854660163,979575387,6032.753309,3553022497,355302249.7,20,50872,2299,1002,1002,0,1002,50872,0,1002,18.0983165,0.488215488,0.488215488,67681.95084,230.7367003,1.167003367,99367.69832,0.68064368,0.00232005,1.35537E-05,0,0.019696493,213,40
D:1| T0: 0.10| T1: 515.00| I0: 400.0| I1: 75.0| WTP: 600000,1,0.096153846,515,600000,1,0.2,400,75,-1414555815,2142525414,12519.76766,788567431.6,78856743.16,4,93670,3990,711,2080,1369,711,93670,1369,2080,256.7384615,3.523076923,10.48717949,45475.51282,1895.589744,14.17435897,98908.51282,0.456217912,0.019047371,0.000143821,0.658173077,0.022205615,28,8
D:1| T0: 0.10| T1: 515.00| I0: 400.0| I1: 75.0| WTP: 600000,1,0.096153846,515,600000,1,0.2,400,75,-1308353211,1464057597,10553.45839,780680291.3,78068029.13,4,83440,3665,765,1753,988,765,83440,988,1753,168.3247232,2.6900369,6.287822878,47638.99262,1154.653137,9.103321033,98981.90406,0.478795989,0.011598857,9.33721E-05,0.563605248,0.021010116,39,8
D:1| T0: 0.10| T1: 515.00| I0: 400.0| I1: 75.0| WTP: 600000,1,0.096153846,515,600000,1,0.2,400,75,-1363136256,364562610,11575.53304,784359603.8,78435960.38,4,90373,3854,667,1923,1256,667,90373,1256,1923,239.7939698,3.246231156,9.497487437,43443.79899,1533.854271,12.86432161,98892.47739,0.436426742,0.015401995,0.000130688,0.653146126,0.021278479,29,8
D:1| T0: 0.10| T1: 515.00| I0: 400.0| I1: 75.0| WTP: 600000,1,0.096153846,515,600000,1,0.2,400,75,-1378858728,40350784,11893.77738,784169859.3,78416985.93,4,90261,3748,686,1976,1290,686,90261,1290,1976,227.5502392,3.148325359,9.267942584,45322.52632,1657.406699,12.54545455,98905.97608,0.455083565,0.016649277,0.000127961,0.652834008,0.021892069,30,8
D:1| T0: 0.10| T1: 515.00| I0: 400.0| I1: 75.0| WTP: 600000,1,0.096153846,515,600000,1,0.2,400,75,-1273483426,804064356,9720.873859,787439732.7,78743973.27,4,86882,4047,690,1614,924,690,86882,924,1614,242.6941748,3.247572816,7.669902913,46469.7767,1217.18932,11.01941748,99087.15534,0.466785178,0.012203156,0.000112138,0.572490706,0.018577134,30,8
D:1| T0: 0.10| T1: 515.00| I0: 400.0| I1: 75.0| WTP: 600000,1,0.096153846,515,600000,1,0.2,400,75,-2319925722,2125493986,8432.611715,1898295136,189829513.6,12,62046,2602,1204,1401,197,1204,62046,197,1401,50.528125,1.7,2,56292.82188,306.8828125,3.86875,99029.09687,0.567669122,0.00308812,4.09292E-05,0.140613847,0.022580021,92,21
D:1| T0: 0.10| T1: 515.00| I0: 400.0| I1: 75.0| WTP: 600000,1,0.096153846,515,600000,1,0.2,400,75,-1238899457,23154253,9166.195974,780589658.5,78058965.85,4,78757,3560,713,1522,809,713,78757,809,1522,180.2627451,2.670588235,5.815686275,47154.9451,824.9607843,8.62745098,99039.89804,0.474417196,0.0082769,8.79372E-05,0.531537451,0.019325266,37,8
D:1| T0: 0.10| T1: 515.00| I0: 400.0| I1: 75.0| WTP: 600000,1,0.096153846,515,600000,1,0.2,400,75,-2511880828,1391367689,7139.311997,2154915228,215491522.8,12,53490,2342,1186,1186,0,1186,53490,0,1186,28.15077821,0.956225681,0.956225681,64184.97568,175.2879377,2.110894942,99229.57782,0.646290944,0.00176379,2.31887E-05,0,0.022172369,147,24
D:1| T0: 0.10| T1: 515.00| I0: 400.0| I1: 75.0| WTP: 600000,1,0.096153846,515,600000,1,0.2,400,75,-1552896132,574142276,8711.360882,1117328088,111732808.8,6,68260,3027,1028,1447,419,1028,68260,419,1447,58.45525903,1.489795918,2.128728414,45664.82418,492.7974882,3.739403454,98876.81319,0.460916927,0.004956339,3.90818E-05,0.289564616,0.021198359,91,12
D:1| T0: 0.10| T1: 515.00| I0: 400.0| I1: 75.0| WTP: 600000,1,0.096153846,515,600000,1,0.2,400,75,-4236571669,898736779,6610.068845,3906068227,390606822.7,22,51970,2330,1098,1098,0,1098,51970,0,1098,16.28859447,0.44297235,0.44297235,67029.11406,220.3317972,1.081797235,99309.51613,0.674426379,0.002216861,1.27122E-05,0,0.021127574,248,44
D:1| T0: 0.10| T1: 515.00| I0: 400.0| I1: 75.0| WTP: 600000,1,0.096153846,515,600000,1,0.2,400,75,-1592145177,346473503,9107.904737,1136749940,113674994,6,83659,3995,705,1512,807,705,83659,807,1512,187.6121673,2.558935361,5.593155894,47566.31939,1805.48289,8.281368821,99124.53992,0.477771188,0.018116781,8.4613E-05,0.533730159,0.018073369,38,12
D:1| T0: 0.10| T1: 515.00| I0: 400.0| I1: 75.0| WTP: 600000,1,0.096153846,515,600000,1,0.2,400,75,-1614837646,445552282,9771.244653,1126275413,112627541.3,6,74932,3334,1023,1623,600,1023,74932,600,1623,92.79039301,2.100436681,3.390829694,44598.56332,935.5764192,5.626637555,98843.41703,0.449686464,0.009411044,5.81305E-05,0.369685767,0.021659638,65,12
D:1| T0: 0.10| T1: 515.00| I0: 400.0| I1: 75.0| WTP: 600000,1,0.096153846,515,600000,1,0.2,400,75,-1357914148,911758476,11272.52828,794287734,79428773.4,4,92384,4221,734,1872,1138,734,92384,1138,1872,299.1277778,3.994444444,10.21111111,32892.38889,1436.666667,14.30555556,98743.08889,0.331642215,0.014415871,0.000145371,0.607905983,0.020263249,26,8
D:1| T0: 0.10| T1: 515.00| I0: 400.0| I1: 75.0| WTP: 600000,1,0.096153846,515,600000,1,0.2,400,75,-1381815226,1464197940,11687.88935,797420758.4,79742075.84,4,96108,4386,679,1941,1262,679,96108,1262,1941,277.2636816,3.278606965,9.527363184,38605.37313,2774.383085,12.90547264,98875.17413,0.387457565,0.027857109,0.000130907,0.650180319,0.020196029,29,8
D:1| T0: 0.10| T1: 515.00| I0: 400.0| I1: 75.0| WTP: 600000,1,0.096153846,515,600000,1,0.2,400,75,-2234895450,500405854,8492.519185,1810269491,181026949.1,10,63343,2660,1277,1411,134,1277,63343,134,1411,29.91511194,1.043843284,1.164179104,48843.12034,240.1110075,2.353544776,98876.2444,0.493418878,0.002418199,2.52306E-05,0.094968108,0.022275547,154,20
D:1| T0: 0.10| T1: 515.00| I0: 400.0| I1: 75.0| WTP: 600000,1,0.096153846,515,600000,1,0.2,400,75,-1367557469,772037341,11777.84409,778665265.1,77866526.51,4,84909,3608,627,1957,1330,627,84909,1330,1957,214.6699029,2.917475728,9.32038835,47682.80583,1350.533981,12.36893204,98881.03398,0.47935571,0.013564432,0.000125993,0.67961165,0.023048205,30,8
D:1| T0: 0.10| T1: 515.00| I0: 400.0| I1: 75.0| WTP: 600000,1,0.096153846,515,600000,1,0.2,400,75,-3497634449,1543158763,5971.62215,3199053341,319905334.1,18,47789,2059,992,992,0,992,47789,0,992,16.89938817,0.487423521,0.487423521,71478.88171,157.7940177,1.174711081,99404.87627,0.718633337,0.001587365,1.35453E-05,0,0.020757915,211,36
D:1| T0: 0.10| T1: 515.00| I0: 400.0| I1: 75.0| WTP: 600000,1,0.096153846,515,600000,1,0.2,400,75,-1456046314,1604932531,13319.00724,790095952.1,79009595.21,4,94892,4067,764,2213,1449,764,94892,1449,2213,253.65,3.76,10.935,33670.975,1394.895,14.74,98553.945,0.33912986,0.014029531,0.000149718,0.654767284,0.023321249,29,8
D:1| T0: 0.10| T1: 515.00| I0: 400.0| I1: 75.0| WTP: 600000,1,0.096153846,515,600000,1,0.2,400,75,-1368832810,539051477,11601.00889,788782365.3,78878236.53,4,91936,4058,718,1927,1209,718,91936,1209,1927,224.8883929,3.107142857,8.446428571,42742.0625,2343.183036,11.64285714,98910.42857,0.429129865,0.02354521,0.000118658,0.627400104,0.020960233,32,8
D:1| T0: 0.10| T1: 515.00| I0: 400.0| I1: 75.0| WTP: 600000,1,0.096153846,515,600000,1,0.2,400,75,-3163061022,1743124675,6207.285195,2852696763,285269676.3,18,49848,2164,1031,1031,0,1031,49848,0,1031,18.17842876,0.533288948,0.533288948,65895.17244,112.5426099,1.225699068,99304.6225,0.66305441,0.001132996,1.37901E-05,0,0.020683291,215,32
D:1| T0: 0.10| T1: 515.00| I0: 400.0| I1: 75.0| WTP: 600000,1,0.096153846,515,600000,1,0.2,400,75,-1924639129,1965983789,9149.584792,1467159889,146715988.9,8,67612,2919,1130,1520,390,1130,67612,390,1520,86.10849057,2.54245283,3.429245283,55063.81132,931.7382075,6.099056604,99037.48349,0.554457073,0.009367031,6.28291E-05,0.256578947,0.022481216,61,16
D:1| T0: 0.10| T1: 515.00| I0: 400.0| I1: 75.0| WTP: 600000,1,0.096153846,515,600000,1,0.2,400,75,-2926753490,516774280,8217.668543,2515870063,251587006.3,14,65230,2826,1341,1365,24,1341,65230,24,1365,27.67591125,0.881933439,0.898573693,52003.90412,332.699683,1.961965135,99012.60222,0.524494418,0.003349407,2.15725E-05,0.017582418,0.020926275,180,28
D:1| T0: 0.10| T1: 515.00| I0: 400.0| I1: 75.0| WTP: 600000,1,0.096153846,515,600000,1,0.2,400,75,-998389498.6,86603142,11251.91933,435793532.2,43579353.22,2,88466,3815,624,1869,1245,624,88466,1245,1869,285.6569767,3.534883721,10.72674419,32496.5407,1333.540698,14.31976744,98668.77907,0.32826279,0.013375069,0.000145509,0.666131621,0.021126999,25,4
D:1| T0: 0.10| T1: 515.00| I0: 400.0| I1: 75.0| WTP: 600000,1,0.096153846,515,600000,1,0.2,400,75,-5334174769,1431870609,7369.308233,4965709358,496570935.8,28,59813,2651,1224,1224,0,1224,59813,0,1224,15.96067961,0.41407767,0.41407767,61266.54175,200.4174757,1.001941748,99224.81311,0.616842952,0.00201782,1.19508E-05,0,0.020463779,295,56
D:1| T0: 0.10| T1: 515.00| I0: 400.0| I1: 75.0| WTP: 600000,1,0.096153846,515,600000,1,0.2,400,75,-1241929708,1592383984,9320.840289,775887694,77588769.4,4,75834,3394,816,1548,732,816,75834,732,1548,142.5348837,2.594684385,5.003322259,48621.0897,734.4053156,7.707641196,99004.48837,0.489411742,0.007375628,7.88586E-05,0.472868217,0.020413007,43,8
D:1| T0: 0.10| T1: 515.00| I0: 400.0| I1: 75.0| WTP: 600000,1,0.096153846,515,600000,1,0.2,400,75,-1525685022,1440183867,8176.73623,1116848210,111684821,6,67584,3004,1053,1358,305,1053,67584,305,1358,56.20637329,1.474962064,1.918057663,46558.82246,494.0622155,3.509863429,98949.02124,0.46969305,0.004968516,3.67834E-05,0.224594993,0.020093513,95,12
D:1| T0: 0.10| T1: 515.00| I0: 400.0| I1: 75.0| WTP: 600000,1,0.096153846,515,600000,1,0.2,400,75,-1564916020,1696510588,8987.047175,1115563661,111556366.1,6,68836,2924,1114,1493,379,1114,68836,379,1493,50.93220339,1.415254237,1.940677966,46325.5113,456.1483051,3.514124294,98855.14831,0.467626388,0.004591065,3.70537E-05,0.253851306,0.021689232,102,12
D:1| T0: 0.10| T1: 515.00| I0: 400.0| I1: 75.0| WTP: 600000,1,0.096153846,515,600000,1,0.2,400,75,-1377059077,895039877,11834.12517,785352818.9,78535281.89,4,89167,3768,700,1966,1266,700,89167,1266,1966,198.7037037,2.781893004,7.95473251,40717.83128,1933.230453,10.81893004,98795.68313,0.409387433,0.019434156,0.000110336,0.643947101,0.022048516,35,8
D:1| T0: 0.10| T1: 515.00| I0: 400.0| I1: 75.0| WTP: 600000,1,0.096153846,515,600000,1,0.2,400,75,-1934228476,129565953,9329.962588,1467730347,146773034.7,8,68647,2898,1264,1550,286,1264,68647,286,1550,49.80487805,1.592140921,1.963414634,45897.94715,657.098916,3.66395664,98807.27507,0.463438098,0.006615092,3.83759E-05,0.184516129,0.022579282,105,16
D:1| T0: 0.10| T1: 515.00| I0: 400.0| I1: 75.0| WTP: 600000,1,0.096153846,515,600000,1,0.2,400,75,-2086926358,1902565669,7214.472969,1726202709,172620270.9,10,62641,2772,1076,1198,122,1076,62641,122,1198,31.41967509,0.835740072,0.940433213,49326.0009,217.8916968,1.896209386,99042.44314,0.497499343,0.002192382,2.06283E-05,0.101836394,0.019124854,159,19
D:1| T0: 0.10| T1: 515.00| I0: 400.0| I1: 75.0| WTP: 600000,1,0.096153846,515,600000,1,0.2,400,75,-4676099784,1984179288,8222.294392,4264985064,426498506.4,24,62711,2648,1365,1366,1,1365,62711,1,1366,18.22388889,0.555555556,0.556111111,57770.48111,262.4438889,1.316666667,99089.57167,0.582369487,0.002643475,1.5268E-05,0.000732064,0.021782462,258,48
D:1| T0: 0.10| T1: 515.00| I0: 400.0| I1: 75.0| WTP: 600000,1,0.096153846,515,600000,1,0.2,400,75,-1672883771,677377223,10776.64854,1134051344,113405134.4,6,84378,3760,982,1790,808,982,84378,808,1790,137.5146199,2.754385965,5.076023392,44094.5,2006.149123,7.964912281,98893.07018,0.443490911,0.020177447,8.15647E-05,0.451396648,0.021214061,48,12
D:1| T0: 0.10| T1: 515.00| I0: 400.0| I1: 75.0| WTP: 600000,1,0.096153846,515,600000,1,0.2,400,75,-1636446099,973583301,10114.98174,1130697012,113069701.2,6,83161,3652,1049,1680,631,1049,83161,631,1680,116.6813472,2.593264249,4.191709845,43396.62953,1753.088083,6.904145078,98924.07772,0.436575097,0.017627865,7.11207E-05,0.375595238,0.020201777,56,12
D:1| T0: 0.10| T1: 515.00| I0: 400.0| I1: 75.0| WTP: 600000,1,0.096153846,515,600000,1,0.2,400,75,-1847566363,781062938,7511.568095,1471987958,147198795.8,8,67525,3274,1073,1247,174,1073,67525,174,1247,49.67121588,1.171215881,1.3808933,45767.134,383.955335,2.713399504,99025.75806,0.46158692,0.00385996,2.89304E-05,0.139534884,0.018467234,116,16
D:1| T0: 0.10| T1: 515.00| I0: 400.0| I1: 75.0| WTP: 600000,1,0.096153846,515,600000,1,0.2,400,75,-1955668869,338783425,9537.685585,1478784589,147878458.9,8,78335,3480,1117,1584,467,1117,78335,467,1584,112.8989637,2.764248705,3.917098446,51237.18135,1650.994819,6.821243523,99078.8057,0.515062453,0.016597431,7.03429E-05,0.294823232,0.020220846,56,16
D:1| T0: 0.10| T1: 515.00| I0: 400.0| I1: 75.0| WTP: 600000,1,0.096153846,515,600000,1,0.2,400,75,-5317613207,1027579040,7044.904855,4965367965,496536796.5,28,58196,2632,1170,1170,0,1170,58196,0,1170,15.09258406,0.377245509,0.377245509,58919.19899,201.2178719,0.918470751,99185.19899,0.593511726,0.002025476,1.08368E-05,0,0.020104475,310,56
D:1| T0: 0.10| T1: 515.00| I0: 400.0| I1: 75.0| WTP: 600000,1,0.096153846,515,600000,1,0.2,400,75,-1611760109,764973813,9758.464307,1123836894,112383689.4,6,74930,3230,1102,1621,519,1102,74930,519,1621,88.01290323,2.219354839,3.309677419,46362.68172,1098.643011,5.692473118,98888.8172,0.467207518,0.011051039,5.89207E-05,0.320172733,0.021633525,66,12
D:1| T0: 0.10| T1: 515.00| I0: 400.0| I1: 75.0| WTP: 600000,1,0.096153846,515,600000,1,0.2,400,75,-1636982850,1245753446,10126.8896,1130638370,113063837,6,82957,3589,791,1682,891,791,82957,891,1682,146.1483871,2.432258065,5.270967742,44432.0129,1834.8,7.822580645,98945.21935,0.446895393,0.018438291,8.02072E-05,0.529726516,0.020275809,45,12
D:1| T0: 0.10| T1: 515.00| I0: 400.0| I1: 75.0| WTP: 600000,1,0.096153846,515,600000,1,0.2,400,75,-1558974130,1013177794,8890.602571,1114444001,111444400.1,6,67359,2884,1090,1477,387,1090,67359,387,1477,54.01221374,1.523664122,2.097709924,46385.86107,428.5923664,3.766412214,98854.17252,0.468359867,0.004312399,3.94282E-05,0.262017603,0.021927285,94,12
D:1| T0: 0.10| T1: 515.00| I0: 400.0| I1: 75.0| WTP: 600000,1,0.096153846,515,600000,1,0.2,400,75,-3874137164,1395089249,6499.940972,3549140115,354914011.5,20,47936,2010,1080,1080,0,1080,47936,0,1080,14.18906341,0.450843514,0.450843514,69439.74636,144.7172775,1.072716696,99318.60151,0.698684177,0.001456592,1.26262E-05,0,0.02253004,246,40
D:1| T0: 0.10| T1: 515.00| I0: 400.0| I1: 75.0| WTP: 600000,1,0.096153846,515,600000,1,0.2,400,75,-3860700516,1339545835,6211.941072,3550103462,355010346.2,20,47262,2031,1032,1032,0,1032,47262,0,1032,12.9343253,0.351462288,0.351462288,74458.66444,185.601334,0.871729092,99458.41252,0.748121422,0.001866987,1.06395E-05,0,0.021835724,279,40
D:1| T0: 0.10| T1: 515.00| I0: 400.0| I1: 75.0| WTP: 600000,1,0.096153846,515,600000,1,0.2,400,75,-1332052832,219139554,10832.89656,790408004.2,79040800.42,4,90154,4019,758,1799,1041,758,90154,1041,1799,289.5,4.191011236,9.938202247,41275.98315,1331.713483,14.19101124,98921.76404,0.415222809,0.01335809,0.000144089,0.578654808,0.019954744,26,8
D:1| T0: 0.10| T1: 515.00| I0: 400.0| I1: 75.0| WTP: 600000,1,0.096153846,515,600000,1,0.2,400,75,-2189051598,1336508942,7573.687963,1810367200,181036720,10,59421,2621,1217,1258,41,1217,59421,41,1258,29.89144434,0.946642134,0.983440662,54988.23367,221.8629255,2.109475621,99063.97332,0.554527607,0.002232819,2.28924E-05,0.032591415,0.021170966,156,20
D:1| T0: 0.10| T1: 515.00| I0: 400.0| I1: 75.0| WTP: 600000,1,0.096153846,515,600000,1,0.2,400,75,-4583505956,448559423,6703.442619,4248333825,424833382.5,24,45338,1858,1114,1114,0,1114,45338,0,1114,10.67632184,0.344827586,0.344827586,69649.47862,160.8321839,0.861609195,99249.7108,0.701274793,0.00161938,1.02963E-05,0,0.024571542,311,48
D:1| T0: 0.10| T1: 515.00| I0: 400.0| I1: 75.0| WTP: 600000,1,0.096153846,515,600000,1,0.2,400,75,-1911483973,2110028840,8879.417722,1467513087,146751308.7,8,69517,3061,1230,1475,245,1230,69517,245,1475,51.83779972,1.576868829,1.902679831,47762.10014,479.5430183,3.631875882,98924.52186,0.481801812,0.004825597,3.83819E-05,0.166101695,0.021217832,102,16
D:1| T0: 0.10| T1: 515.00| I0: 400.0| I1: 75.0| WTP: 600000,1,0.096153846,515,600000,1,0.2,400,75,-1967411288,1982030155,9996.479795,1467587298,146758729.8,8,71617,2963,1139,1661,522,1139,71617,522,1661,88.08192771,2.621686747,3.848192771,52236.53012,1148.144578,6.590361446,98944.50602,0.526119546,0.01155041,6.78709E-05,0.314268513,0.023192817,60,16
D:1| T0: 0.10| T1: 515.00| I0: 400.0| I1: 75.0| WTP: 600000,1,0.096153846,515,600000,1,0.2,400,75,-1249698267,696219407,9589.202629,770238135.2,77023813.52,4,72391,3184,769,1593,824,769,72391,824,1593,117.0385757,2.127596439,4.548961424,50996.23442,716.8071217,6.818991098,98970.63205,0.513530369,0.007201362,7.04406E-05,0.517263026,0.022005498,49,8
D:1| T0: 0.10| T1: 515.00| I0: 400.0| I1: 75.0| WTP: 600000,1,0.096153846,515,600000,1,0.2,400,75,-1324873222,1402539442,10665.09851,791618296.9,79161829.69,4,93537,4147,701,1771,1070,701,93537,1070,1771,257.9359606,3.359605911,8.586206897,42599.54187,2112.738916,12.03448276,99011.71921,0.427492934,0.021198924,0.000122191,0.60417843,0.018933684,29,8
D:1| T0: 0.10| T1: 515.00| I0: 400.0| I1: 75.0| WTP: 600000,1,0.096153846,515,600000,1,0.2,400,75,-1385425645,1319833493,11848.62318,792994485.5,79299448.55,4,92959,4187,765,1968,1203,765,92959,1203,1968,220.3666667,3.075,8.033333333,38741.50833,2623.029167,11.21666667,98807.0875,0.389199939,0.026370065,0.000114482,0.611280488,0.021170624,35,8
D:1| T0: 0.10| T1: 515.00| I0: 400.0| I1: 75.0| WTP: 600000,1,0.096153846,515,600000,1,0.2,400,75,-2227169669,663608076,8241.843661,1815077486,181507748.6,10,64885,2867,1225,1369,144,1225,64885,144,1369,32.20073327,0.986251146,1.114573786,47750.84968,359.8386801,2.223648029,98911.94317,0.482114975,0.003622218,2.39186E-05,0.105186267,0.021099192,156,20
D:1| T0: 0.10| T1: 515.00| I0: 400.0| I1: 75.0| WTP: 600000,1,0.096153846,515,600000,1,0.2,400,75,-2171747065,414696500,7225.448381,1810474646,181047464.6,10,58456,2537,1191,1200,9,1191,58456,9,1200,37.55581128,1.18872267,1.20023015,60599.09206,465.127733,2.571921749,99213.35558,0.609952645,0.004675884,2.76479E-05,0.007506255,0.020511154,124,20
D:1| T0: 0.10| T1: 515.00| I0: 400.0| I1: 75.0| WTP: 600000,1,0.096153846,515,600000,1,0.2,400,75,-2887789828,1249738535,7673.362597,2504121698,250412169.8,14,53386,2219,1275,1275,0,1275,53386,0,1275,23.64860288,0.886536833,0.886536833,67219.92464,179.9906859,1.959356478,99229.97121,0.676705903,0.001812268,2.17118E-05,0,0.023882666,169,28
D:1| T0: 0.10| T1: 515.00| I0: 400.0| I1: 75.0| WTP: 600000,1,0.096153846,515,600000,1,0.2,400,75,-2156400917,614415382,6984.128253,1807194505,180719450.5,10,56348,2458,1119,1160,41,1119,56348,41,1160,28.8768797,0.907894737,0.944548872,55847.77068,337.5197368,1.985902256,99109.12594,0.562941387,0.003393661,2.15232E-05,0.035344828,0.020586356,152,20
D:1| T0: 0.10| T1: 515.00| I0: 400.0| I1: 75.0| WTP: 600000,1,0.096153846,515,600000,1,0.2,400,75,-3876773544,524899953,6364.868519,3558530119,355853011.9,20,53757,2495,1057,1057,0,1057,53757,0,1057,22.52989537,0.582212257,0.582212257,68839.64499,233.5949178,1.376681614,99389.21001,0.692089478,0.002349481,1.58717E-05,0,0.019662556,192,40
D:1| T0: 0.10| T1: 515.00| I0: 400.0| I1: 75.0| WTP: 600000,1,0.096153846,515,600000,1,0.2,400,75,-1298416506,1338977757,11848.84101,705974455.5,70597445.55,4,93037,4177,742,1968,1226,742,93037,1226,1968,246.6805556,3.384259259,9,30919.31944,1130.555556,12.43518519,98616.37963,0.311861299,0.011361959,0.000126125,0.62296748,0.021152875,31,7
D:1| T0: 0.10| T1: 515.00| I0: 400.0| I1: 75.0| WTP: 600000,1,0.096153846,515,600000,1,0.2,400,75,-1591392250,341384587,9462.256,1118279450,111827945,6,71935,3085,865,1572,707,865,71935,707,1572,64.07445008,1.304568528,2.485617597,41714.67174,415.0203046,3.947546531,98747.12521,0.421626689,0.004177007,4.15014E-05,0.449745547,0.021853366,85,12
D:1| T0: 0.10| T1: 515.00| I0: 400.0| I1: 75.0| WTP: 600000,1,0.096153846,515,600000,1,0.2,400,75,-1939928387,2032000160,9355.371822,1472159796,147215979.6,8,73150,3178,1100,1554,454,1100,73150,454,1554,92.42757009,2.453271028,3.478971963,48971.89019,1159.079439,6.039719626,98962.89019,0.493264602,0.011655925,6.23514E-05,0.292149292,0.021244019,62,16
D:1| T0: 0.10| T1: 515.00| I0: 400.0| I1: 75.0| WTP: 600000,1,0.096153846,515,600000,1,0.2,400,75,-1413790736,779488939,12489.99598,789290936.8,78929093.68,4,93354,4072,777,2075,1298,777,93354,1298,2075,235.5654206,3.537383178,9.542056075,42853.29439,1650.556075,13.17757009,98841.71028,0.430234072,0.016589327,0.000133965,0.625542169,0.022227221,31,8
D:1| T0: 0.10| T1: 515.00| I0: 400.0| I1: 75.0| WTP: 600000,1,0.096153846,515,600000,1,0.2,400,75,-2239672851,1449019578,8582.725412,1810536580,181053658,10,63836,2605,1323,1426,103,1323,63836,103,1426,31.75616979,1.155972359,1.253701876,51352.14314,391.6949654,2.549851925,98925.12241,0.518271146,0.003943214,2.73052E-05,0.072230014,0.022338492,144,20
D:1| T0: 0.10| T1: 515.00| I0: 400.0| I1: 75.0| WTP: 600000,1,0.096153846,515,600000,1,0.2,400,75,-3416200355,351952211,5938.138644,3119293423,311929342.3,18,51322,2402,986,986,0,986,51322,0,986,19.52952756,0.458005249,0.458005249,68105.06562,149.6003937,1.106299213,99391.69423,0.684731991,0.001504922,1.29951E-05,0,0.019212034,218,35
D:1| T0: 0.10| T1: 515.00| I0: 400.0| I1: 75.0| WTP: 600000,1,0.096153846,515,600000,1,0.2,400,75,-2919863438,486595046,8150.472167,2512339830,251233983,14,62111,2652,1341,1354,13,1341,62111,13,1354,21.69801325,0.739735099,0.748344371,52773.14636,340.3258278,1.634437086,98988.77682,0.532322118,0.00342594,1.79572E-05,0.009601182,0.021799681,214,28
D:1| T0: 0.10| T1: 515.00| I0: 400.0| I1: 75.0| WTP: 600000,1,0.096153846,515,600000,1,0.2,400,75,-1549979558,296745624,8615.829681,1119188074,111918807.4,6,71072,3121,892,1431,539,892,71072,539,1431,58.30408472,1.245083207,2.04387292,40663.177,528.570348,3.379727685,98828.86989,0.410672842,0.00531724,3.53468E-05,0.376659679,0.020134511,95,12
D:1| T0: 0.10| T1: 515.00| I0: 400.0| I1: 75.0| WTP: 600000,1,0.096153846,515,600000,1,0.2,400,75,-3202329036,1671484194,6905.334775,2857062297,285706229.7,16,54999,2445,1146,1147,1,1146,54999,1,1147,21.37122302,0.643884892,0.643884892,60256.21295,202.6618705,1.472661871,99187.88705,0.607038461,0.00203909,1.65794E-05,0.00087184,0.020854925,199,32
D:1| T0: 0.10| T1: 515.00| I0: 400.0| I1: 75.0| WTP: 600000,1,0.096153846,515,600000,1,0.2,400,75,-1400656959,422157396,12131.22765,794095577.1,79409557.71,4,96591,4263,730,2015,1285,730,96591,1285,2015,303.9602273,4.085227273,11.3125,36754.43182,2040.965909,15.46022727,98801.69318,0.369351593,0.02049057,0.000156608,0.637717122,0.020861157,26,8
D:1| T0: 0.10| T1: 515.00| I0: 400.0| I1: 75.0| WTP: 600000,1,0.096153846,515,600000,1,0.2,400,75,-1402373523,1916599091,12202.70418,792238313.8,79223831.38,4,94779,4116,740,2027,1287,740,94779,1287,2027,278.4787234,3.877659574,10.63297872,35077.48936,1759.478723,14.56382979,98720.57979,0.353014342,0.017671537,0.000147862,0.634928466,0.021386594,27,8
D:1| T0: 0.10| T1: 515.00| I0: 400.0| I1: 75.0| WTP: 600000,1,0.096153846,515,600000,1,0.2,400,75,-1394522098,1005953941,12016.98896,793672650.1,79367265.01,4,96439,4253,739,1996,1257,739,96439,1257,1996,300.8587571,4.107344633,11.1299435,35529.49153,2208.711864,15.31638418,98792.36723,0.357169885,0.022171188,0.000155156,0.629759519,0.020697021,26,8
D:1| T0: 0.10| T1: 515.00| I0: 400.0| I1: 75.0| WTP: 600000,1,0.096153846,515,600000,1,0.2,400,75,-1351808627,1422765615,11418.30215,780893519.3,78089351.93,4,84828,3612,733,1897,1164,733,84828,1164,1897,138.1939394,2.115151515,5.615151515,35722.34242,890.2272727,7.851515152,98624.77576,0.360262854,0.008957915,8.01868E-05,0.613600422,0.022362899,48,8
D:1| T0: 0.10| T1: 515.00| I0: 400.0| I1: 75.0| WTP: 600000,1,0.096153846,515,600000,1,0.2,400,75,-3871251259,699740192,6416.290912,3550436713,355043671.3,20,46056,1982,1066,1066,0,1066,46056,0,1066,14.81594373,0.441383353,0.441383353,70899.33236,161.0375147,1.076201641,99334.97831,0.71327803,0.001620552,1.25566E-05,0,0.023145736,244,40
D:1| T0: 0.10| T1: 515.00| I0: 400.0| I1: 75.0| WTP: 600000,1,0.096153846,515,600000,1,0.2,400,75,-4196570220,240885764,5823.103263,3905415057,390541505.7,22,48974,2259,967,967,0,967,48974,0,967,13.01428571,0.291705069,0.291705069,67762.61521,137.5654378,0.737327189,99377.63594,0.681414833,0.001384089,8.95157E-06,0,0.019745171,310,44
D:1| T0: 0.10| T1: 515.00| I0: 400.0| I1: 75.0| WTP: 600000,1,0.096153846,515,600000,1,0.2,400,75,-1581553720,2023806564,9122.285902,1125439425,112543942.5,6,76148,3443,814,1515,701,814,76148,701,1515,91.77223427,1.650759219,3.15835141,39103.4859,691.2494577,4.934924078,98828.77007,0.394598588,0.006949047,5.07944E-05,0.462706271,0.019895989,66,12
D:1| T0: 0.10| T1: 515.00| I0: 400.0| I1: 75.0| WTP: 600000,1,0.096153846,515,600000,1,0.2,400,75,-3213434041,1907493879,7168.928681,2854987607,285498760.7,16,54038,2265,1191,1191,0,1191,54038,0,1191,16.67254556,0.549088771,0.549088771,59484.78189,198.3862434,1.253380364,99115.08524,0.599607392,0.0019969,1.4079E-05,0,0.022040046,242,32
D:1| T0: 0.10| T1: 515.00| I0: 400.0| I1: 75.0| WTP: 600000,1,0.096153846,515,600000,1,0.2,400,75,-2006116322,1565815291,10623.41755,1474945445,147494544.5,8,76751,3304,1108,1765,657,1108,76751,657,1765,121.8869048,3.175595238,5.077380952,53762.17857,1840.910714,8.375,99013.96131,0.540680734,0.018513514,8.60053E-05,0.37223796,0.022996443,48,16
D:1| T0: 0.10| T1: 515.00| I0: 400.0| I1: 75.0| WTP: 600000,1,0.096153846,515,600000,1,0.2,400,75,-3832721813,784442364,5671.158898,3549163868,354916386.8,20,47470,2069,942,942,0,942,47470,0,942,14.62048549,0.389579633,0.389579633,67774.22143,148.2717584,0.942569568,99366.53286,0.681660664,0.001491377,1.12006E-05,0,0.019844112,241,40
D:1| T0: 0.10| T1: 515.00| I0: 400.0| I1: 75.0| WTP: 600000,1,0.096153846,515,600000,1,0.2,400,75,-1328696419,206369745,10808.1209,788290373.8,78829037.38,4,89831,3978,651,1795,1144,651,89831,1144,1795,221.8854626,2.748898678,7.735682819,43566.67401,1652.828194,10.59911894,98966.01322,0.437483646,0.016592473,0.000108216,0.637325905,0.019981966,33,8
D:1| T0: 0.10| T1: 515.00| I0: 400.0| I1: 75.0| WTP: 600000,1,0.096153846,515,600000,1,0.2,400,75,-1399854953,2087235992,12154.60119,792124894.1,79212489.41,4,96085,4163,716,2019,1303,716,96085,1303,2019,244.4439252,3.271028037,9.299065421,35212.33178,1958.341121,12.64485981,98751.13084,0.353717758,0.019681409,0.000128441,0.645368995,0.021012645,31,8
D:1| T0: 0.10| T1: 515.00| I0: 400.0| I1: 75.0| WTP: 600000,1,0.096153846,515,600000,1,0.2,400,75,-1874302414,1019092536,8235.211007,1462541864,146254186.4,8,65273,2730,1150,1368,218,1150,65273,218,1368,37.9877095,1.147486034,1.381005587,46684.53073,401.9776536,2.654748603,98910.53184,0.471292259,0.004043971,2.82988E-05,0.159356725,0.020958451,128,16
D:1| T0: 0.10| T1: 515.00| I0: 400.0| I1: 75.0| WTP: 600000,1,0.096153846,515,600000,1,0.2,400,75,-1516146340,1885906113,8126.405233,1109826079,110982607.9,6,62004,2636,1026,1350,324,1026,62004,324,1350,66.26868687,1.884848485,2.525252525,53878.5596,383.0848485,4.612121212,99027.85657,0.543218206,0.00385044,4.82333E-05,0.24,0.021774545,71,12
D:1| T0: 0.10| T1: 515.00| I0: 400.0| I1: 75.0| WTP: 600000,1,0.096153846,515,600000,1,0.2,400,75,-3182787319,2028637200,8044.08364,2780583137,278058313.7,16,64506,2935,1319,1336,17,1319,64506,17,1336,33.15087397,1.015639374,1.031278749,57230.63477,230.7276909,2.241950322,99117.24195,0.5767567,0.00232321,2.45668E-05,0.012724551,0.020711252,156,31
D:1| T0: 0.10| T1: 515.00| I0: 400.0| I1: 75.0| WTP: 600000,1,0.096153846,515,600000,1,0.2,400,75,-1364907365,181476086,11452.03695,792305517.9,79230551.79,4,93283,4189,738,1902,1164,738,93283,1164,1902,253.8792271,3.487922705,9.038647343,41593.16425,2103.729469,12.61352657,98916.02899,0.417604489,0.021124338,0.000128072,0.611987382,0.020389567,30,8
D:1| T0: 0.10| T1: 515.00| I0: 400.0| I1: 75.0| WTP: 600000,1,0.096153846,515,600000,1,0.2,400,75,-1373254053,2097578470,11685.14698,788996704.4,78899670.44,4,89677,4071,709,1941,1232,709,89677,1232,1941,204.465587,2.761133603,7.71659919,39028.49798,1979.57085,10.57894737,98772.87449,0.392509754,0.019896899,0.00010786,0.634724369,0.021644346,36,8
D:1| T0: 0.10| T1: 515.00| I0: 400.0| I1: 75.0| WTP: 600000,1,0.096153846,515,600000,1,0.2,400,75,-1912530852,119646392,8909.355244,1467063090,146706309,8,66475,2877,1148,1480,332,1148,66475,332,1480,80.0372807,2.401315789,3.10745614,54870.66009,920.9802632,5.61622807,99036.08114,0.55261572,0.009258779,5.79312E-05,0.224324324,0.022264009,66,16
D:1| T0: 0.10| T1: 515.00| I0: 400.0| I1: 75.0| WTP: 600000,1,0.096153846,515,600000,1,0.2,400,75,-1370247682,1298895859,11601.48818,790173272.4,79017327.24,4,93306,4115,776,1927,1151,776,93306,1151,1927,241.3113208,3.566037736,8.938679245,37637.36321,1834.410377,12.61320755,98806.64151,0.378343302,0.018428409,0.000128055,0.597301505,0.020652477,31,8
D:1| T0: 0.10| T1: 515.00| I0: 400.0| I1: 75.0| WTP: 600000,1,0.096153846,515,600000,1,0.2,400,75,-1281086956,1489316290,10024.69192,779852360.3,77985236.03,4,79345,3565,660,1665,1005,660,79345,1005,1665,180.0277778,2.492063492,6.44047619,46518.76587,1094.714286,9.075396825,98935.94841,0.468242795,0.010993592,9.26423E-05,0.603603604,0.020984309,36,8
D:1| T0: 0.10| T1: 515.00| I0: 400.0| I1: 75.0| WTP: 600000,1,0.096153846,515,600000,1,0.2,400,75,-1452302520,855602142,13311.86476,786709281.5,78670928.15,4,96804,3861,655,2212,1557,655,96804,1557,2212,211.2857143,2.761904762,9.454545455,32627.65368,1496.593074,12.29004329,98553.32468,0.327857515,0.015056015,0.000124876,0.703887884,0.022850295,33,8
D:1| T0: 0.10| T1: 515.00| I0: 400.0| I1: 75.0| WTP: 600000,1,0.096153846,515,600000,1,0.2,400,75,-1894139245,1438649896,8507.478514,1468765319,146876531.9,8,68900,3023,1031,1413,382,1031,68900,382,1413,67.20284698,1.722419929,2.393238434,47425.13879,623.475089,4.229537367,98950.07651,0.478202688,0.006269348,4.37207E-05,0.27034678,0.020507983,80,16
D:1| T0: 0.10| T1: 515.00| I0: 400.0| I1: 75.0| WTP: 600000,1,0.096153846,515,600000,1,0.2,400,75,-4963828022,952489126,7209.346261,4603360709,460336070.9,26,53182,2125,1198,1198,0,1198,53182,0,1198,11.60812641,0.374266366,0.374266366,62404.70023,184.1860045,0.908352144,99167.65869,0.628769205,0.001854432,1.08774E-05,0,0.022526419,317,52
D:1| T0: 0.10| T1: 515.00| I0: 400.0| I1: 75.0| WTP: 600000,1,0.096153846,515,600000,1,0.2,400,75,-1139908859,1550779155,10709.2349,604447113.9,60444711.39,4,84344,3554,549,1779,1230,549,84344,1230,1779,228.5606061,2.666666667,8.833333333,31327.41919,1191.515152,11.61616162,98631.5101,0.317057843,0.011953381,0.00011807,0.691399663,0.021092194,29,6
D:1| T0: 0.10| T1: 515.00| I0: 400.0| I1: 75.0| WTP: 600000,1,0.096153846,515,600000,1,0.2,400,75,-4230411825,607323321,6537.226483,3903550501,390355050.1,22,49592,2185,1086,1086,0,1086,49592,0,1086,15.5314319,0.463911525,0.463911525,66425.2532,139.4959255,1.106519208,99260.42258,0.668704763,0.0014045,1.27041E-05,0,0.021900018,246,44
D:1| T0: 0.10| T1: 515.00| I0: 400.0| I1: 75.0| WTP: 600000,1,0.096153846,515,600000,1,0.2,400,75,-1508441244,2103646485,7946.611489,1111110670,111111067,6,62287,2719,864,1320,456,864,62287,456,1320,63.35084428,1.491557223,2.335834897,50390.0863,351.3320826,3.943714822,98970.16135,0.508481349,0.003531716,4.11747E-05,0.345454545,0.021192223,77,12
D:1| T0: 0.10| T1: 515.00| I0: 400.0| I1: 75.0| WTP: 600000,1,0.096153846,515,600000,1,0.2,400,75,-1276594682,258120157,9822.37854,785475755,78547575.5,4,86451,3878,766,1631,865,766,86451,865,1631,245.9393939,3.782828283,8.075757576,35194.74242,1110.146465,11.93939394,98852.54545,0.355139236,0.011134346,0.000121481,0.530349479,0.018866179,29,8
D:1| T0: 0.10| T1: 515.00| I0: 400.0| I1: 75.0| WTP: 600000,1,0.096153846,515,600000,1,0.2,400,75,-2700946440,1068951401,7226.426109,2339625135,233962513.5,14,61557,2796,1165,1200,35,1165,61557,35,1200,27.62370724,0.76531424,0.793158313,52458.07558,190.6658711,1.707239459,99085.61496,0.528904181,0.001918978,1.89132E-05,0.029166667,0.019494444,180,26
D:1| T0: 0.10| T1: 515.00| I0: 400.0| I1: 75.0| WTP: 600000,1,0.096153846,515,600000,1,0.2,400,75,-1881809274,635956235,8361.764757,1463721036,146372103.6,8,64161,2810,1281,1389,108,1281,64161,108,1389,35.946875,1.210416667,1.323958333,49276.47813,507.6072917,2.651041667,98924.76146,0.497201967,0.0051075,2.79771E-05,0.07775378,0.021648665,137,16
D:1| T0: 0.10| T1: 515.00| I0: 400.0| I1: 75.0| WTP: 600000,1,0.096153846,515,600000,1,0.2,400,75,-3514799205,1346693470,6272.595588,3201169426,320116942.6,18,48744,2106,1042,1042,0,1042,48744,0,1042,16.66389776,0.481789137,0.481789137,70367.76933,160.2466454,1.159744409,99377.023,0.707569584,0.001612141,1.33774E-05,0,0.02137699,224,36
D:1| T0: 0.10| T1: 515.00| I0: 400.0| I1: 75.0| WTP: 600000,1,0.096153846,515,600000,1,0.2,400,75,-1436811384,847102011,12905.10747,791556010.2,79155601.02,4,96205,4107,751,2144,1393,751,96205,1393,2144,273.8465608,3.899470899,11.17989418,35680.60317,1746.306878,15.15873016,98687.22751,0.35874908,0.017551088,0.000153949,0.649720149,0.022285744,27,8
D:1| T0: 0.10| T1: 515.00| I0: 400.0| I1: 75.0| WTP: 600000,1,0.096153846,515,600000,1,0.2,400,75,-1714735427,812083272,11705.96907,1129436974,112943697.4,6,83229,3514,929,1945,1016,929,83229,1016,1945,144.9046053,2.927631579,6.226973684,47286.86513,1685.930921,9.289473684,98850.78289,0.475603073,0.016966441,9.51709E-05,0.522365039,0.023369258,44,12
D:1| T0: 0.10| T1: 515.00| I0: 400.0| I1: 75.0| WTP: 600000,1,0.096153846,515,600000,1,0.2,400,75,-1329200586,2146825809,10784.68261,789966455.8,78996645.58,4,92017,4213,791,1791,1000,791,92017,1000,1791,304.4285714,4.642857143,10.5,37555.85714,1728.714286,15.19642857,98890.13095,0.378191999,0.017334485,0.000154162,0.558347292,0.019463795,24,8
D:1| T0: 0.10| T1: 515.00| I0: 400.0| I1: 75.0| WTP: 600000,1,0.096153846,515,600000,1,0.2,400,75,-1422160518,226186520,12664.04666,788958184.6,78895818.46,4,95343,4023,741,2104,1363,741,95343,1363,2104,260.0829016,3.797927461,10.79274611,37185.46114,1436.834197,14.62176166,98720.09845,0.373754352,0.014436702,0.00014812,0.647813688,0.022067692,28,8
D:1| T0: 0.10| T1: 515.00| I0: 400.0| I1: 75.0| WTP: 600000,1,0.096153846,515,600000,1,0.2,400,75,-1671403457,1110225441,10793.9403,1131706442,113170644.2,6,83782,3620,1052,1793,741,1052,83782,741,1793,109.9299517,2.446859903,4.200483092,41402.09903,1563.417874,6.734299517,98811.07971,0.416752734,0.015736354,6.91861E-05,0.413273843,0.021400778,60,12
D:1| T0: 0.10| T1: 515.00| I0: 400.0| I1: 75.0| WTP: 600000,1,0.096153846,515,600000,1,0.2,400,75,-1563806166,1190767082,8714.77514,1128067409,112806740.9,6,77773,3542,777,1447,670,777,77773,670,1447,93.10782241,1.56448203,2.957716702,39348.08879,876.0634249,4.604651163,98908.65962,0.396589721,0.008805308,4.72575E-05,0.463026952,0.018605429,68,12
D:1| T0: 0.10| T1: 515.00| I0: 400.0| I1: 75.0| WTP: 600000,1,0.096153846,515,600000,1,0.2,400,75,-2212943786,2108234095,8077.766464,1809055463,180905546.3,10,60123,2523,1284,1342,58,1284,60123,58,1342,33.97516199,1.205183585,1.264578834,56197.4622,396.7645788,2.660907127,99043.5432,0.566638564,0.003991683,2.85197E-05,0.043219076,0.022320909,133,20
D:1| T0: 0.10| T1: 515.00| I0: 400.0| I1: 75.0| WTP: 600000,1,0.096153846,515,600000,1,0.2,400,75,-1427185703,465621985,12659.72959,794199223.5,79419922.35,4,95321,4277,739,2103,1364,739,95321,1364,2103,254.4666667,3.428571429,9.880952381,29536.09524,1563.871429,13.39047619,98550.21429,0.297670185,0.015724434,0.000136115,0.648597242,0.022062295,30,8
D:1| T0: 0.10| T1: 515.00| I0: 400.0| I1: 75.0| WTP: 600000,1,0.096153846,515,600000,1,0.2,400,75,-2129996772,1487072553,7984.711947,1730761174,173076117.4,10,65172,2996,1221,1326,105,1221,65172,105,1326,43.13093859,1.259559676,1.376593279,52159.87949,271.0301275,2.785631518,99028.28969,0.526018442,0.002728072,2.96775E-05,0.07918552,0.020346161,124,19
D:1| T0: 0.10| T1: 515.00| I0: 400.0| I1: 75.0| WTP: 600000,1,0.096153846,515,600000,1,0.2,400,75,-1585188215,1213733847,9300.804262,1120148002,112014800.2,6,70532,3040,894,1545,651,894,70532,651,1545,119.8707692,2.618461538,4.593846154,51998.73538,921.44,7.335384615,99000.21846,0.523719141,0.009257401,7.54013E-05,0.421359223,0.021904951,47,12
D:1| T0: 0.10| T1: 515.00| I0: 400.0| I1: 75.0| WTP: 600000,1,0.096153846,515,600000,1,0.2,400,75,-1284823097,2003658337,10197.28708,774958743.2,77495874.32,4,78538,3342,749,1694,945,749,78538,945,1694,140.7766667,2.353333333,5.473333333,47004.39,1069.653333,7.96,98919.34667,0.473175567,0.010748333,8.18436E-05,0.55785124,0.021570001,43,8
D:1| T0: 0.10| T1: 515.00| I0: 400.0| I1: 75.0| WTP: 600000,1,0.096153846,515,600000,1,0.2,400,75,-4925625724,1170868072,6428.84406,4604183521,460418352.1,26,51968,2249,1068,1068,0,1068,51968,0,1068,12.63506432,0.333015722,0.333015722,65781.48595,143.5097666,0.850881372,99309.70986,0.661882036,0.001444466,1.0226E-05,0,0.020551108,300,52
D:1| T0: 0.10| T1: 515.00| I0: 400.0| I1: 75.0| WTP: 600000,1,0.096153846,515,600000,1,0.2,400,75,-1335608429,569919592,10946.28814,788294021.8,78829402.18,4,90824,4024,754,1818,1064,754,90824,1064,1818,264.0842105,3.878947368,9.410526316,31576.06316,1246.510526,13.38947368,98725.11053,0.318722427,0.012508754,0.000135951,0.585258526,0.020016736,28,8
D:1| T0: 0.10| T1: 515.00| I0: 400.0| I1: 75.0| WTP: 600000,1,0.096153846,515,600000,1,0.2,400,75,-1536052886,1833180623,8233.200098,1124392881,112439288.1,6,73609,3467,1010,1367,357,1010,73609,357,1367,94.02031603,2.119638826,2.898419865,46665.58916,775.4740406,5.162528217,99053.39278,0.469996077,0.007789716,5.39094E-05,0.261155816,0.018571099,64,12
D:1| T0: 0.10| T1: 515.00| I0: 400.0| I1: 75.0| WTP: 600000,1,0.096153846,515,600000,1,0.2,400,75,-1449906411,1123666637,13169.32017,791440402.2,79144040.22,4,93680,4045,755,2188,1433,755,93680,1433,2188,305.5621302,4.384615385,12.77514793,40612.14201,1667.100592,17.24260355,98739.3432,0.408409567,0.01674863,0.000174963,0.654936015,0.023356106,25,8
D:1| T0: 0.10| T1: 515.00| I0: 400.0| I1: 75.0| WTP: 600000,1,0.096153846,515,600000,1,0.2,400,75,-1704109548,1682024981,11412.92154,1133463471,113346347.1,6,89643,3842,764,1896,1132,764,89643,1132,1896,188.3951613,2.943548387,7.475806452,45053.7621,2954.197581,10.55241935,98945.47581,0.452364142,0.029691437,0.000107839,0.597046414,0.021150564,35,12
D:1| T0: 0.10| T1: 515.00| I0: 400.0| I1: 75.0| WTP: 600000,1,0.096153846,515,600000,1,0.2,400,75,-1614347386,1687523543,9853.780441,1121658364,112165836.4,6,73916,3191,910,1637,727,910,73916,727,1637,121.412844,2.660550459,4.856269113,51852.32722,863.6544343,7.617737003,98992.85015,0.521887287,0.008680329,7.82927E-05,0.44410507,0.02214736,47,12
D:1| T0: 0.10| T1: 515.00| I0: 400.0| I1: 75.0| WTP: 600000,1,0.096153846,515,600000,1,0.2,400,75,-1345635842,178034412,11156.26963,787822360.1,78782236.01,4,88629,4029,653,1853,1200,653,88629,1200,1853,261.5811518,3.287958115,9.523560209,46469.73822,1635.806283,12.93717277,98981.01571,0.466733283,0.016413064,0.000131658,0.647598489,0.020907378,28,8
D:1| T0: 0.10| T1: 515.00| I0: 400.0| I1: 75.0| WTP: 600000,1,0.096153846,515,600000,1,0.2,400,75,-1343632261,739490003,11055.20661,790871930.9,79087193.09,4,91593,4084,689,1836,1147,689,91593,1147,1836,260.4773869,3.376884422,9.085427136,41796.68844,1289.628141,12.54271357,98924.0804,0.419874794,0.012941805,0.00012734,0.624727669,0.0200452,29,8
D:1| T0: 0.10| T1: 515.00| I0: 400.0| I1: 75.0| WTP: 600000,1,0.096153846,515,600000,1,0.2,400,75,-1632749712,178482706,10255.52932,1119973245,111997324.5,6,73756,3058,723,1704,981,723,73756,981,1704,125.6019417,2.223300971,5.365695793,48541.16828,1021.236246,7.699029126,98876.09385,0.489142598,0.010260109,7.89631E-05,0.576042278,0.023089647,45,12
D:1| T0: 0.10| T1: 515.00| I0: 400.0| I1: 75.0| WTP: 600000,1,0.096153846,515,600000,1,0.2,400,75,-1604761086,1919366370,9708.888994,1119316637,111931663.7,6,69705,3015,869,1613,744,869,69705,744,1613,107.1815642,2.312849162,4.37150838,50930.91341,672.2513966,6.787709497,98908.24302,0.513376182,0.006758993,6.96902E-05,0.461252325,0.023140377,52,12
D:1| T0: 0.10| T1: 515.00| I0: 400.0| I1: 75.0| WTP: 600000,1,0.096153846,515,600000,1,0.2,400,75,-1350194507,1819796913,11110.46298,794671358.1,79467135.81,4,96556,4424,693,1845,1152,693,96556,1152,1845,305.4971751,3.858757062,10.31638418,39525.46893,2242.305085,14.22033898,98959.40113,0.396708982,0.022489033,0.000143838,0.624390244,0.019108082,26,8
D:1| T0: 0.10| T1: 515.00| I0: 400.0| I1: 75.0| WTP: 600000,1,0.096153846,515,600000,1,0.2,400,75,-1687407474,1866591913,11129.97502,1130908723,113090872.3,6,83745,3646,1088,1849,761,1088,83745,761,1849,108.7070218,2.520581114,4.319612591,44543.16949,1673.42615,6.96125908,98850.49395,0.448054997,0.016843643,7.16161E-05,0.411573824,0.02207893,59,12
D:1| T0: 0.10| T1: 515.00| I0: 400.0| I1: 75.0| WTP: 600000,1,0.096153846,515,600000,1,0.2,400,75,-1369589293,1219425989,11619.00268,788639159.1,78863915.91,4,90583,4102,788,1930,1142,788,90583,1142,1930,291.6686047,4.488372093,11.04651163,34593.16279,1358.366279,15.62209302,98721.4593,0.349013794,0.013630391,0.000158696,0.591709845,0.021306426,25,8
D:1| T0: 0.10| T1: 515.00| I0: 400.0| I1: 75.0| WTP: 600000,1,0.096153846,515,600000,1,0.2,400,75,-1375186767,502409586,11691.69309,790602112.6,79060211.26,4,94589,4132,740,1942,1202,740,94589,1202,1942,234.9086758,3.292237443,8.716894977,35365.22374,1740.424658,12.12328767,98775.38813,0.355504956,0.017480772,0.000123025,0.618949537,0.020530929,32,8
D:1| T0: 0.10| T1: 515.00| I0: 400.0| I1: 75.0| WTP: 600000,1,0.096153846,515,600000,1,0.2,400,75,-1298231005,1405887957,10390.66199,778697905.8,77869790.58,4,81475,3596,731,1726,995,731,81475,995,1726,190.7467811,3.017167382,7.253218884,47510.91416,1061.261803,10.39484979,98959.02575,0.477923174,0.010656147,0.000105861,0.576477404,0.021184412,34,8
D:1| T0: 0.10| T1: 515.00| I0: 400.0| I1: 75.0| WTP: 600000,1,0.096153846,515,600000,1,0.2,400,75,-1310750888,283033753,10772.86618,772107578.5,77210757.85,4,78441,3243,736,1790,1054,736,78441,1054,1790,159.4703557,2.754940711,6.865612648,46613.99605,821.6679842,9.794466403,98849.01581,0.469582242,0.008255853,0.000100309,0.588826816,0.022819699,37,8
D:1| T0: 0.10| T1: 515.00| I0: 400.0| I1: 75.0| WTP: 600000,1,0.096153846,515,600000,1,0.2,400,75,-1631707308,1083157068,10178.47526,1122783545,112278354.5,6,75552,3236,1104,1691,587,1104,75552,587,1691,82.34836066,2.096311475,3.266393443,42607.33607,785.3504098,5.540983607,98773.31967,0.429969257,0.007901423,5.76564E-05,0.347131875,0.022381936,70,12
D:1| T0: 0.10| T1: 515.00| I0: 400.0| I1: 75.0| WTP: 600000,1,0.096153846,515,600000,1,0.2,400,75,-1575601853,1988704626,9315.465025,1109828602,110982860.2,6,64252,2684,1092,1548,456,1092,64252,456,1548,52.1364366,1.566613162,2.290529695,49615.64045,264.8988764,4.048154093,98808.39647,0.501301032,0.002667251,4.26434E-05,0.294573643,0.024092635,89,12
D:1| T0: 0.10| T1: 515.00| I0: 400.0| I1: 75.0| WTP: 600000,1,0.096153846,515,600000,1,0.2,400,75,-1235553535,884761309,10818.19661,694643704,69464370.4,4,83967,3749,680,1797,1117,680,83967,1117,1797,191.8065844,2.703703704,7.279835391,29886.15226,898.345679,10.08230453,98566.96708,0.302686556,0.009023984,0.000102489,0.621591541,0.02140152,35,7
D:1| T0: 0.10| T1: 515.00| I0: 400.0| I1: 75.0| WTP: 600000,1,0.096153846,515,600000,1,0.2,400,75,-2431016675,533485933,7041.055072,2078963922,207896392.2,12,62958,2859,1155,1169,14,1155,62958,14,1169,43.79854369,1.21723301,1.234223301,59279.22816,207.0206311,2.610436893,99250.66505,0.596649677,0.002082345,2.83348E-05,0.011976048,0.018569114,118,23
D:1| T0: 0.10| T1: 515.00| I0: 400.0| I1: 75.0| WTP: 600000,1,0.096153846,515,600000,1,0.2,400,75,-2061748667,632196071,8463.701177,1638563608,163856360.8,10,64158,2773,1321,1406,85,1321,64158,85,1406,47.46463245,1.632454924,1.74479889,56497.73509,230.0069348,3.585298197,99065.27046,0.569500707,0.002315487,3.80399E-05,0.060455192,0.021914648,103,18
D:1| T0: 0.10| T1: 515.00| I0: 400.0| I1: 75.0| WTP: 600000,1,0.096153846,515,600000,1,0.2,400,75,-1367451527,393400457,11482.34108,793334472.9,79333447.29,4,94442,4189,581,1907,1326,581,94442,1326,1907,266.935,2.815,9.385,40691.735,1473.695,12.275,98891.985,0.408448052,0.014792933,0.000124897,0.695332984,0.020192287,29,8
D:1| T0: 0.10| T1: 515.00| I0: 400.0| I1: 75.0| WTP: 600000,1,0.096153846,515,600000,1,0.2,400,75,-1308958325,398973227,10671.83767,775366441.6,77536644.16,4,79252,3307,687,1773,1086,687,79252,1086,1773,156.6273063,2.420664207,6.383763838,44968.54613,876.2804428,8.915129151,98833.99631,0.453017302,0.00880499,9.123E-05,0.612521151,0.02237224,39,8
D:1| T0: 0.10| T1: 515.00| I0: 400.0| I1: 75.0| WTP: 600000,1,0.096153846,515,600000,1,0.2,400,75,-1632435487,1402256491,10019.10245,1131480364,113148036.4,6,81489,3659,898,1664,766,898,81489,766,1664,145.1238095,2.720634921,5.126984127,46008.50794,1633.187302,7.984126984,98967.87302,0.462769249,0.016412544,8.17556E-05,0.460336538,0.020419934,45,12
D:1| T0: 0.10| T1: 515.00| I0: 400.0| I1: 75.0| WTP: 600000,1,0.096153846,515,600000,1,0.2,400,75,-1417702314,2102527413,12585.78621,788413003.6,78841300.36,4,91625,3900,698,2091,1393,698,91625,1393,2091,198.4365079,2.662698413,8.154761905,39848.72619,2102.353175,10.92063492,98734.33333,0.400390378,0.021147796,0.000111369,0.666188427,0.022821282,36,8
D:1| T0: 0.10| T1: 515.00| I0: 400.0| I1: 75.0| WTP: 600000,1,0.096153846,515,600000,1,0.2,400,75,-1376646080,1748031099,11822.1405,785539054.7,78553905.47,4,91504,3881,672,1964,1292,672,91504,1292,1964,205.0805085,2.737288136,8.177966102,38983.5339,2100.516949,11.00847458,98797.72458,0.39176593,0.021109395,0.000112304,0.657841141,0.021464012,34,8
D:1| T0: 0.10| T1: 515.00| I0: 400.0| I1: 75.0| WTP: 600000,1,0.096153846,515,600000,1,0.2,400,75,-1773041693,1946754629,7917.645678,1377159409,137715940.9,8,62689,2791,1079,1315,236,1079,62689,236,1315,50.22457627,1.357344633,1.676553672,50949.50282,339.2612994,3.216101695,98999.26836,0.513942736,0.003411154,3.39925E-05,0.179467681,0.020976567,102,15
D:1| T0: 0.10| T1: 515.00| I0: 400.0| I1: 75.0| WTP: 600000,1,0.096153846,515,600000,1,0.2,400,75,-1513576986,2097712204,8013.258541,1112914059,111291405.9,6,64921,2912,1013,1331,318,1013,64921,318,1331,62.7920434,1.638336347,2.198915009,51456.95118,366.3562387,4.048824593,99031.05606,0.518807863,0.003683309,4.25992E-05,0.238918107,0.020501841,79,12
D:1| T0: 0.10| T1: 515.00| I0: 400.0| I1: 75.0| WTP: 600000,1,0.096153846,515,600000,1,0.2,400,75,-1885383761,1198827119,8427.924174,1463987552,146398755.2,8,61458,2695,1235,1400,165,1235,61458,165,1400,46.82479784,1.517520216,1.735849057,54867.54582,532.3989218,3.396226415,98998.42453,0.553175636,0.005355092,3.57125E-05,0.117857143,0.022779785,106,16
D:1| T0: 0.10| T1: 515.00| I0: 400.0| I1: 75.0| WTP: 600000,1,0.096153846,515,600000,1,0.2,400,75,-4169410184,109253198,5513.071063,3893756631,389375663.1,22,41628,1723,916,916,0,916,41628,0,916,12.41176471,0.37,0.37,74460.47529,171.8994118,0.905294118,99445.58235,0.748360815,0.001728275,1.08196E-05,0,0.022004949,242,44
D:1| T0: 0.10| T1: 515.00| I0: 400.0| I1: 75.0| WTP: 600000,1,0.096153846,515,600000,1,0.2,400,75,-3003796168,314481292,8072.479876,2600172174,260017217.4,16,61293,2664,1336,1341,5,1336,61293,5,1341,33.2816616,1.149949341,1.154002026,61819.56839,185.3546099,2.499493414,99177.13982,0.622577404,0.001866604,2.72778E-05,0.003728561,0.021878518,141,29
D:1| T0: 0.10| T1: 515.00| I0: 400.0| I1: 100.0| WTP: 700000,1,0.096153846,515,700000,1,0.2,400,100,-3522911051,1178568022,8017.072895,3122057406,312205740.6,18,58963,2503,1332,1332,0,1332,58963,0,1332,24.01811024,0.848818898,0.848818898,62820.9189,237.8905512,1.885826772,99177.67244,0.632708678,0.002395332,2.11002E-05,0,0.022573861,181,35
D:1| T0: 0.10| T1: 515.00| I0: 400.0| I1: 100.0| WTP: 700000,1,0.096153846,515,700000,1,0.2,400,100,-1383520751,2029998696,11830.2407,792008715.4,79200871.54,4,94945,4164,648,1965,1317,648,94945,1317,1965,230.8502203,2.753303965,8.524229075,35657.04846,1414.511013,11.37444934,98757.2467,0.358235323,0.014213002,0.00011567,0.670229008,0.020696193,33,8
D:1| T0: 0.10| T1: 515.00| I0: 400.0| I1: 100.0| WTP: 700000,1,0.096153846,515,700000,1,0.2,400,100,-1413972414,776062361,12590.52504,784446162.6,78444616.26,4,92374,3822,796,2092,1296,796,92374,1296,2092,176.2304833,2.862453532,7.643122677,39223.80669,2136.762082,10.60594796,98727.87361,0.394065151,0.021505698,0.000108069,0.619502868,0.022647065,38,8
D:1| T0: 0.10| T1: 515.00| I0: 400.0| I1: 100.0| WTP: 700000,1,0.096153846,515,700000,1,0.2,400,100,-3615887381,1813046880,8054.207821,3213176990,321317699,18,59021,2632,1332,1338,6,1332,59021,6,1338,23.01688951,0.737508797,0.741027445,59178.40113,263.1013371,1.694581281,99088.18578,0.596549104,0.0026493,1.89027E-05,0.004484305,0.022669897,203,36
D:1| T0: 0.10| T1: 515.00| I0: 400.0| I1: 100.0| WTP: 700000,1,0.096153846,515,700000,1,0.2,400,100,-2105309265,2032407216,7563.107386,1727153896,172715389.6,10,63774,2844,1151,1256,105,1151,63774,105,1256,42.35817308,1.188701923,1.308894231,53134.13822,268.0961538,2.689903846,99098.81611,0.535527463,0.002696444,2.90788E-05,0.083665339,0.019679483,119,19
D:1| T0: 0.10| T1: 515.00| I0: 400.0| I1: 100.0| WTP: 700000,1,0.096153846,515,700000,1,0.2,400,100,-5180425007,1507873352,6367.140665,4862067974,486206797.4,28,47622,1976,1058,1058,0,1058,47622,0,1058,9.666803954,0.279242175,0.279242175,70497.91433,142.0667216,0.717051071,99345.21211,0.709082078,0.001430235,8.7577E-06,0,0.022216623,346,55
D:1| T0: 0.10| T1: 515.00| I0: 400.0| I1: 100.0| WTP: 700000,1,0.096153846,515,700000,1,0.2,400,100,-2758687993,1855899401,6791.365537,2419119716,241911971.6,14,53777,2390,1128,1128,0,1128,53777,0,1128,28.5128694,0.861773117,0.861773117,68517.09724,191.1448999,1.938989514,99347.03241,0.689083645,0.001922981,2.16074E-05,0,0.02097629,150,27
D:1| T0: 0.10| T1: 515.00| I0: 400.0| I1: 100.0| WTP: 700000,1,0.096153846,515,700000,1,0.2,400,100,-1281892609,1819459251,10172.70203,773257507.6,77325750.76,4,76418,3302,742,1690,948,742,76418,948,1690,125.5731707,2.131097561,4.987804878,45077.6372,836.4054878,7.237804878,98842.49695,0.454341786,0.008406084,7.45449E-05,0.560946746,0.022116077,47,8
D:1| T0: 0.10| T1: 515.00| I0: 400.0| I1: 100.0| WTP: 700000,1,0.096153846,515,700000,1,0.2,400,100,-2871517247,909791748,7224.906035,2510271945,251027194.5,18,56279,2539,1200,1200,0,1200,56279,0,1200,29.33363971,0.883272059,0.883272059,68743.23713,167.5652574,2.002757353,99353.63971,0.691203734,0.001686695,2.21714E-05,0,0.021322719,156,28
D:1| T0: 0.10| T1: 515.00| I0: 400.0| I1: 100.0| WTP: 700000,1,0.096153846,515,700000,1,0.2,400,100,-1476838419,1339092841,9063.685199,1023654159,102365415.9,6,65749,2721,812,1506,694,812,65749,694,1506,89.15915119,2.068965517,3.888594164,51412.98674,627.1883289,6.031830239,98925.66048,0.518515701,0.006302596,6.17803E-05,0.460823373,0.02290564,54,11
D:1| T0: 0.10| T1: 515.00| I0: 400.0| I1: 100.0| WTP: 700000,1,0.096153846,515,700000,1,0.2,400,100,-1403507233,1365866345,12208.93929,793060268.4,79306026.84,4,95855,4267,715,2028,1313,715,95855,1313,2028,219.3112033,2.887966805,8.298755187,32980.77593,1247.344398,11.24481328,98667.9917,0.331489792,0.0125414,0.000114431,0.647435897,0.021156956,35,8
D:1| T0: 0.10| T1: 515.00| I0: 400.0| I1: 100.0| WTP: 700000,1,0.096153846,515,700000,1,0.2,400,100,-1572425539,825453433,8912.60515,1126795282,112679528.2,6,75128,3348,899,1480,581,899,75128,581,1480,106.8044554,2.094059406,3.514851485,45192.02475,946.3836634,5.747524752,98971.0198,0.455215944,0.009507945,5.91903E-05,0.392567568,0.019699712,58,12
D:1| T0: 0.10| T1: 515.00| I0: 400.0| I1: 100.0| WTP: 700000,1,0.096153846,515,700000,1,0.2,400,100,-1392680308,939711378,11974.9893,793930842.6,79393084.26,4,96951,4287,640,1989,1349,640,96951,1349,1989,232.7434783,2.726086957,8.539130435,32911.42174,1656.417391,11.30434783,98717.07391,0.330585224,0.016642516,0.000114881,0.678230266,0.020515518,33,8
D:1| T0: 0.10| T1: 515.00| I0: 400.0| I1: 100.0| WTP: 700000,1,0.096153846,515,700000,1,0.2,400,100,-1894952660,638950699,8430.951515,1473405084,147340508.4,8,70609,3151,1087,1400,313,1087,70609,313,1400,69.30204778,1.747440273,2.262798635,45785.31399,760.7542662,4.126279863,98958.57167,0.461567767,0.007648648,4.26643E-05,0.223571429,0.019827501,84,16
D:1| T0: 0.10| T1: 515.00| I0: 400.0| I1: 100.0| WTP: 700000,1,0.096153846,515,700000,1,0.2,400,100,-2044818313,938699148,8056.404785,1641998074,164199807.4,10,65703,2965,1259,1338,79,1259,65703,79,1338,46.52101911,1.405095541,1.496815287,53485.68408,280.8509554,3.100636943,99071.22038,0.53914998,0.002826195,3.32647E-05,0.059043348,0.020364367,113,18
D:1| T0: 0.10| T1: 515.00| I0: 400.0| I1: 100.0| WTP: 700000,1,0.096153846,515,700000,1,0.2,400,100,-3884003155,121790188,6438.102574,3562098026,356209802.6,20,56679,2623,1069,1069,0,1069,56679,0,1069,20.35390428,0.498110831,0.498110831,61657.86713,256.8457179,1.176322418,99283.08186,0.620499608,0.002583134,1.35271E-05,0,0.018860601,226,40
D:1| T0: 0.10| T1: 515.00| I0: 400.0| I1: 100.0| WTP: 700000,1,0.096153846,515,700000,1,0.2,400,100,-1618858892,1331335240,11336.8885,1052014467,105201446.7,6,90734,3926,720,1883,1163,720,90734,1163,1883,202.708,2.764,7.368,40985.628,2391.792,10.244,98879.656,0.41171151,0.024033941,0.000104673,0.617631439,0.02075297,36,11
D:1| T0: 0.10| T1: 515.00| I0: 400.0| I1: 100.0| WTP: 700000,1,0.096153846,515,700000,1,0.2,400,100,-1344883793,470935411,12850.55476,702356055.6,70235605.56,4,93723,3995,728,2135,1407,728,93723,1407,2135,299.1823529,4.194117647,12.37647059,34795.56471,1426.711765,16.67058824,98640.10588,0.350554058,0.014330058,0.000169245,0.659016393,0.022779894,25,7
D:1| T0: 0.10| T1: 515.00| I0: 400.0| I1: 100.0| WTP: 700000,1,0.096153846,515,700000,1,0.2,400,100,-1605330363,823434397,9785.986436,1116031041,111603104.1,6,69486,2888,1189,1626,437,1189,69486,437,1626,59.44059406,1.836633663,2.537953795,46806.24092,586.9438944,4.491749175,98788.86469,0.472555394,0.005908499,4.67626E-05,0.268757688,0.023400734,87,12
D:1| T0: 0.10| T1: 515.00| I0: 400.0| I1: 100.0| WTP: 700000,1,0.096153846,515,700000,1,0.2,400,100,-2458203307,493045351,6093.837116,2153511451,215351145.1,14,52722,2335,1012,1012,0,1012,52722,0,1012,27.15047619,0.768571429,0.768571429,64054.04857,127.6933333,1.73047619,99319.63905,0.644437381,0.00128451,1.93554E-05,0,0.019195023,150,24
D:1| T0: 0.10| T1: 515.00| I0: 400.0| I1: 100.0| WTP: 700000,1,0.096153846,515,700000,1,0.2,400,100,-1755128038,1700216563,7439.205727,1383167752,138316775.2,8,65454,3003,988,1235,247,988,65454,247,1235,94.81204819,2.262650602,2.83373494,57538.34458,847.0433735,5.207228916,99240.98795,0.578572346,0.008501784,5.37672E-05,0.2,0.018868213,60,15
D:1| T0: 0.10| T1: 515.00| I0: 400.0| I1: 100.0| WTP: 700000,1,0.096153846,515,700000,1,0.2,400,100,-1730984569,1744119059,7124.103118,1374779413,137477941.3,8,60673,2809,1039,1183,144,1039,60673,144,1183,47.4757953,1.2406639,1.432918396,53086.77593,230.8907331,2.87275242,99100.10927,0.535221416,0.002321487,3.08754E-05,0.121724429,0.019497964,104,15
D:1| T0: 0.10| T1: 515.00| I0: 400.0| I1: 100.0| WTP: 700000,1,0.096153846,515,700000,1,0.2,400,100,-2532250973,2036906360,7447.180971,2159891924,215989192.4,12,58820,2606,1221,1237,16,1221,58820,16,1237,22.45780591,0.695499297,0.708157525,53542.94726,287.1420534,1.565400844,99046.69339,0.540002808,0.00288975,1.73805E-05,0.012934519,0.021030262,203,24
D:1| T0: 0.10| T1: 515.00| I0: 400.0| I1: 100.0| WTP: 700000,1,0.096153846,515,700000,1,0.2,400,100,-1877769364,809704121,8171.308232,1469203953,146920395.3,8,67694,3069,1009,1357,348,1009,67694,348,1357,91.42925659,2.278177458,3.09352518,55503.19664,838.7889688,5.51558753,99149.98561,0.558406623,0.008424791,5.69833E-05,0.256448047,0.02004609,59,16
D:1| T0: 0.10| T1: 515.00| I0: 400.0| I1: 100.0| WTP: 700000,1,0.096153846,515,700000,1,0.2,400,100,-1700234090,1219866412,11258.06692,1137330744,113733074.4,6,89654,3951,801,1870,1069,801,89654,1069,1870,186.7528517,2.923954373,6.950570342,40127.79468,2798.513308,9.992395437,98855.30798,0.403365863,0.028130056,0.000102118,0.571657754,0.020857965,38,12
D:1| T0: 0.10| T1: 515.00| I0: 400.0| I1: 100.0| WTP: 700000,1,0.096153846,515,700000,1,0.2,400,100,-4372521155,843498920,7517.884718,3996626919,399662691.9,26,56132,2457,1249,1249,0,1249,56132,0,1249,17.80563887,0.550689862,0.550689862,67096.12058,162.1271746,1.300539892,99288.25015,0.675041798,0.00163268,1.50701E-05,0,0.022251122,239,45
D:1| T0: 0.10| T1: 515.00| I0: 400.0| I1: 100.0| WTP: 700000,1,0.096153846,515,700000,1,0.2,400,100,-1981660987,107351963,10326.07949,1465357012,146535701.2,8,71840,2807,1295,1716,421,1295,71840,421,1716,48.4813278,1.64868603,2.215767635,44824.26694,690.9377593,3.987551867,98718.40387,0.452727074,0.006959652,4.19493E-05,0.245337995,0.023886414,104,16
D:1| T0: 0.10| T1: 515.00| I0: 400.0| I1: 100.0| WTP: 700000,1,0.096153846,515,700000,1,0.2,400,100,-1897380583,773789021,8608.970154,1466932075,146693207.5,8,69060,3016,1080,1430,350,1080,69060,350,1430,63.23529412,1.74567474,2.335640138,47481.24913,811.6816609,4.223183391,98946.90657,0.478726033,0.008161808,4.36655E-05,0.244755245,0.020706632,83,16
D:1| T0: 0.10| T1: 515.00| I0: 400.0| I1: 100.0| WTP: 700000,1,0.096153846,515,700000,1,0.2,400,100,-1618199969,850936611,10020.55179,1117172380,111717238,6,69867,2894,1127,1665,538,1127,69867,538,1665,57.07142857,1.641304348,2.448757764,44639.63509,575.613354,4.187888199,98709.67081,0.451028243,0.005796502,4.36564E-05,0.323123123,0.023830993,92,12
D:1| T0: 0.10| T1: 515.00| I0: 400.0| I1: 100.0| WTP: 700000,1,0.096153846,515,700000,1,0.2,400,100,-1568445633,1701318364,8982.293752,1119330945,111933094.5,6,70496,3025,1075,1492,417,1075,70496,417,1492,60.82250396,1.580031696,2.228209192,42821.13154,470.340729,3.93977813,98808.25674,0.43253079,0.004732987,4.09292E-05,0.279490617,0.021164321,91,12
D:1| T0: 0.10| T1: 515.00| I0: 400.0| I1: 100.0| WTP: 700000,1,0.096153846,515,700000,1,0.2,400,100,-3525584487,778708269,6394.292181,3205869878,320586987.8,18,50300,2259,1062,1062,0,1062,50300,0,1062,18.20770202,0.517676768,0.517676768,62806.15278,245.5625,1.193181818,99223.0202,0.632489342,0.002469286,1.34719E-05,0,0.02111332,227,36
D:1| T0: 0.10| T1: 515.00| I0: 400.0| I1: 100.0| WTP: 700000,1,0.096153846,515,700000,1,0.2,400,100,-2676811173,1391938506,8552.811662,2249170590,224917059,14,60320,2536,1396,1421,25,1396,60320,25,1421,31.09665072,1.129186603,1.151196172,58230.03062,205.2019139,2.486124402,99021.04689,0.587422593,0.002067217,2.7124E-05,0.017593244,0.023558083,150,25
D:1| T0: 0.10| T1: 515.00| I0: 400.0| I1: 100.0| WTP: 700000,1,0.096153846,515,700000,1,0.2,400,100,-3763880303,43418681,6049.456328,3461407487,346140748.7,20,46748,2033,1005,1005,0,1005,46748,0,1005,15.27860697,0.422885572,0.422885572,71023.29167,163.1660448,1.060945274,99384.15672,0.714184776,0.001641298,1.25552E-05,0,0.021498706,230,39
D:1| T0: 0.10| T1: 515.00| I0: 400.0| I1: 100.0| WTP: 700000,1,0.096153846,515,700000,1,0.2,400,100,-1417547193,817384966,12692.12962,782940711.9,78294071.19,4,90602,3756,789,2109,1320,789,90602,1320,2109,252.4456522,4.195652174,11.2826087,40878.88587,1341.407609,15.5923913,98743.14674,0.411496812,0.013472938,0.000158227,0.625889047,0.023277632,27,8
D:1| T0: 0.10| T1: 515.00| I0: 400.0| I1: 100.0| WTP: 700000,1,0.096153846,515,700000,1,0.2,400,100,-1329680087,762053968,10908.90403,784234885.7,78423488.57,4,89409,3903,706,1812,1106,706,89409,1106,1812,233.9460784,3.362745098,8.730392157,42878.75,1366.02451,12.18627451,98936.04902,0.430944848,0.013709946,0.000123882,0.610375276,0.020266416,30,8
D:1| T0: 0.10| T1: 515.00| I0: 400.0| I1: 100.0| WTP: 700000,1,0.096153846,515,700000,1,0.2,400,100,-1875569597,1692506311,8129.27901,1469105647,146910564.7,8,68062,3054,1210,1350,140,1210,68062,140,1350,47.73081761,1.38490566,1.553459119,47667.30189,568.436478,3.059119497,98987.66289,0.480621105,0.005717023,3.23789E-05,0.103703704,0.019835148,113,16
D:1| T0: 0.10| T1: 515.00| I0: 400.0| I1: 100.0| WTP: 700000,1,0.096153846,515,700000,1,0.2,400,100,-3077379545,1037620300,6278.833453,2763437872,276343787.2,16,49667,2082,1043,1043,0,1043,49667,0,1043,23.4096171,0.723063224,0.723063224,71208.33571,184.9572573,1.649154052,99403.38201,0.715834121,0.001860046,1.86558E-05,0,0.020999859,161,31
D:1| T0: 0.10| T1: 515.00| I0: 400.0| I1: 100.0| WTP: 700000,1,0.096153846,515,700000,1,0.2,400,100,-3046733152,301400999,7278.119686,2682827168,268282716.8,16,57296,2472,1209,1209,0,1209,57296,0,1209,28.65553435,0.990458015,0.990458015,59785.17844,227.0753817,2.123091603,99171.5458,0.602272697,0.002284478,2.31903E-05,0,0.021102054,150,30
D:1| T0: 0.10| T1: 515.00| I0: 400.0| I1: 100.0| WTP: 700000,1,0.096153846,515,700000,1,0.2,400,100,-1336895639,1868336855,11035.35716,785127780.7,78512778.07,4,88867,3905,818,1833,1015,818,88867,1015,1833,214.8928571,3.53125,8.035714286,45474.58482,1548.191964,11.6875,98973.66518,0.456759151,0.015547365,0.000118855,0.553737043,0.020626329,32,8
D:1| T0: 0.10| T1: 515.00| I0: 400.0| I1: 100.0| WTP: 700000,1,0.096153846,515,700000,1,0.2,400,100,-1328426135,1868498144,11020.78071,777387099.5,77738709.95,4,83064,3574,738,1831,1093,738,83064,1093,1831,154.2624113,2.468085106,6.308510638,43508.91489,1229.22695,8.946808511,98828.9078,0.437946382,0.012357932,9.15984E-05,0.596941562,0.022043244,41,8
D:1| T0: 0.10| T1: 515.00| I0: 400.0| I1: 100.0| WTP: 700000,1,0.096153846,515,700000,1,0.2,400,100,-2773869689,2101566889,7085.828934,2419578243,241957824.3,14,53913,2379,1171,1177,6,1171,53913,6,1177,26.28809107,0.854640981,0.859894921,59798.71191,268.767951,1.888791594,99133.47198,0.602659978,0.002703667,2.06636E-05,0.005097706,0.021831469,164,27
D:1| T0: 0.10| T1: 515.00| I0: 400.0| I1: 100.0| WTP: 700000,1,0.096153846,515,700000,1,0.2,400,100,-1326607715,1665097450,12466.49921,703282753.9,70328275.39,4,95376,4092,712,2071,1359,712,95376,1359,2071,268.265625,3.651041667,10.65625,33922.08333,1700.838542,14.359375,98663.69271,0.341408236,0.017091824,0.000145674,0.656204732,0.021714058,28,7
D:1| T0: 0.10| T1: 515.00| I0: 400.0| I1: 100.0| WTP: 700000,1,0.096153846,515,700000,1,0.2,400,100,-1337506518,1716179948,10775.50476,798731279.7,79873127.97,4,97436,4498,713,1789,1076,713,97436,1076,1789,304.7365591,3.747311828,9.478494624,36982.23118,1808.892473,13.31182796,98946.6129,0.371245615,0.018147954,0.000134933,0.601453326,0.01836077,27,8
D:1| T0: 0.10| T1: 515.00| I0: 400.0| I1: 100.0| WTP: 700000,1,0.096153846,515,700000,1,0.2,400,100,-2606912320,1560278715,7384.02137,2237711252,223771125.2,14,49543,1996,1216,1227,11,1216,49543,11,1227,30.05465116,1.209302326,1.224418605,67580.56395,196.955814,2.648837209,99207.39651,0.680648013,0.001982,2.85489E-05,0.008964955,0.024769364,122,25
D:1| T0: 0.10| T1: 515.00| I0: 400.0| I1: 100.0| WTP: 700000,1,0.096153846,515,700000,1,0.2,400,100,-1400544680,991019385,12343.8999,783349685.4,78334968.54,4,90105,3827,713,2051,1338,713,90105,1338,2051,176.2255639,2.560150376,7.567669173,38985.35338,2004.496241,10.26691729,98708.37218,0.392013411,0.020164468,0.000104562,0.6523647,0.022762333,38,8
D:1| T0: 0.10| T1: 515.00| I0: 400.0| I1: 100.0| WTP: 700000,1,0.096153846,515,700000,1,0.2,400,100,-1350120201,118052103,11293.66053,785437174.6,78543717.46,4,87357,3891,765,1876,1111,765,87357,1111,1876,180.4701493,2.720149254,6.824626866,45449.93657,1649.537313,9.701492537,98919.63433,0.456590564,0.016581293,9.90906E-05,0.592217484,0.021475096,39,8
D:1| T0: 0.10| T1: 515.00| I0: 400.0| I1: 100.0| WTP: 700000,1,0.096153846,515,700000,1,0.2,400,100,-1405055439,1209758844,12434.00238,783355320.1,78335532.01,4,89402,3728,691,2066,1375,691,89402,1375,2066,240.5179487,3.441025641,10.44102564,45146.83077,1345.369231,13.96410256,98835.05128,0.45362038,0.013515966,0.000142049,0.66553727,0.023109103,28,8
D:1| T0: 0.10| T1: 515.00| I0: 400.0| I1: 100.0| WTP: 700000,1,0.096153846,515,700000,1,0.2,400,100,-4979158049,70671723,7367.943991,4610760849,461076084.9,26,56072,2392,1224,1224,0,1224,56072,0,1224,16.13108614,0.475655431,0.475655431,64640.25361,184.8020332,1.131621188,99241.31086,0.650791734,0.001860823,1.31715E-05,0,0.021829077,267,52
D:1| T0: 0.10| T1: 515.00| I0: 400.0| I1: 100.0| WTP: 700000,1,0.096153846,515,700000,1,0.2,400,100,-2841836380,1722612191,6659.903054,2508841227,250884122.7,14,55199,2488,1106,1106,0,1106,55199,0,1106,26.96721311,0.754961173,0.754961173,65582.39431,262.9974116,1.716134599,99329.13891,0.659608161,0.002644378,1.91747E-05,0,0.020036595,165,28
D:1| T0: 0.10| T1: 515.00| I0: 400.0| I1: 100.0| WTP: 700000,1,0.096153846,515,700000,1,0.2,400,100,-2811973997,1968291596,6088.944564,2507526769,250752676.9,14,53337,2427,1011,1011,0,1011,53337,0,1011,29.22116301,0.7607245,0.7607245,68510.72259,204.013346,1.721639657,99412.93136,0.688602737,0.002051086,1.93548E-05,0,0.018955302,150,28
D:1| T0: 0.10| T1: 515.00| I0: 400.0| I1: 100.0| WTP: 700000,1,0.096153846,515,700000,1,0.2,400,100,-1449474365,1877569084,13169.17406,791015662.1,79101566.21,4,96488,4069,745,2188,1443,745,96488,1443,2188,266.1295337,3.813471503,11.21243523,35133.56995,1600.093264,15.05181347,98644.61658,0.353250926,0.016087307,0.00015278,0.659506399,0.022676395,28,8
D:1| T0: 0.10| T1: 515.00| I0: 400.0| I1: 100.0| WTP: 700000,1,0.096153846,515,700000,1,0.2,400,100,-1400909269,1726322189,12190.40189,791389174.1,79138917.41,4,95421,4151,742,2025,1283,742,95421,1283,2025,268.4352332,3.777202073,10.33678756,36894.84456,1673.772021,14.19170984,98778.33161,0.370759373,0.0168105,0.000144015,0.633580247,0.021221744,28,8
D:1| T0: 0.10| T1: 515.00| I0: 400.0| I1: 100.0| WTP: 700000,1,0.096153846,515,700000,1,0.2,400,100,-1390977632,307848836,12063.07059,787824102.3,78782410.23,4,91431,4027,613,2004,1391,613,91431,1391,2004,231.5627907,2.772093023,9.195348837,41100.16744,1495.390698,12.03255814,98811.69767,0.412902006,0.015021828,0.000122332,0.694111776,0.021918168,31,8
D:1| T0: 0.10| T1: 515.00| I0: 400.0| I1: 100.0| WTP: 700000,1,0.096153846,515,700000,1,0.2,400,100,-1256273041,1154000220,11067.13265,702916408,70291640.8,4,91009,4125,749,1838,1089,749,91009,1089,1838,280.1630435,3.983695652,9.836956522,33230.30978,1286.51087,13.89673913,98752.70652,0.335189924,0.012907515,0.000141173,0.592491839,0.020195805,27,7
D:1| T0: 0.10| T1: 515.00| I0: 400.0| I1: 100.0| WTP: 700000,1,0.096153846,515,700000,1,0.2,400,100,-4082597946,2028661055,7006.978574,3732249018,373224901.8,22,53229,2340,1164,1164,0,1164,53229,0,1164,18.39644219,0.554637865,0.554637865,66018.08196,176.7890724,1.299237611,99267.61309,0.664490542,0.001779524,1.48674E-05,0,0.021867779,225,42
D:1| T0: 0.10| T1: 515.00| I0: 400.0| I1: 100.0| WTP: 700000,1,0.096153846,515,700000,1,0.2,400,100,-1881607245,1629114640,9872.933435,1387960573,138796057.3,8,77706,3400,1070,1640,570,1070,77706,570,1640,121.5146199,3.005847953,4.622807018,50148.26608,1410.076023,7.748538012,99020.85965,0.504481775,0.014172465,7.96657E-05,0.347560976,0.021105463,49,15
D:1| T0: 0.10| T1: 515.00| I0: 400.0| I1: 100.0| WTP: 700000,1,0.096153846,515,700000,1,0.2,400,100,-1448079271,1439048174,13026.9009,796734226.2,79673422.62,4,96599,4308,746,2164,1418,746,96599,1418,2164,300.1748634,4,11.66666667,38851.43169,2247.836066,15.75956284,98756.08743,0.390137629,0.022590817,0.000159786,0.655268022,0.022401888,27,8
D:1| T0: 0.10| T1: 515.00| I0: 400.0| I1: 100.0| WTP: 700000,1,0.096153846,515,700000,1,0.2,400,100,-1292416835,865227006,11976.89732,693571969.4,69357196.94,4,88440,3679,705,1990,1285,705,88440,1285,1990,275.0722892,4.120481928,11.79518072,34329.10843,1429.783133,16.08433735,98636.85542,0.346731923,0.014345885,0.000163076,0.645728643,0.02250164,24,7
D:1| T0: 0.10| T1: 515.00| I0: 400.0| I1: 100.0| WTP: 700000,1,0.096153846,515,700000,1,0.2,400,100,-1621086639,890479738,11355.36228,1053318525,105331852.5,6,90197,3992,809,1886,1077,809,90197,1077,1886,218.5914894,3.310638298,7.846808511,44940.32766,2739.4,11.3106383,98964.15745,0.45120578,0.027521137,0.000115252,0.571049841,0.020909786,34,11
D:1| T0: 0.10| T1: 515.00| I0: 400.0| I1: 100.0| WTP: 700000,1,0.096153846,515,700000,1,0.2,400,100,-3365321786,1017049163,6623.668628,3034138355,303413835.5,20,54660,2546,1099,1100,1,1099,54660,1,1100,22.57247438,0.646412884,0.647144949,59930.16545,142.9509517,1.448023426,99204.959,0.603629123,0.001438681,1.6175E-05,0.000909091,0.020124405,196,34
D:1| T0: 0.10| T1: 515.00| I0: 400.0| I1: 100.0| WTP: 700000,1,0.096153846,515,700000,1,0.2,400,100,-3525124691,1707305064,6340.919541,3208078714,320807871.4,18,53097,2413,1053,1053,0,1053,53097,0,1053,21.83549784,0.564935065,0.564935065,65713.18615,200.7330447,1.336219336,99323.15152,0.661102099,0.002019018,1.52641E-05,0,0.019831629,198,36
D:1| T0: 0.10| T1: 515.00| I0: 400.0| I1: 100.0| WTP: 700000,1,0.096153846,515,700000,1,0.2,400,100,-1286251020,400145663,11803.58029,696072005.8,69607200.58,4,86942,3738,730,1961,1231,730,86942,1231,1961,245.9270833,3.723958333,10.078125,32762.4375,1214.723958,13.875,98577.98958,0.331264071,0.012196606,0.000140896,0.627740948,0.022555267,28,7
D:1| T0: 0.10| T1: 515.00| I0: 400.0| I1: 100.0| WTP: 700000,1,0.096153846,515,700000,1,0.2,400,100,-3242846837,1662654181,7615.676358,2862063019,286206301.9,18,58573,2619,1245,1265,20,1245,58573,20,1265,24.10178306,0.765973254,0.778603269,56576.27117,179.1270431,1.707280832,99076.31352,0.570450586,0.001803553,1.87527E-05,0.015810277,0.021596982,193,32
D:1| T0: 0.10| T1: 515.00| I0: 400.0| I1: 100.0| WTP: 700000,1,0.096153846,515,700000,1,0.2,400,100,-1362182916,182136456,11380.26596,793169618,79316961.8,4,95282,4251,770,1890,1120,770,95282,1120,1890,282.1489362,4.037234043,9.909574468,37686.44149,1749.590426,14,98864.92021,0.378761919,0.017562797,0.000142007,0.592592593,0.019835856,27,8
D:1| T0: 0.10| T1: 515.00| I0: 400.0| I1: 100.0| WTP: 700000,1,0.096153846,515,700000,1,0.2,400,100,-3854660163,979575387,6032.753309,3553022497,355302249.7,20,50872,2299,1002,1002,0,1002,50872,0,1002,18.0983165,0.488215488,0.488215488,67681.95084,230.7367003,1.167003367,99367.69832,0.68064368,0.00232005,1.35537E-05,0,0.019696493,213,40
D:1| T0: 0.10| T1: 515.00| I0: 400.0| I1: 100.0| WTP: 700000,1,0.096153846,515,700000,1,0.2,400,100,-1414555815,2142525414,12519.76766,788567431.6,78856743.16,4,93670,3990,711,2080,1369,711,93670,1369,2080,256.7384615,3.523076923,10.48717949,45475.51282,1895.589744,14.17435897,98908.51282,0.456217912,0.019047371,0.000143821,0.658173077,0.022205615,28,8
D:1| T0: 0.10| T1: 515.00| I0: 400.0| I1: 100.0| WTP: 700000,1,0.096153846,515,700000,1,0.2,400,100,-1308353211,1464057597,10553.45839,780680291.3,78068029.13,4,83440,3665,765,1753,988,765,83440,988,1753,168.3247232,2.6900369,6.287822878,47638.99262,1154.653137,9.103321033,98981.90406,0.478795989,0.011598857,9.33721E-05,0.563605248,0.021010116,39,8
D:1| T0: 0.10| T1: 515.00| I0: 400.0| I1: 100.0| WTP: 700000,1,0.096153846,515,700000,1,0.2,400,100,-1363136256,364562610,11575.53304,784359603.8,78435960.38,4,90373,3854,667,1923,1256,667,90373,1256,1923,239.7939698,3.246231156,9.497487437,43443.79899,1533.854271,12.86432161,98892.47739,0.436426742,0.015401995,0.000130688,0.653146126,0.021278479,29,8
D:1| T0: 0.10| T1: 515.00| I0: 400.0| I1: 100.0| WTP: 700000,1,0.096153846,515,700000,1,0.2,400,100,-1378858728,40350784,11893.77738,784169859.3,78416985.93,4,90261,3748,686,1976,1290,686,90261,1290,1976,227.5502392,3.148325359,9.267942584,45322.52632,1657.406699,12.54545455,98905.97608,0.455083565,0.016649277,0.000127961,0.652834008,0.021892069,30,8
D:1| T0: 0.10| T1: 515.00| I0: 400.0| I1: 100.0| WTP: 700000,1,0.096153846,515,700000,1,0.2,400,100,-1273483426,804064356,9720.873859,787439732.7,78743973.27,4,86882,4047,690,1614,924,690,86882,924,1614,242.6941748,3.247572816,7.669902913,46469.7767,1217.18932,11.01941748,99087.15534,0.466785178,0.012203156,0.000112138,0.572490706,0.018577134,30,8
D:1| T0: 0.10| T1: 515.00| I0: 400.0| I1: 100.0| WTP: 700000,1,0.096153846,515,700000,1,0.2,400,100,-2241362013,2125493986,8600.972753,1811313375,181131337.5,12,63274,2650,1232,1429,197,1232,63274,197,1429,48.1634757,1.621502209,1.904270987,54991.72018,295.1384389,3.703976436,98999.76289,0.554688175,0.002970732,3.94172E-05,0.137858642,0.022584316,97,20
D:1| T0: 0.10| T1: 515.00| I0: 400.0| I1: 100.0| WTP: 700000,1,0.096153846,515,700000,1,0.2,400,100,-1238899457,23154253,9166.195974,780589658.5,78058965.85,4,78757,3560,713,1522,809,713,78757,809,1522,180.2627451,2.670588235,5.815686275,47154.9451,824.9607843,8.62745098,99039.89804,0.474417196,0.0082769,8.79372E-05,0.531537451,0.019325266,37,8
D:1| T0: 0.10| T1: 515.00| I0: 400.0| I1: 100.0| WTP: 700000,1,0.096153846,515,700000,1,0.2,400,100,-2416272439,1391367689,6953.574094,2068593735,206859373.5,12,54774,2422,1155,1155,0,1155,54774,0,1155,30.81282316,1,1,64324.61013,191.0672182,2.178903826,99251.08687,0.647531681,0.001922405,2.40018E-05,0,0.021086647,139,23
D:1| T0: 0.10| T1: 515.00| I0: 400.0| I1: 100.0| WTP: 700000,1,0.096153846,515,700000,1,0.2,400,100,-1552896132,574142276,8711.360882,1117328088,111732808.8,6,68260,3027,1028,1447,419,1028,68260,419,1447,58.45525903,1.489795918,2.128728414,45664.82418,492.7974882,3.739403454,98876.81319,0.460916927,0.004956339,3.90818E-05,0.289564616,0.021198359,91,12
D:1| T0: 0.10| T1: 515.00| I0: 400.0| I1: 100.0| WTP: 700000,1,0.096153846,515,700000,1,0.2,400,100,-4236571669,898736779,6610.068845,3906068227,390606822.7,22,51970,2330,1098,1098,0,1098,51970,0,1098,16.28859447,0.44297235,0.44297235,67029.11406,220.3317972,1.081797235,99309.51613,0.674426379,0.002216861,1.27122E-05,0,0.021127574,248,44
D:1| T0: 0.10| T1: 515.00| I0: 400.0| I1: 100.0| WTP: 700000,1,0.096153846,515,700000,1,0.2,400,100,-1592145177,346473503,9107.904737,1136749940,113674994,6,83659,3995,705,1512,807,705,83659,807,1512,187.6121673,2.558935361,5.593155894,47566.31939,1805.48289,8.281368821,99124.53992,0.477771188,0.018116781,8.4613E-05,0.533730159,0.018073369,38,12
D:1| T0: 0.10| T1: 515.00| I0: 400.0| I1: 100.0| WTP: 700000,1,0.096153846,515,700000,1,0.2,400,100,-1614837646,445552282,9771.244653,1126275413,112627541.3,6,74932,3334,1023,1623,600,1023,74932,600,1623,92.79039301,2.100436681,3.390829694,44598.56332,935.5764192,5.626637555,98843.41703,0.449686464,0.009411044,5.81305E-05,0.369685767,0.021659638,65,12
D:1| T0: 0.10| T1: 515.00| I0: 400.0| I1: 100.0| WTP: 700000,1,0.096153846,515,700000,1,0.2,400,100,-1270786973,911758476,11284.51619,706561163.2,70656116.32,4,92449,4212,736,1874,1138,736,92449,1138,1874,252.5492958,3.384976526,8.638497653,28949.4554,1215.075117,12.10798122,98646.93427,0.292196282,0.012203292,0.000123144,0.607257204,0.020270636,31,7
D:1| T0: 0.10| T1: 515.00| I0: 400.0| I1: 100.0| WTP: 700000,1,0.096153846,515,700000,1,0.2,400,100,-1381815226,1464197940,11687.88935,797420758.4,79742075.84,4,96108,4386,679,1941,1262,679,96108,1262,1941,277.2636816,3.278606965,9.527363184,38605.37313,2774.383085,12.90547264,98875.17413,0.387457565,0.027857109,0.000130907,0.650180319,0.020196029,29,8
D:1| T0: 0.10| T1: 515.00| I0: 400.0| I1: 100.0| WTP: 700000,1,0.096153846,515,700000,1,0.2,400,100,-2055414881,500405854,8384.807806,1636174490,163617449,10,63617,2698,1259,1393,134,1259,63617,134,1393,39.03562945,1.305225653,1.458432304,51808.63064,306.8978622,2.956057007,98956.17815,0.522910342,0.003089481,3.16812E-05,0.096195262,0.021896663,121,18
D:1| T0: 0.10| T1: 515.00| I0: 400.0| I1: 100.0| WTP: 700000,1,0.096153846,515,700000,1,0.2,400,100,-1367557469,772037341,11777.84409,778665265.1,77866526.51,4,84909,3608,627,1957,1330,627,84909,1330,1957,214.6699029,2.917475728,9.32038835,47682.80583,1350.533981,12.36893204,98881.03398,0.47935571,0.013564432,0.000125993,0.67961165,0.023048205,30,8
D:1| T0: 0.10| T1: 515.00| I0: 400.0| I1: 100.0| WTP: 700000,1,0.096153846,515,700000,1,0.2,400,100,-3497634449,1543158763,5971.62215,3199053341,319905334.1,18,47789,2059,992,992,0,992,47789,0,992,16.89938817,0.487423521,0.487423521,71478.88171,157.7940177,1.174711081,99404.87627,0.718633337,0.001587365,1.35453E-05,0,0.020757915,211,36
D:1| T0: 0.10| T1: 515.00| I0: 400.0| I1: 100.0| WTP: 700000,1,0.096153846,515,700000,1,0.2,400,100,-1456046314,1604932531,13319.00724,790095952.1,79009595.21,4,94892,4067,764,2213,1449,764,94892,1449,2213,253.65,3.76,10.935,33670.975,1394.895,14.74,98553.945,0.33912986,0.014029531,0.000149718,0.654767284,0.023321249,29,8
D:1| T0: 0.10| T1: 515.00| I0: 400.0| I1: 100.0| WTP: 700000,1,0.096153846,515,700000,1,0.2,400,100,-1368832810,539051477,11601.00889,788782365.3,78878236.53,4,91936,4058,718,1927,1209,718,91936,1209,1927,224.8883929,3.107142857,8.446428571,42742.0625,2343.183036,11.64285714,98910.42857,0.429129865,0.02354521,0.000118658,0.627400104,0.020960233,32,8
D:1| T0: 0.10| T1: 515.00| I0: 400.0| I1: 100.0| WTP: 700000,1,0.096153846,515,700000,1,0.2,400,100,-2904989119,1743124675,6332.935203,2588342358,258834235.8,18,51442,2183,1052,1052,0,1052,51442,0,1052,21.2516129,0.663709677,0.663709677,67604.0879,140.5822581,1.508064516,99332.5129,0.68004143,0.001414726,1.70435E-05,0,0.020450216,178,29
D:1| T0: 0.10| T1: 515.00| I0: 400.0| I1: 100.0| WTP: 700000,1,0.096153846,515,700000,1,0.2,400,100,-1924639129,1965983789,9149.584792,1467159889,146715988.9,8,67612,2919,1130,1520,390,1130,67612,390,1520,86.10849057,2.54245283,3.429245283,55063.81132,931.7382075,6.099056604,99037.48349,0.554457073,0.009367031,6.28291E-05,0.256578947,0.022481216,61,16
D:1| T0: 0.10| T1: 515.00| I0: 400.0| I1: 100.0| WTP: 700000,1,0.096153846,515,700000,1,0.2,400,100,-2926753490,516774280,8217.668543,2515870063,251587006.3,14,65230,2826,1341,1365,24,1341,65230,24,1365,27.67591125,0.881933439,0.898573693,52003.90412,332.699683,1.961965135,99012.60222,0.524494418,0.003349407,2.15725E-05,0.017582418,0.020926275,180,28
D:1| T0: 0.10| T1: 515.00| I0: 400.0| I1: 100.0| WTP: 700000,1,0.096153846,515,700000,1,0.2,400,100,-998389498.6,86603142,11251.91933,435793532.2,43579353.22,2,88466,3815,624,1869,1245,624,88466,1245,1869,285.6569767,3.534883721,10.72674419,32496.5407,1333.540698,14.31976744,98668.77907,0.32826279,0.013375069,0.000145509,0.666131621,0.021126999,25,4
D:1| T0: 0.10| T1: 515.00| I0: 400.0| I1: 100.0| WTP: 700000,1,0.096153846,515,700000,1,0.2,400,100,-5334174769,1431870609,7369.308233,4965709358,496570935.8,28,59813,2651,1224,1224,0,1224,59813,0,1224,15.96067961,0.41407767,0.41407767,61266.54175,200.4174757,1.001941748,99224.81311,0.616842952,0.00201782,1.19508E-05,0,0.020463779,295,56
D:1| T0: 0.10| T1: 515.00| I0: 400.0| I1: 100.0| WTP: 700000,1,0.096153846,515,700000,1,0.2,400,100,-1241929708,1592383984,9320.840289,775887694,77588769.4,4,75834,3394,816,1548,732,816,75834,732,1548,142.5348837,2.594684385,5.003322259,48621.0897,734.4053156,7.707641196,99004.48837,0.489411742,0.007375628,7.88586E-05,0.472868217,0.020413007,43,8
D:1| T0: 0.10| T1: 515.00| I0: 400.0| I1: 100.0| WTP: 700000,1,0.096153846,515,700000,1,0.2,400,100,-1525685022,1440183867,8176.73623,1116848210,111684821,6,67584,3004,1053,1358,305,1053,67584,305,1358,56.20637329,1.474962064,1.918057663,46558.82246,494.0622155,3.509863429,98949.02124,0.46969305,0.004968516,3.67834E-05,0.224594993,0.020093513,95,12
D:1| T0: 0.10| T1: 515.00| I0: 400.0| I1: 100.0| WTP: 700000,1,0.096153846,515,700000,1,0.2,400,100,-1564916020,1696510588,8987.047175,1115563661,111556366.1,6,68836,2924,1114,1493,379,1114,68836,379,1493,50.93220339,1.415254237,1.940677966,46325.5113,456.1483051,3.514124294,98855.14831,0.467626388,0.004591065,3.70537E-05,0.253851306,0.021689232,102,12
D:1| T0: 0.10| T1: 515.00| I0: 400.0| I1: 100.0| WTP: 700000,1,0.096153846,515,700000,1,0.2,400,100,-1377059077,895039877,11834.12517,785352818.9,78535281.89,4,89167,3768,700,1966,1266,700,89167,1266,1966,198.7037037,2.781893004,7.95473251,40717.83128,1933.230453,10.81893004,98795.68313,0.409387433,0.019434156,0.000110336,0.643947101,0.022048516,35,8
D:1| T0: 0.10| T1: 515.00| I0: 400.0| I1: 100.0| WTP: 700000,1,0.096153846,515,700000,1,0.2,400,100,-1934228476,129565953,9329.962588,1467730347,146773034.7,8,68647,2898,1264,1550,286,1264,68647,286,1550,49.80487805,1.592140921,1.963414634,45897.94715,657.098916,3.66395664,98807.27507,0.463438098,0.006615092,3.83759E-05,0.184516129,0.022579282,105,16
D:1| T0: 0.10| T1: 515.00| I0: 400.0| I1: 100.0| WTP: 700000,1,0.096153846,515,700000,1,0.2,400,100,-2086926358,1902565669,7214.472969,1726202709,172620270.9,10,62641,2772,1076,1198,122,1076,62641,122,1198,31.41967509,0.835740072,0.940433213,49326.0009,217.8916968,1.896209386,99042.44314,0.497499343,0.002192382,2.06283E-05,0.101836394,0.019124854,159,19
D:1| T0: 0.10| T1: 515.00| I0: 400.0| I1: 100.0| WTP: 700000,1,0.096153846,515,700000,1,0.2,400,100,-4583851227,1984179288,8126.280711,4177537191,417753719.1,24,61420,2676,1349,1350,1,1349,61420,1,1350,17.71905274,0.539289559,0.539827772,57273.53767,248.8342304,1.263724435,99071.21421,0.577465607,0.002506316,1.46171E-05,0.000740741,0.021979811,266,47
D:1| T0: 0.10| T1: 515.00| I0: 400.0| I1: 100.0| WTP: 700000,1,0.096153846,515,700000,1,0.2,400,100,-1672883771,677377223,10776.64854,1134051344,113405134.4,6,84378,3760,982,1790,808,982,84378,808,1790,137.5146199,2.754385965,5.076023392,44094.5,2006.149123,7.964912281,98893.07018,0.443490911,0.020177447,8.15647E-05,0.451396648,0.021214061,48,12
D:1| T0: 0.10| T1: 515.00| I0: 400.0| I1: 100.0| WTP: 700000,1,0.096153846,515,700000,1,0.2,400,100,-1636446099,973583301,10114.98174,1130697012,113069701.2,6,83161,3652,1049,1680,631,1049,83161,631,1680,116.6813472,2.593264249,4.191709845,43396.62953,1753.088083,6.904145078,98924.07772,0.436575097,0.017627865,7.11207E-05,0.375595238,0.020201777,56,12
D:1| T0: 0.10| T1: 515.00| I0: 400.0| I1: 100.0| WTP: 700000,1,0.096153846,515,700000,1,0.2,400,100,-1756950570,781062938,7445.623955,1384669372,138466937.2,8,67582,3268,1062,1236,174,1062,67582,174,1236,49.94789082,1.167493797,1.377171216,45631.03598,384.1650124,2.688585608,99030.55211,0.460194728,0.003862004,2.86544E-05,0.140776699,0.018288893,116,15
D:1| T0: 0.10| T1: 515.00| I0: 400.0| I1: 100.0| WTP: 700000,1,0.096153846,515,700000,1,0.2,400,100,-1955668869,338783425,9537.685585,1478784589,147878458.9,8,78335,3480,1117,1584,467,1117,78335,467,1584,112.8989637,2.764248705,3.917098446,51237.18135,1650.994819,6.821243523,99078.8057,0.515062453,0.016597431,7.03429E-05,0.294823232,0.020220846,56,16
D:1| T0: 0.10| T1: 515.00| I0: 400.0| I1: 100.0| WTP: 700000,1,0.096153846,515,700000,1,0.2,400,100,-5317613207,1027579040,7044.904855,4965367965,496536796.5,28,58196,2632,1170,1170,0,1170,58196,0,1170,15.09258406,0.377245509,0.377245509,58919.19899,201.2178719,0.918470751,99185.19899,0.593511726,0.002025476,1.08368E-05,0,0.020104475,310,56
D:1| T0: 0.10| T1: 515.00| I0: 400.0| I1: 100.0| WTP: 700000,1,0.096153846,515,700000,1,0.2,400,100,-1611760109,764973813,9758.464307,1123836894,112383689.4,6,74930,3230,1102,1621,519,1102,74930,519,1621,88.01290323,2.219354839,3.309677419,46362.68172,1098.643011,5.692473118,98888.8172,0.467207518,0.011051039,5.89207E-05,0.320172733,0.021633525,66,12
D:1| T0: 0.10| T1: 515.00| I0: 400.0| I1: 100.0| WTP: 700000,1,0.096153846,515,700000,1,0.2,400,100,-1636982850,1245753446,10126.8896,1130638370,113063837,6,82957,3589,791,1682,891,791,82957,891,1682,146.1483871,2.432258065,5.270967742,44432.0129,1834.8,7.822580645,98945.21935,0.446895393,0.018438291,8.02072E-05,0.529726516,0.020275809,45,12
D:1| T0: 0.10| T1: 515.00| I0: 400.0| I1: 100.0| WTP: 700000,1,0.096153846,515,700000,1,0.2,400,100,-1558974130,1013177794,8890.602571,1114444001,111444400.1,6,67359,2884,1090,1477,387,1090,67359,387,1477,54.01221374,1.523664122,2.097709924,46385.86107,428.5923664,3.766412214,98854.17252,0.468359867,0.004312399,3.94282E-05,0.262017603,0.021927285,94,12
D:1| T0: 0.10| T1: 515.00| I0: 400.0| I1: 100.0| WTP: 700000,1,0.096153846,515,700000,1,0.2,400,100,-3874137164,1395089249,6499.940972,3549140115,354914011.5,20,47936,2010,1080,1080,0,1080,47936,0,1080,14.18906341,0.450843514,0.450843514,69439.74636,144.7172775,1.072716696,99318.60151,0.698684177,0.001456592,1.26262E-05,0,0.02253004,246,40
D:1| T0: 0.10| T1: 515.00| I0: 400.0| I1: 100.0| WTP: 700000,1,0.096153846,515,700000,1,0.2,400,100,-3860700516,1339545835,6211.941072,3550103462,355010346.2,20,47262,2031,1032,1032,0,1032,47262,0,1032,12.9343253,0.351462288,0.351462288,74458.66444,185.601334,0.871729092,99458.41252,0.748121422,0.001866987,1.06395E-05,0,0.021835724,279,40
D:1| T0: 0.10| T1: 515.00| I0: 400.0| I1: 100.0| WTP: 700000,1,0.096153846,515,700000,1,0.2,400,100,-1332052832,219139554,10832.89656,790408004.2,79040800.42,4,90154,4019,758,1799,1041,758,90154,1041,1799,289.5,4.191011236,9.938202247,41275.98315,1331.713483,14.19101124,98921.76404,0.415222809,0.01335809,0.000144089,0.578654808,0.019954744,26,8
D:1| T0: 0.10| T1: 515.00| I0: 400.0| I1: 100.0| WTP: 700000,1,0.096153846,515,700000,1,0.2,400,100,-2095427249,1336508942,7477.235468,1721565476,172156547.6,10,58153,2548,1201,1242,41,1201,58153,41,1242,32.5932377,1.048155738,1.089139344,56565.12705,240.9938525,2.320696721,99094.71824,0.570254422,0.002424474,2.51616E-05,0.033011272,0.021357821,140,19
D:1| T0: 0.10| T1: 515.00| I0: 400.0| I1: 100.0| WTP: 700000,1,0.096153846,515,700000,1,0.2,400,100,-4583505956,448559423,6703.442619,4248333825,424833382.5,24,45338,1858,1114,1114,0,1114,45338,0,1114,10.67632184,0.344827586,0.344827586,69649.47862,160.8321839,0.861609195,99249.7108,0.701274793,0.00161938,1.02963E-05,0,0.024571542,311,48
D:1| T0: 0.10| T1: 515.00| I0: 400.0| I1: 100.0| WTP: 700000,1,0.096153846,515,700000,1,0.2,400,100,-1911483973,2110028840,8879.417722,1467513087,146751308.7,8,69517,3061,1230,1475,245,1230,69517,245,1475,51.83779972,1.576868829,1.902679831,47762.10014,479.5430183,3.631875882,98924.52186,0.481801812,0.004825597,3.83819E-05,0.166101695,0.021217832,102,16
D:1| T0: 0.10| T1: 515.00| I0: 400.0| I1: 100.0| WTP: 700000,1,0.096153846,515,700000,1,0.2,400,100,-1967411288,1982030155,9996.479795,1467587298,146758729.8,8,71617,2963,1139,1661,522,1139,71617,522,1661,88.08192771,2.621686747,3.848192771,52236.53012,1148.144578,6.590361446,98944.50602,0.526119546,0.01155041,6.78709E-05,0.314268513,0.023192817,60,16
D:1| T0: 0.10| T1: 515.00| I0: 400.0| I1: 100.0| WTP: 700000,1,0.096153846,515,700000,1,0.2,400,100,-1249698267,696219407,9589.202629,770238135.2,77023813.52,4,72391,3184,769,1593,824,769,72391,824,1593,117.0385757,2.127596439,4.548961424,50996.23442,716.8071217,6.818991098,98970.63205,0.513530369,0.007201362,7.04406E-05,0.517263026,0.022005498,49,8
D:1| T0: 0.10| T1: 515.00| I0: 400.0| I1: 100.0| WTP: 700000,1,0.096153846,515,700000,1,0.2,400,100,-1324873222,1402539442,10665.09851,791618296.9,79161829.69,4,93537,4147,701,1771,1070,701,93537,1070,1771,257.9359606,3.359605911,8.586206897,42599.54187,2112.738916,12.03448276,99011.71921,0.427492934,0.021198924,0.000122191,0.60417843,0.018933684,29,8
D:1| T0: 0.10| T1: 515.00| I0: 400.0| I1: 100.0| WTP: 700000,1,0.096153846,515,700000,1,0.2,400,100,-1385425645,1319833493,11848.62318,792994485.5,79299448.55,4,92959,4187,765,1968,1203,765,92959,1203,1968,220.3666667,3.075,8.033333333,38741.50833,2623.029167,11.21666667,98807.0875,0.389199939,0.026370065,0.000114482,0.611280488,0.021170624,35,8
D:1| T0: 0.10| T1: 515.00| I0: 400.0| I1: 100.0| WTP: 700000,1,0.096153846,515,700000,1,0.2,400,100,-2137188058,663608076,8211.521647,1726611976,172661197.6,10,64309,2859,1220,1364,144,1220,64309,144,1364,32.84469697,0.991477273,1.12405303,48299.42045,368.6373106,2.285037879,98921.92519,0.487607585,0.003710574,2.46147E-05,0.105571848,0.021210095,151,19
D:1| T0: 0.10| T1: 515.00| I0: 400.0| I1: 100.0| WTP: 700000,1,0.096153846,515,700000,1,0.2,400,100,-2171747065,414696500,7225.448381,1810474646,181047464.6,10,58456,2537,1191,1200,9,1191,58456,9,1200,37.55581128,1.18872267,1.20023015,60599.09206,465.127733,2.571921749,99213.35558,0.609952645,0.004675884,2.76479E-05,0.007506255,0.020511154,124,20
D:1| T0: 0.10| T1: 515.00| I0: 400.0| I1: 100.0| WTP: 700000,1,0.096153846,515,700000,1,0.2,400,100,-2887789828,1249738535,7673.362597,2504121698,250412169.8,14,53386,2219,1275,1275,0,1275,53386,0,1275,23.64860288,0.886536833,0.886536833,67219.92464,179.9906859,1.959356478,99229.97121,0.676705903,0.001812268,2.17118E-05,0,0.023882666,169,28
D:1| T0: 0.10| T1: 515.00| I0: 400.0| I1: 100.0| WTP: 700000,1,0.096153846,515,700000,1,0.2,400,100,-2156400917,614415382,6984.128253,1807194505,180719450.5,10,56348,2458,1119,1160,41,1119,56348,41,1160,28.8768797,0.907894737,0.944548872,55847.77068,337.5197368,1.985902256,99109.12594,0.562941387,0.003393661,2.15232E-05,0.035344828,0.020586356,152,20
D:1| T0: 0.10| T1: 515.00| I0: 400.0| I1: 100.0| WTP: 700000,1,0.096153846,515,700000,1,0.2,400,100,-3876773544,524899953,6364.868519,3558530119,355853011.9,20,53757,2495,1057,1057,0,1057,53757,0,1057,22.52989537,0.582212257,0.582212257,68839.64499,233.5949178,1.376681614,99389.21001,0.692089478,0.002349481,1.58717E-05,0,0.019662556,192,40
D:1| T0: 0.10| T1: 515.00| I0: 400.0| I1: 100.0| WTP: 700000,1,0.096153846,515,700000,1,0.2,400,100,-1298416506,1338977757,11848.84101,705974455.5,70597445.55,4,93037,4177,742,1968,1226,742,93037,1226,1968,246.6805556,3.384259259,9,30919.31944,1130.555556,12.43518519,98616.37963,0.311861299,0.011361959,0.000126125,0.62296748,0.021152875,31,7
D:1| T0: 0.10| T1: 515.00| I0: 400.0| I1: 100.0| WTP: 700000,1,0.096153846,515,700000,1,0.2,400,100,-1591392250,341384587,9462.256,1118279450,111827945,6,71935,3085,865,1572,707,865,71935,707,1572,64.07445008,1.304568528,2.485617597,41714.67174,415.0203046,3.947546531,98747.12521,0.421626689,0.004177007,4.15014E-05,0.449745547,0.021853366,85,12
D:1| T0: 0.10| T1: 515.00| I0: 400.0| I1: 100.0| WTP: 700000,1,0.096153846,515,700000,1,0.2,400,100,-1939928387,2032000160,9355.371822,1472159796,147215979.6,8,73150,3178,1100,1554,454,1100,73150,454,1554,92.42757009,2.453271028,3.478971963,48971.89019,1159.079439,6.039719626,98962.89019,0.493264602,0.011655925,6.23514E-05,0.292149292,0.021244019,62,16
D:1| T0: 0.10| T1: 515.00| I0: 400.0| I1: 100.0| WTP: 700000,1,0.096153846,515,700000,1,0.2,400,100,-1413790736,779488939,12489.99598,789290936.8,78929093.68,4,93354,4072,777,2075,1298,777,93354,1298,2075,235.5654206,3.537383178,9.542056075,42853.29439,1650.556075,13.17757009,98841.71028,0.430234072,0.016589327,0.000133965,0.625542169,0.022227221,31,8
D:1| T0: 0.10| T1: 515.00| I0: 400.0| I1: 100.0| WTP: 700000,1,0.096153846,515,700000,1,0.2,400,100,-2239672851,1449019578,8582.725412,1810536580,181053658,10,63836,2605,1323,1426,103,1323,63836,103,1426,31.75616979,1.155972359,1.253701876,51352.14314,391.6949654,2.549851925,98925.12241,0.518271146,0.003943214,2.73052E-05,0.072230014,0.022338492,144,20
D:1| T0: 0.10| T1: 515.00| I0: 400.0| I1: 100.0| WTP: 700000,1,0.096153846,515,700000,1,0.2,400,100,-3416200355,351952211,5938.138644,3119293423,311929342.3,18,51322,2402,986,986,0,986,51322,0,986,19.52952756,0.458005249,0.458005249,68105.06562,149.6003937,1.106299213,99391.69423,0.684731991,0.001504922,1.29951E-05,0,0.019212034,218,35
D:1| T0: 0.10| T1: 515.00| I0: 400.0| I1: 100.0| WTP: 700000,1,0.096153846,515,700000,1,0.2,400,100,-2919863438,486595046,8150.472167,2512339830,251233983,14,62111,2652,1341,1354,13,1341,62111,13,1354,21.69801325,0.739735099,0.748344371,52773.14636,340.3258278,1.634437086,98988.77682,0.532322118,0.00342594,1.79572E-05,0.009601182,0.021799681,214,28
D:1| T0: 0.10| T1: 515.00| I0: 400.0| I1: 100.0| WTP: 700000,1,0.096153846,515,700000,1,0.2,400,100,-1549979558,296745624,8615.829681,1119188074,111918807.4,6,71072,3121,892,1431,539,892,71072,539,1431,58.30408472,1.245083207,2.04387292,40663.177,528.570348,3.379727685,98828.86989,0.410672842,0.00531724,3.53468E-05,0.376659679,0.020134511,95,12
D:1| T0: 0.10| T1: 515.00| I0: 400.0| I1: 100.0| WTP: 700000,1,0.096153846,515,700000,1,0.2,400,100,-3202329036,1671484194,6905.334775,2857062297,285706229.7,16,54999,2445,1146,1147,1,1146,54999,1,1147,21.37122302,0.643884892,0.643884892,60256.21295,202.6618705,1.472661871,99187.88705,0.607038461,0.00203909,1.65794E-05,0.00087184,0.020854925,199,32
D:1| T0: 0.10| T1: 515.00| I0: 400.0| I1: 100.0| WTP: 700000,1,0.096153846,515,700000,1,0.2,400,100,-1400656959,422157396,12131.22765,794095577.1,79409557.71,4,96591,4263,730,2015,1285,730,96591,1285,2015,303.9602273,4.085227273,11.3125,36754.43182,2040.965909,15.46022727,98801.69318,0.369351593,0.02049057,0.000156608,0.637717122,0.020861157,26,8
D:1| T0: 0.10| T1: 515.00| I0: 400.0| I1: 100.0| WTP: 700000,1,0.096153846,515,700000,1,0.2,400,100,-1402373523,1916599091,12202.70418,792238313.8,79223831.38,4,94779,4116,740,2027,1287,740,94779,1287,2027,278.4787234,3.877659574,10.63297872,35077.48936,1759.478723,14.56382979,98720.57979,0.353014342,0.017671537,0.000147862,0.634928466,0.021386594,27,8
D:1| T0: 0.10| T1: 515.00| I0: 400.0| I1: 100.0| WTP: 700000,1,0.096153846,515,700000,1,0.2,400,100,-1394522098,1005953941,12016.98896,793672650.1,79367265.01,4,96439,4253,739,1996,1257,739,96439,1257,1996,300.8587571,4.107344633,11.1299435,35529.49153,2208.711864,15.31638418,98792.36723,0.357169885,0.022171188,0.000155156,0.629759519,0.020697021,26,8
D:1| T0: 0.10| T1: 515.00| I0: 400.0| I1: 100.0| WTP: 700000,1,0.096153846,515,700000,1,0.2,400,100,-1351808627,1422765615,11418.30215,780893519.3,78089351.93,4,84828,3612,733,1897,1164,733,84828,1164,1897,138.1939394,2.115151515,5.615151515,35722.34242,890.2272727,7.851515152,98624.77576,0.360262854,0.008957915,8.01868E-05,0.613600422,0.022362899,48,8
D:1| T0: 0.10| T1: 515.00| I0: 400.0| I1: 100.0| WTP: 700000,1,0.096153846,515,700000,1,0.2,400,100,-3871251259,699740192,6416.290912,3550436713,355043671.3,20,46056,1982,1066,1066,0,1066,46056,0,1066,14.81594373,0.441383353,0.441383353,70899.33236,161.0375147,1.076201641,99334.97831,0.71327803,0.001620552,1.25566E-05,0,0.023145736,244,40
D:1| T0: 0.10| T1: 515.00| I0: 400.0| I1: 100.0| WTP: 700000,1,0.096153846,515,700000,1,0.2,400,100,-4102934123,240885764,5714.839461,3817192150,381719215,22,49105,2230,949,949,0,949,49105,0,949,16.08597807,0.370455857,0.370455857,70983.65263,172.9567224,0.919792268,99448.92383,0.713304878,0.001739245,1.09979E-05,0,0.019305963,248,43
D:1| T0: 0.10| T1: 515.00| I0: 400.0| I1: 100.0| WTP: 700000,1,0.096153846,515,700000,1,0.2,400,100,-1581553720,2023806564,9122.285902,1125439425,112543942.5,6,76148,3443,814,1515,701,814,76148,701,1515,91.77223427,1.650759219,3.15835141,39103.4859,691.2494577,4.934924078,98828.77007,0.394598588,0.006949047,5.07944E-05,0.462706271,0.019895989,66,12
D:1| T0: 0.10| T1: 515.00| I0: 400.0| I1: 100.0| WTP: 700000,1,0.096153846,515,700000,1,0.2,400,100,-3213434041,1907493879,7168.928681,2854987607,285498760.7,16,54038,2265,1191,1191,0,1191,54038,0,1191,16.67254556,0.549088771,0.549088771,59484.78189,198.3862434,1.253380364,99115.08524,0.599607392,0.0019969,1.4079E-05,0,0.022040046,242,32
D:1| T0: 0.10| T1: 515.00| I0: 400.0| I1: 100.0| WTP: 700000,1,0.096153846,515,700000,1,0.2,400,100,-2006116322,1565815291,10623.41755,1474945445,147494544.5,8,76751,3304,1108,1765,657,1108,76751,657,1765,121.8869048,3.175595238,5.077380952,53762.17857,1840.910714,8.375,99013.96131,0.540680734,0.018513514,8.60053E-05,0.37223796,0.022996443,48,16
D:1| T0: 0.10| T1: 515.00| I0: 400.0| I1: 100.0| WTP: 700000,1,0.096153846,515,700000,1,0.2,400,100,-3832721813,784442364,5671.158898,3549163868,354916386.8,20,47470,2069,942,942,0,942,47470,0,942,14.62048549,0.389579633,0.389579633,67774.22143,148.2717584,0.942569568,99366.53286,0.681660664,0.001491377,1.12006E-05,0,0.019844112,241,40
D:1| T0: 0.10| T1: 515.00| I0: 400.0| I1: 100.0| WTP: 700000,1,0.096153846,515,700000,1,0.2,400,100,-1328696419,206369745,10808.1209,788290373.8,78829037.38,4,89831,3978,651,1795,1144,651,89831,1144,1795,221.8854626,2.748898678,7.735682819,43566.67401,1652.828194,10.59911894,98966.01322,0.437483646,0.016592473,0.000108216,0.637325905,0.019981966,33,8
D:1| T0: 0.10| T1: 515.00| I0: 400.0| I1: 100.0| WTP: 700000,1,0.096153846,515,700000,1,0.2,400,100,-1399854953,2087235992,12154.60119,792124894.1,79212489.41,4,96085,4163,716,2019,1303,716,96085,1303,2019,244.4439252,3.271028037,9.299065421,35212.33178,1958.341121,12.64485981,98751.13084,0.353717758,0.019681409,0.000128441,0.645368995,0.021012645,31,8
D:1| T0: 0.10| T1: 515.00| I0: 400.0| I1: 100.0| WTP: 700000,1,0.096153846,515,700000,1,0.2,400,100,-1874302414,1019092536,8235.211007,1462541864,146254186.4,8,65273,2730,1150,1368,218,1150,65273,218,1368,37.9877095,1.147486034,1.381005587,46684.53073,401.9776536,2.654748603,98910.53184,0.471292259,0.004043971,2.82988E-05,0.159356725,0.020958451,128,16
D:1| T0: 0.10| T1: 515.00| I0: 400.0| I1: 100.0| WTP: 700000,1,0.096153846,515,700000,1,0.2,400,100,-1516146340,1885906113,8126.405233,1109826079,110982607.9,6,62004,2636,1026,1350,324,1026,62004,324,1350,66.26868687,1.884848485,2.525252525,53878.5596,383.0848485,4.612121212,99027.85657,0.543218206,0.00385044,4.82333E-05,0.24,0.021774545,71,12
D:1| T0: 0.10| T1: 515.00| I0: 400.0| I1: 100.0| WTP: 700000,1,0.096153846,515,700000,1,0.2,400,100,-2936427960,2028637200,8350.801954,2518887862,251888786.2,16,65020,2950,1370,1387,17,1370,65020,17,1387,35.74463938,1.133528265,1.150097466,56817.81774,245.2280702,2.479532164,99092.42105,0.572645111,0.002469269,2.70329E-05,0.012256669,0.021332554,147,28
D:1| T0: 0.10| T1: 515.00| I0: 400.0| I1: 100.0| WTP: 700000,1,0.096153846,515,700000,1,0.2,400,100,-1364907365,181476086,11452.03695,792305517.9,79230551.79,4,93283,4189,738,1902,1164,738,93283,1164,1902,253.8792271,3.487922705,9.038647343,41593.16425,2103.729469,12.61352657,98916.02899,0.417604489,0.021124338,0.000128072,0.611987382,0.020389567,30,8
D:1| T0: 0.10| T1: 515.00| I0: 400.0| I1: 100.0| WTP: 700000,1,0.096153846,515,700000,1,0.2,400,100,-1373254053,2097578470,11685.14698,788996704.4,78899670.44,4,89677,4071,709,1941,1232,709,89677,1232,1941,204.465587,2.761133603,7.71659919,39028.49798,1979.57085,10.57894737,98772.87449,0.392509754,0.019896899,0.00010786,0.634724369,0.021644346,36,8
D:1| T0: 0.10| T1: 515.00| I0: 400.0| I1: 100.0| WTP: 700000,1,0.096153846,515,700000,1,0.2,400,100,-1912530852,119646392,8909.355244,1467063090,146706309,8,66475,2877,1148,1480,332,1148,66475,332,1480,80.0372807,2.401315789,3.10745614,54870.66009,920.9802632,5.61622807,99036.08114,0.55261572,0.009258779,5.79312E-05,0.224324324,0.022264009,66,16
D:1| T0: 0.10| T1: 515.00| I0: 400.0| I1: 100.0| WTP: 700000,1,0.096153846,515,700000,1,0.2,400,100,-1370247682,1298895859,11601.48818,790173272.4,79017327.24,4,93306,4115,776,1927,1151,776,93306,1151,1927,241.3113208,3.566037736,8.938679245,37637.36321,1834.410377,12.61320755,98806.64151,0.378343302,0.018428409,0.000128055,0.597301505,0.020652477,31,8
D:1| T0: 0.10| T1: 515.00| I0: 400.0| I1: 100.0| WTP: 700000,1,0.096153846,515,700000,1,0.2,400,100,-1281086956,1489316290,10024.69192,779852360.3,77985236.03,4,79345,3565,660,1665,1005,660,79345,1005,1665,180.0277778,2.492063492,6.44047619,46518.76587,1094.714286,9.075396825,98935.94841,0.468242795,0.010993592,9.26423E-05,0.603603604,0.020984309,36,8
D:1| T0: 0.10| T1: 515.00| I0: 400.0| I1: 100.0| WTP: 700000,1,0.096153846,515,700000,1,0.2,400,100,-1452302520,855602142,13311.86476,786709281.5,78670928.15,4,96804,3861,655,2212,1557,655,96804,1557,2212,211.2857143,2.761904762,9.454545455,32627.65368,1496.593074,12.29004329,98553.32468,0.327857515,0.015056015,0.000124876,0.703887884,0.022850295,33,8
D:1| T0: 0.10| T1: 515.00| I0: 400.0| I1: 100.0| WTP: 700000,1,0.096153846,515,700000,1,0.2,400,100,-1814548709,1438649896,8640.058816,1382545768,138254576.8,8,69989,3087,1053,1435,382,1053,69989,382,1435,62.58995138,1.585089141,2.196110211,45529.67585,577.2155592,3.904376013,98911.89465,0.459269985,0.00580605,4.0552E-05,0.266202091,0.020503222,88,15
D:1| T0: 0.10| T1: 515.00| I0: 400.0| I1: 100.0| WTP: 700000,1,0.096153846,515,700000,1,0.2,400,100,-4877362913,952489126,7233.362173,4515694804,451569480.4,26,53337,2144,1202,1202,0,1202,53337,0,1202,12.62536873,0.410521141,0.410521141,63660.34267,201.3053097,0.993608653,99197.56785,0.641232282,0.002026472,1.18846E-05,0,0.022536373,291,51
D:1| T0: 0.10| T1: 515.00| I0: 400.0| I1: 100.0| WTP: 700000,1,0.096153846,515,700000,1,0.2,400,100,-1139908859,1550779155,10709.2349,604447113.9,60444711.39,4,84344,3554,549,1779,1230,549,84344,1230,1779,228.5606061,2.666666667,8.833333333,31327.41919,1191.515152,11.61616162,98631.5101,0.317057843,0.011953381,0.00011807,0.691399663,0.021092194,29,6
D:1| T0: 0.10| T1: 515.00| I0: 400.0| I1: 100.0| WTP: 700000,1,0.096153846,515,700000,1,0.2,400,100,-4083988205,607323321,7054.669844,3731254713,373125471.3,22,53245,2310,1172,1172,0,1172,53245,0,1172,18.10331633,0.542091837,0.542091837,66922.99171,164.4158163,1.295918367,99270.91135,0.673567386,0.001655459,1.50274E-05,0,0.022011456,224,42
D:1| T0: 0.10| T1: 515.00| I0: 400.0| I1: 100.0| WTP: 700000,1,0.096153846,515,700000,1,0.2,400,100,-1508441244,2103646485,7946.611489,1111110670,111111067,6,62287,2719,864,1320,456,864,62287,456,1320,63.35084428,1.491557223,2.335834897,50390.0863,351.3320826,3.943714822,98970.16135,0.508481349,0.003531716,4.11747E-05,0.345454545,0.021192223,77,12
D:1| T0: 0.10| T1: 515.00| I0: 400.0| I1: 100.0| WTP: 700000,1,0.096153846,515,700000,1,0.2,400,100,-1187916302,258120157,9816.134032,697109600.8,69710960.08,4,86490,3877,765,1630,865,765,86490,865,1630,274.125,4.25,9.079545455,37882.96023,1249.409091,13.42045455,98913.35227,0.38198227,0.012523214,0.000136465,0.530674847,0.018846109,26,7
D:1| T0: 0.10| T1: 515.00| I0: 400.0| I1: 100.0| WTP: 700000,1,0.096153846,515,700000,1,0.2,400,100,-2626944558,1068951401,7490.816471,2252403734,225240373.4,14,63708,2831,1209,1244,35,1209,63708,35,1244,32.46461825,0.936685289,0.969273743,53506.94041,231.726257,2.086592179,99103.25605,0.539290571,0.002332053,2.29615E-05,0.028135048,0.01952659,154,25
D:1| T0: 0.10| T1: 515.00| I0: 400.0| I1: 100.0| WTP: 700000,1,0.096153846,515,700000,1,0.2,400,100,-1881809274,635956235,8361.764757,1463721036,146372103.6,8,64161,2810,1281,1389,108,1281,64161,108,1389,35.946875,1.210416667,1.323958333,49276.47813,507.6072917,2.651041667,98924.76146,0.497201967,0.0051075,2.79771E-05,0.07775378,0.021648665,137,16
D:1| T0: 0.10| T1: 515.00| I0: 400.0| I1: 100.0| WTP: 700000,1,0.096153846,515,700000,1,0.2,400,100,-3431732240,1346693470,6315.438893,3115960295,311596029.5,18,50485,2192,1049,1049,0,1049,50485,0,1049,20.59715994,0.573243647,0.573243647,72347.17489,194.5732436,1.369207773,99431.88191,0.727064481,0.001957023,1.57509E-05,0,0.020778449,192,35
D:1| T0: 0.10| T1: 515.00| I0: 400.0| I1: 100.0| WTP: 700000,1,0.096153846,515,700000,1,0.2,400,100,-1436811384,847102011,12905.10747,791556010.2,79155601.02,4,96205,4107,751,2144,1393,751,96205,1393,2144,273.8465608,3.899470899,11.17989418,35680.60317,1746.306878,15.15873016,98687.22751,0.35874908,0.017551088,0.000153949,0.649720149,0.022285744,27,8
D:1| T0: 0.10| T1: 515.00| I0: 400.0| I1: 100.0| WTP: 700000,1,0.096153846,515,700000,1,0.2,400,100,-1714735427,812083272,11705.96907,1129436974,112943697.4,6,83229,3514,929,1945,1016,929,83229,1016,1945,144.9046053,2.927631579,6.226973684,47286.86513,1685.930921,9.289473684,98850.78289,0.475603073,0.016966441,9.51709E-05,0.522365039,0.023369258,44,12
D:1| T0: 0.10| T1: 515.00| I0: 400.0| I1: 100.0| WTP: 700000,1,0.096153846,515,700000,1,0.2,400,100,-1329200586,2146825809,10784.68261,789966455.8,78996645.58,4,92017,4213,791,1791,1000,791,92017,1000,1791,304.4285714,4.642857143,10.5,37555.85714,1728.714286,15.19642857,98890.13095,0.378191999,0.017334485,0.000154162,0.558347292,0.019463795,24,8
D:1| T0: 0.10| T1: 515.00| I0: 400.0| I1: 100.0| WTP: 700000,1,0.096153846,515,700000,1,0.2,400,100,-1422160518,226186520,12664.04666,788958184.6,78895818.46,4,95343,4023,741,2104,1363,741,95343,1363,2104,260.0829016,3.797927461,10.79274611,37185.46114,1436.834197,14.62176166,98720.09845,0.373754352,0.014436702,0.00014812,0.647813688,0.022067692,28,8
D:1| T0: 0.10| T1: 515.00| I0: 400.0| I1: 100.0| WTP: 700000,1,0.096153846,515,700000,1,0.2,400,100,-1671403457,1110225441,10793.9403,1131706442,113170644.2,6,83782,3620,1052,1793,741,1052,83782,741,1793,109.9299517,2.446859903,4.200483092,41402.09903,1563.417874,6.734299517,98811.07971,0.416752734,0.015736354,6.91861E-05,0.413273843,0.021400778,60,12
D:1| T0: 0.10| T1: 515.00| I0: 400.0| I1: 100.0| WTP: 700000,1,0.096153846,515,700000,1,0.2,400,100,-1563806166,1190767082,8714.77514,1128067409,112806740.9,6,77773,3542,777,1447,670,777,77773,670,1447,93.10782241,1.56448203,2.957716702,39348.08879,876.0634249,4.604651163,98908.65962,0.396589721,0.008805308,4.72575E-05,0.463026952,0.018605429,68,12
D:1| T0: 0.10| T1: 515.00| I0: 400.0| I1: 100.0| WTP: 700000,1,0.096153846,515,700000,1,0.2,400,100,-2212943786,2108234095,8077.766464,1809055463,180905546.3,10,60123,2523,1284,1342,58,1284,60123,58,1342,33.97516199,1.205183585,1.264578834,56197.4622,396.7645788,2.660907127,99043.5432,0.566638564,0.003991683,2.85197E-05,0.043219076,0.022320909,133,20
D:1| T0: 0.10| T1: 515.00| I0: 400.0| I1: 100.0| WTP: 700000,1,0.096153846,515,700000,1,0.2,400,100,-1427185703,465621985,12659.72959,794199223.5,79419922.35,4,95321,4277,739,2103,1364,739,95321,1364,2103,254.4666667,3.428571429,9.880952381,29536.09524,1563.871429,13.39047619,98550.21429,0.297670185,0.015724434,0.000136115,0.648597242,0.022062295,30,8
D:1| T0: 0.10| T1: 515.00| I0: 400.0| I1: 100.0| WTP: 700000,1,0.096153846,515,700000,1,0.2,400,100,-2048856581,1487072553,8104.989387,1643607111,164360711.1,10,66117,2996,1241,1346,105,1241,66117,105,1346,47.94501279,1.410485934,1.539641944,53089.45908,303.6943734,3.121483376,99049.47698,0.53522799,0.00305626,3.32653E-05,0.078066914,0.020343649,112,18
D:1| T0: 0.10| T1: 515.00| I0: 400.0| I1: 100.0| WTP: 700000,1,0.096153846,515,700000,1,0.2,400,100,-1585188215,1213733847,9300.804262,1120148002,112014800.2,6,70532,3040,894,1545,651,894,70532,651,1545,119.8707692,2.618461538,4.593846154,51998.73538,921.44,7.335384615,99000.21846,0.523719141,0.009257401,7.54013E-05,0.421359223,0.021904951,47,12
D:1| T0: 0.10| T1: 515.00| I0: 400.0| I1: 100.0| WTP: 700000,1,0.096153846,515,700000,1,0.2,400,100,-1284823097,2003658337,10197.28708,774958743.2,77495874.32,4,78538,3342,749,1694,945,749,78538,945,1694,140.7766667,2.353333333,5.473333333,47004.39,1069.653333,7.96,98919.34667,0.473175567,0.010748333,8.18436E-05,0.55785124,0.021570001,43,8
D:1| T0: 0.10| T1: 515.00| I0: 400.0| I1: 100.0| WTP: 700000,1,0.096153846,515,700000,1,0.2,400,100,-4778709960,1170868072,6916.629567,4432878482,443287848.2,26,55914,2449,1149,1149,0,1149,55914,0,1149,16.96513002,0.476359338,0.476359338,68136.97104,192.7647754,1.167257683,99358.97813,0.68517141,0.001940061,1.36519E-05,0,0.020549415,242,50
D:1| T0: 0.10| T1: 515.00| I0: 400.0| I1: 100.0| WTP: 700000,1,0.096153846,515,700000,1,0.2,400,100,-1248387758,569919592,10946.42582,701066467.4,70106646.74,4,90927,4036,754,1818,1064,754,90927,1064,1818,253.4723618,3.698492462,8.979899497,30524.05528,1191.648241,12.79396985,98700.54774,0.30818856,0.011961138,0.000129833,0.585258526,0.019994061,29,7
D:1| T0: 0.10| T1: 515.00| I0: 400.0| I1: 100.0| WTP: 700000,1,0.096153846,515,700000,1,0.2,400,100,-1536052886,1833180623,8233.200098,1124392881,112439288.1,6,73609,3467,1010,1367,357,1010,73609,357,1367,94.02031603,2.119638826,2.898419865,46665.58916,775.4740406,5.162528217,99053.39278,0.469996077,0.007789716,5.39094E-05,0.261155816,0.018571099,64,12
D:1| T0: 0.10| T1: 515.00| I0: 400.0| I1: 100.0| WTP: 700000,1,0.096153846,515,700000,1,0.2,400,100,-1449906411,1123666637,13169.32017,791440402.2,79144040.22,4,93680,4045,755,2188,1433,755,93680,1433,2188,305.5621302,4.384615385,12.77514793,40612.14201,1667.100592,17.24260355,98739.3432,0.408409567,0.01674863,0.000174963,0.654936015,0.023356106,25,8
D:1| T0: 0.10| T1: 515.00| I0: 400.0| I1: 100.0| WTP: 700000,1,0.096153846,515,700000,1,0.2,400,100,-1704109548,1682024981,11412.92154,1133463471,113346347.1,6,89643,3842,764,1896,1132,764,89643,1132,1896,188.3951613,2.943548387,7.475806452,45053.7621,2954.197581,10.55241935,98945.47581,0.452364142,0.029691437,0.000107839,0.597046414,0.021150564,35,12
D:1| T0: 0.10| T1: 515.00| I0: 400.0| I1: 100.0| WTP: 700000,1,0.096153846,515,700000,1,0.2,400,100,-1614347386,1687523543,9853.780441,1121658364,112165836.4,6,73916,3191,910,1637,727,910,73916,727,1637,121.412844,2.660550459,4.856269113,51852.32722,863.6544343,7.617737003,98992.85015,0.521887287,0.008680329,7.82927E-05,0.44410507,0.02214736,47,12
D:1| T0: 0.10| T1: 515.00| I0: 400.0| I1: 100.0| WTP: 700000,1,0.096153846,515,700000,1,0.2,400,100,-1345635842,178034412,11156.26963,787822360.1,78782236.01,4,88629,4029,653,1853,1200,653,88629,1200,1853,261.5811518,3.287958115,9.523560209,46469.73822,1635.806283,12.93717277,98981.01571,0.466733283,0.016413064,0.000131658,0.647598489,0.020907378,28,8
D:1| T0: 0.10| T1: 515.00| I0: 400.0| I1: 100.0| WTP: 700000,1,0.096153846,515,700000,1,0.2,400,100,-1343632261,739490003,11055.20661,790871930.9,79087193.09,4,91593,4084,689,1836,1147,689,91593,1147,1836,260.4773869,3.376884422,9.085427136,41796.68844,1289.628141,12.54271357,98924.0804,0.419874794,0.012941805,0.00012734,0.624727669,0.0200452,29,8
D:1| T0: 0.10| T1: 515.00| I0: 400.0| I1: 100.0| WTP: 700000,1,0.096153846,515,700000,1,0.2,400,100,-1553233087,178482706,10405.85626,1032940274,103294027.4,6,74832,3109,748,1729,981,748,74832,981,1729,105.8054054,1.886486486,4.510810811,44486.69189,865.7702703,6.52972973,98771.49189,0.44878558,0.008704529,6.73512E-05,0.567379988,0.023105397,53,11
D:1| T0: 0.10| T1: 515.00| I0: 400.0| I1: 100.0| WTP: 700000,1,0.096153846,515,700000,1,0.2,400,100,-1531958326,1919366370,9979.550375,1032980808,103298080.8,6,71648,3083,914,1658,744,914,71648,744,1658,65.85016835,1.427609428,2.668350168,41756.26263,416.1902357,4.19023569,98679.4899,0.422029262,0.004190934,4.35861E-05,0.448733414,0.023140911,85,11
D:1| T0: 0.10| T1: 515.00| I0: 400.0| I1: 100.0| WTP: 700000,1,0.096153846,515,700000,1,0.2,400,100,-1350194507,1819796913,11110.46298,794671358.1,79467135.81,4,96556,4424,693,1845,1152,693,96556,1152,1845,305.4971751,3.858757062,10.31638418,39525.46893,2242.305085,14.22033898,98959.40113,0.396708982,0.022489033,0.000143838,0.624390244,0.019108082,26,8
D:1| T0: 0.10| T1: 515.00| I0: 400.0| I1: 100.0| WTP: 700000,1,0.096153846,515,700000,1,0.2,400,100,-1687407474,1866591913,11129.97502,1130908723,113090872.3,6,83745,3646,1088,1849,761,1088,83745,761,1849,108.7070218,2.520581114,4.319612591,44543.16949,1673.42615,6.96125908,98850.49395,0.448054997,0.016843643,7.16161E-05,0.411573824,0.02207893,59,12
D:1| T0: 0.10| T1: 515.00| I0: 400.0| I1: 100.0| WTP: 700000,1,0.096153846,515,700000,1,0.2,400,100,-1283167706,1219425989,11643.03443,701015984.6,70101598.46,4,90737,4104,792,1934,1142,792,90737,1142,1934,271.2054054,4.194594595,10.29189189,32771.8973,1265.313514,14.56216216,98674.60541,0.330799664,0.012702179,0.000148043,0.590486039,0.021314348,27,7
D:1| T0: 0.10| T1: 515.00| I0: 400.0| I1: 100.0| WTP: 700000,1,0.096153846,515,700000,1,0.2,400,100,-1375186767,502409586,11691.69309,790602112.6,79060211.26,4,94589,4132,740,1942,1202,740,94589,1202,1942,234.9086758,3.292237443,8.716894977,35365.22374,1740.424658,12.12328767,98775.38813,0.355504956,0.017480772,0.000123025,0.618949537,0.020530929,32,8
D:1| T0: 0.10| T1: 515.00| I0: 400.0| I1: 100.0| WTP: 700000,1,0.096153846,515,700000,1,0.2,400,100,-1298231005,1405887957,10390.66199,778697905.8,77869790.58,4,81475,3596,731,1726,995,731,81475,995,1726,190.7467811,3.017167382,7.253218884,47510.91416,1061.261803,10.39484979,98959.02575,0.477923174,0.010656147,0.000105861,0.576477404,0.021184412,34,8
D:1| T0: 0.10| T1: 515.00| I0: 400.0| I1: 100.0| WTP: 700000,1,0.096153846,515,700000,1,0.2,400,100,-1310750888,283033753,10772.86618,772107578.5,77210757.85,4,78441,3243,736,1790,1054,736,78441,1054,1790,159.4703557,2.754940711,6.865612648,46613.99605,821.6679842,9.794466403,98849.01581,0.469582242,0.008255853,0.000100309,0.588826816,0.022819699,37,8
D:1| T0: 0.10| T1: 515.00| I0: 400.0| I1: 100.0| WTP: 700000,1,0.096153846,515,700000,1,0.2,400,100,-1631707308,1083157068,10178.47526,1122783545,112278354.5,6,75552,3236,1104,1691,587,1104,75552,587,1691,82.34836066,2.096311475,3.266393443,42607.33607,785.3504098,5.540983607,98773.31967,0.429969257,0.007901423,5.76564E-05,0.347131875,0.022381936,70,12
D:1| T0: 0.10| T1: 515.00| I0: 400.0| I1: 100.0| WTP: 700000,1,0.096153846,515,700000,1,0.2,400,100,-1575601853,1988704626,9315.465025,1109828602,110982860.2,6,64252,2684,1092,1548,456,1092,64252,456,1548,52.1364366,1.566613162,2.290529695,49615.64045,264.8988764,4.048154093,98808.39647,0.501301032,0.002667251,4.26434E-05,0.294573643,0.024092635,89,12
D:1| T0: 0.10| T1: 515.00| I0: 400.0| I1: 100.0| WTP: 700000,1,0.096153846,515,700000,1,0.2,400,100,-1235553535,884761309,10818.19661,694643704,69464370.4,4,83967,3749,680,1797,1117,680,83967,1117,1797,191.8065844,2.703703704,7.279835391,29886.15226,898.345679,10.08230453,98566.96708,0.302686556,0.009023984,0.000102489,0.621591541,0.02140152,35,7
D:1| T0: 0.10| T1: 515.00| I0: 400.0| I1: 100.0| WTP: 700000,1,0.096153846,515,700000,1,0.2,400,100,-2279905245,533485933,7415.176021,1909146444,190914644.4,12,65699,3162,1217,1231,14,1217,65699,14,1231,47.74605103,1.286755772,1.303766707,57249.90522,216.5917375,2.760631835,99202.00851,0.576363907,0.002179364,2.98923E-05,0.011372868,0.018737537,118,21
D:1| T0: 0.10| T1: 515.00| I0: 400.0| I1: 100.0| WTP: 700000,1,0.096153846,515,700000,1,0.2,400,100,-2061748667,632196071,8463.701177,1638563608,163856360.8,10,64158,2773,1321,1406,85,1321,64158,85,1406,47.46463245,1.632454924,1.74479889,56497.73509,230.0069348,3.585298197,99065.27046,0.569500707,0.002315487,3.80399E-05,0.060455192,0.021914648,103,18
D:1| T0: 0.10| T1: 515.00| I0: 400.0| I1: 100.0| WTP: 700000,1,0.096153846,515,700000,1,0.2,400,100,-1367451527,393400457,11482.34108,793334472.9,79333447.29,4,94442,4189,581,1907,1326,581,94442,1326,1907,266.935,2.815,9.385,40691.735,1473.695,12.275,98891.985,0.408448052,0.014792933,0.000124897,0.695332984,0.020192287,29,8
D:1| T0: 0.10| T1: 515.00| I0: 400.0| I1: 100.0| WTP: 700000,1,0.096153846,515,700000,1,0.2,400,100,-1308958325,398973227,10671.83767,775366441.6,77536644.16,4,79252,3307,687,1773,1086,687,79252,1086,1773,156.6273063,2.420664207,6.383763838,44968.54613,876.2804428,8.915129151,98833.99631,0.453017302,0.00880499,9.123E-05,0.612521151,0.02237224,39,8
D:1| T0: 0.10| T1: 515.00| I0: 400.0| I1: 100.0| WTP: 700000,1,0.096153846,515,700000,1,0.2,400,100,-1632435487,1402256491,10019.10245,1131480364,113148036.4,6,81489,3659,898,1664,766,898,81489,766,1664,145.1238095,2.720634921,5.126984127,46008.50794,1633.187302,7.984126984,98967.87302,0.462769249,0.016412544,8.17556E-05,0.460336538,0.020419934,45,12
D:1| T0: 0.10| T1: 515.00| I0: 400.0| I1: 100.0| WTP: 700000,1,0.096153846,515,700000,1,0.2,400,100,-1417702314,2102527413,12585.78621,788413003.6,78841300.36,4,91625,3900,698,2091,1393,698,91625,1393,2091,198.4365079,2.662698413,8.154761905,39848.72619,2102.353175,10.92063492,98734.33333,0.400390378,0.021147796,0.000111369,0.666188427,0.022821282,36,8
D:1| T0: 0.10| T1: 515.00| I0: 400.0| I1: 100.0| WTP: 700000,1,0.096153846,515,700000,1,0.2,400,100,-1376646080,1748031099,11822.1405,785539054.7,78553905.47,4,91504,3881,672,1964,1292,672,91504,1292,1964,205.0805085,2.737288136,8.177966102,38983.5339,2100.516949,11.00847458,98797.72458,0.39176593,0.021109395,0.000112304,0.657841141,0.021464012,34,8
D:1| T0: 0.10| T1: 515.00| I0: 400.0| I1: 100.0| WTP: 700000,1,0.096153846,515,700000,1,0.2,400,100,-1773041693,1946754629,7917.645678,1377159409,137715940.9,8,62689,2791,1079,1315,236,1079,62689,236,1315,50.22457627,1.357344633,1.676553672,50949.50282,339.2612994,3.216101695,98999.26836,0.513942736,0.003411154,3.39925E-05,0.179467681,0.020976567,102,15
D:1| T0: 0.10| T1: 515.00| I0: 400.0| I1: 100.0| WTP: 700000,1,0.096153846,515,700000,1,0.2,400,100,-1513576986,2097712204,8013.258541,1112914059,111291405.9,6,64921,2912,1013,1331,318,1013,64921,318,1331,62.7920434,1.638336347,2.198915009,51456.95118,366.3562387,4.048824593,99031.05606,0.518807863,0.003683309,4.25992E-05,0.238918107,0.020501841,79,12
D:1| T0: 0.10| T1: 515.00| I0: 400.0| I1: 100.0| WTP: 700000,1,0.096153846,515,700000,1,0.2,400,100,-1885383761,1198827119,8427.924174,1463987552,146398755.2,8,61458,2695,1235,1400,165,1235,61458,165,1400,46.82479784,1.517520216,1.735849057,54867.54582,532.3989218,3.396226415,98998.42453,0.553175636,0.005355092,3.57125E-05,0.117857143,0.022779785,106,16
D:1| T0: 0.10| T1: 515.00| I0: 400.0| I1: 100.0| WTP: 700000,1,0.096153846,515,700000,1,0.2,400,100,-4169410184,109253198,5513.071063,3893756631,389375663.1,22,41628,1723,916,916,0,916,41628,0,916,12.41176471,0.37,0.37,74460.47529,171.8994118,0.905294118,99445.58235,0.748360815,0.001728275,1.08196E-05,0,0.022004949,242,44
D:1| T0: 0.10| T1: 515.00| I0: 400.0| I1: 100.0| WTP: 700000,1,0.096153846,515,700000,1,0.2,400,100,-2799123084,314481292,7537.107589,2422267705,242226770.5,16,59936,2590,1247,1252,5,1247,59936,5,1252,29.35541045,0.972014925,0.975746269,59849.70149,166.6669776,2.145522388,99168.05597,0.602840642,0.001678045,2.34363E-05,0.00399361,0.020888948,154,27
D:1| T0: 0.10| T1: 515.00| I0: 400.0| I1: 125.0| WTP: 1000000,1,0.096153846,515,1000000,1,0.2,400,125,-3509396428,1178568022,7740.916654,3122350595,312235059.5,20,57503,2468,1286,1286,0,1286,57503,0,1286,21.39583333,0.720138889,0.720138889,60565.55486,204.6277778,1.611111111,99122.01528,0.61033981,0.002060709,1.7964E-05,0,0.022364051,205,35
D:1| T0: 0.10| T1: 515.00| I0: 400.0| I1: 125.0| WTP: 1000000,1,0.096153846,515,1000000,1,0.2,400,125,-1383520751,2029998696,11830.2407,792008715.4,79200871.54,4,94945,4164,648,1965,1317,648,94945,1317,1965,230.8502203,2.753303965,8.524229075,35657.04846,1414.511013,11.37444934,98757.2467,0.358235323,0.014213002,0.00011567,0.670229008,0.020696193,33,8
D:1| T0: 0.10| T1: 515.00| I0: 400.0| I1: 125.0| WTP: 1000000,1,0.096153846,515,1000000,1,0.2,400,125,-1413972414,776062361,12590.52504,784446162.6,78444616.26,4,92374,3822,796,2092,1296,796,92374,1296,2092,176.2304833,2.862453532,7.643122677,39223.80669,2136.762082,10.60594796,98727.87361,0.394065151,0.021505698,0.000108069,0.619502868,0.022647065,38,8
D:1| T0: 0.10| T1: 515.00| I0: 400.0| I1: 125.0| WTP: 1000000,1,0.096153846,515,1000000,1,0.2,400,125,-3523206202,1813046880,7898.97875,3128257264,312825726.4,18,59638,2685,1306,1312,6,1306,59638,6,1312,25.33701251,0.768211921,0.771891096,59221.35467,277.602649,1.746136865,99105.06107,0.596855938,0.002795147,1.93769E-05,0.004573171,0.021999396,195,35
D:1| T0: 0.10| T1: 515.00| I0: 400.0| I1: 125.0| WTP: 1000000,1,0.096153846,515,1000000,1,0.2,400,125,-2039275681,2032407216,7924.62783,1643044289,164304428.9,10,66947,3018,1211,1316,105,1211,66947,105,1316,47.56521739,1.378516624,1.506393862,51657.73913,300.7404092,3.039641944,99076.44246,0.520601062,0.003024904,3.24882E-05,0.079787234,0.019657341,112,18
D:1| T0: 0.10| T1: 515.00| I0: 400.0| I1: 125.0| WTP: 1000000,1,0.096153846,515,1000000,1,0.2,400,125,-5001959371,1507873352,6318.851429,4686016800,468601680,28,46405,1925,1050,1050,0,1050,46405,0,1050,9.401468788,0.272133823,0.272133823,70663.61689,136.8376173,0.700122399,99343.68992,0.710781522,0.001377508,8.60961E-06,0,0.022626872,350,53
D:1| T0: 0.10| T1: 515.00| I0: 400.0| I1: 125.0| WTP: 1000000,1,0.096153846,515,1000000,1,0.2,400,125,-2680482142,1855899401,6965.785781,2332192853,233219285.3,14,54378,2400,1157,1157,0,1157,54378,0,1157,28.49152542,0.891713748,0.891713748,67459.24482,191.4623352,1.979284369,99323.12335,0.67855066,0.001926395,2.1895E-05,0,0.02127777,152,26
D:1| T0: 0.10| T1: 515.00| I0: 400.0| I1: 125.0| WTP: 1000000,1,0.096153846,515,1000000,1,0.2,400,125,-1281892609,1819459251,10172.70203,773257507.6,77325750.76,4,76418,3302,742,1690,948,742,76418,948,1690,125.5731707,2.131097561,4.987804878,45077.6372,836.4054878,7.237804878,98842.49695,0.454341786,0.008406084,7.45449E-05,0.560946746,0.022116077,47,8
D:1| T0: 0.10| T1: 515.00| I0: 400.0| I1: 125.0| WTP: 1000000,1,0.096153846,515,1000000,1,0.2,400,125,-2717295176,909791748,7580.35868,2338277242,233827724.2,18,57207,2628,1259,1259,0,1259,57207,0,1259,31.84716981,0.988679245,0.988679245,67679.96604,175.2009434,2.186792453,99311.66415,0.680728898,0.001763782,2.38824E-05,0,0.022007796,152,26
D:1| T0: 0.10| T1: 515.00| I0: 400.0| I1: 125.0| WTP: 1000000,1,0.096153846,515,1000000,1,0.2,400,125,-1476838419,1339092841,9063.685199,1023654159,102365415.9,6,65749,2721,812,1506,694,812,65749,694,1506,89.15915119,2.068965517,3.888594164,51412.98674,627.1883289,6.031830239,98925.66048,0.518515701,0.006302596,6.17803E-05,0.460823373,0.02290564,54,11
D:1| T0: 0.10| T1: 515.00| I0: 400.0| I1: 125.0| WTP: 1000000,1,0.096153846,515,1000000,1,0.2,400,125,-1403507233,1365866345,12208.93929,793060268.4,79306026.84,4,95855,4267,715,2028,1313,715,95855,1313,2028,219.3112033,2.887966805,8.298755187,32980.77593,1247.344398,11.24481328,98667.9917,0.331489792,0.0125414,0.000114431,0.647435897,0.021156956,35,8
D:1| T0: 0.10| T1: 515.00| I0: 400.0| I1: 125.0| WTP: 1000000,1,0.096153846,515,1000000,1,0.2,400,125,-1572425539,825453433,8912.60515,1126795282,112679528.2,6,75128,3348,899,1480,581,899,75128,581,1480,106.8044554,2.094059406,3.514851485,45192.02475,946.3836634,5.747524752,98971.0198,0.455215944,0.009507945,5.91903E-05,0.392567568,0.019699712,58,12
D:1| T0: 0.10| T1: 515.00| I0: 400.0| I1: 125.0| WTP: 1000000,1,0.096153846,515,1000000,1,0.2,400,125,-1392680308,939711378,11974.9893,793930842.6,79393084.26,4,96951,4287,640,1989,1349,640,96951,1349,1989,232.7434783,2.726086957,8.539130435,32911.42174,1656.417391,11.30434783,98717.07391,0.330585224,0.016642516,0.000114881,0.678230266,0.020515518,33,8
D:1| T0: 0.10| T1: 515.00| I0: 400.0| I1: 125.0| WTP: 1000000,1,0.096153846,515,1000000,1,0.2,400,125,-1894952660,638950699,8430.951515,1473405084,147340508.4,8,70609,3151,1087,1400,313,1087,70609,313,1400,69.30204778,1.747440273,2.262798635,45785.31399,760.7542662,4.126279863,98958.57167,0.461567767,0.007648648,4.26643E-05,0.223571429,0.019827501,84,16
D:1| T0: 0.10| T1: 515.00| I0: 400.0| I1: 125.0| WTP: 1000000,1,0.096153846,515,1000000,1,0.2,400,125,-2044818313,938699148,8056.404785,1641998074,164199807.4,10,65703,2965,1259,1338,79,1259,65703,79,1338,46.52101911,1.405095541,1.496815287,53485.68408,280.8509554,3.100636943,99071.22038,0.53914998,0.002826195,3.32647E-05,0.059043348,0.020364367,113,18
D:1| T0: 0.10| T1: 515.00| I0: 400.0| I1: 125.0| WTP: 1000000,1,0.096153846,515,1000000,1,0.2,400,125,-3884003155,121790188,6438.102574,3562098026,356209802.6,20,56679,2623,1069,1069,0,1069,56679,0,1069,20.35390428,0.498110831,0.498110831,61657.86713,256.8457179,1.176322418,99283.08186,0.620499608,0.002583134,1.35271E-05,0,0.018860601,226,40
D:1| T0: 0.10| T1: 515.00| I0: 400.0| I1: 125.0| WTP: 1000000,1,0.096153846,515,1000000,1,0.2,400,125,-1532557605,1331335240,11366.86569,964214320.1,96421432.01,6,90780,3925,725,1888,1163,725,90780,1163,1888,215.2085106,2.953191489,7.85106383,42999.01702,2546.085106,10.92765957,98927.48085,0.43176248,0.025577976,0.000111758,0.615995763,0.020797532,34,10
D:1| T0: 0.10| T1: 515.00| I0: 400.0| I1: 125.0| WTP: 1000000,1,0.096153846,515,1000000,1,0.2,400,125,-1344883793,470935411,12850.55476,702356055.6,70235605.56,4,93723,3995,728,2135,1407,728,93723,1407,2135,299.1823529,4.194117647,12.37647059,34795.56471,1426.711765,16.67058824,98640.10588,0.350554058,0.014330058,0.000169245,0.659016393,0.022779894,25,7
D:1| T0: 0.10| T1: 515.00| I0: 400.0| I1: 125.0| WTP: 1000000,1,0.096153846,515,1000000,1,0.2,400,125,-1605330363,823434397,9785.986436,1116031041,111603104.1,6,69486,2888,1189,1626,437,1189,69486,437,1626,59.44059406,1.836633663,2.537953795,46806.24092,586.9438944,4.491749175,98788.86469,0.472555394,0.005908499,4.67626E-05,0.268757688,0.023400734,87,12
D:1| T0: 0.10| T1: 515.00| I0: 400.0| I1: 125.0| WTP: 1000000,1,0.096153846,515,1000000,1,0.2,400,125,-2313732233,493045351,6629.680326,1982248216,198224821.6,14,56827,2538,1101,1101,0,1101,56827,0,1101,32.08045977,0.961337513,0.961337513,63440.0512,151.7105538,2.091954023,99306.13271,0.638199576,0.001526254,2.31122E-05,0,0.019375616,137,22
D:1| T0: 0.10| T1: 515.00| I0: 400.0| I1: 125.0| WTP: 1000000,1,0.096153846,515,1000000,1,0.2,400,125,-1755128038,1700216563,7439.205727,1383167752,138316775.2,8,65454,3003,988,1235,247,988,65454,247,1235,94.81204819,2.262650602,2.83373494,57538.34458,847.0433735,5.207228916,99240.98795,0.578572346,0.008501784,5.37672E-05,0.2,0.018868213,60,15
D:1| T0: 0.10| T1: 515.00| I0: 400.0| I1: 125.0| WTP: 1000000,1,0.096153846,515,1000000,1,0.2,400,125,-1668319922,1744119059,7575.336817,1289553081,128955308.1,8,63490,2908,1114,1258,144,1114,63490,144,1258,52.43004418,1.449189985,1.653902798,51789.63918,257.9690722,3.282768778,99069.67894,0.522168542,0.002594146,3.51063E-05,0.114467409,0.019814144,97,14
D:1| T0: 0.10| T1: 515.00| I0: 400.0| I1: 125.0| WTP: 1000000,1,0.096153846,515,1000000,1,0.2,400,125,-2532250973,2036906360,7447.180971,2159891924,215989192.4,12,58820,2606,1221,1237,16,1221,58820,16,1237,22.45780591,0.695499297,0.708157525,53542.94726,287.1420534,1.565400844,99046.69339,0.540002808,0.00288975,1.73805E-05,0.012934519,0.021030262,203,24
D:1| T0: 0.10| T1: 515.00| I0: 400.0| I1: 125.0| WTP: 1000000,1,0.096153846,515,1000000,1,0.2,400,125,-1877769364,809704121,8171.308232,1469203953,146920395.3,8,67694,3069,1009,1357,348,1009,67694,348,1357,91.42925659,2.278177458,3.09352518,55503.19664,838.7889688,5.51558753,99149.98561,0.558406623,0.008424791,5.69833E-05,0.256448047,0.02004609,59,16
D:1| T0: 0.10| T1: 515.00| I0: 400.0| I1: 125.0| WTP: 1000000,1,0.096153846,515,1000000,1,0.2,400,125,-1700234090,1219866412,11258.06692,1137330744,113733074.4,6,89654,3951,801,1870,1069,801,89654,1069,1870,186.7528517,2.923954373,6.950570342,40127.79468,2798.513308,9.992395437,98855.30798,0.403365863,0.028130056,0.000102118,0.571657754,0.020857965,38,12
D:1| T0: 0.10| T1: 515.00| I0: 400.0| I1: 125.0| WTP: 1000000,1,0.096153846,515,1000000,1,0.2,400,125,-4091675285,843498920,7151.689349,3734090818,373409081.8,26,55077,2378,1188,1188,0,1188,55077,0,1188,20.15117057,0.575250836,0.575250836,68580.33779,177.5591973,1.384615385,99343.96856,0.689665028,0.00178725,1.59772E-05,0,0.021552037,214,42
D:1| T0: 0.10| T1: 515.00| I0: 400.0| I1: 125.0| WTP: 1000000,1,0.096153846,515,1000000,1,0.2,400,125,-1981660987,107351963,10326.07949,1465357012,146535701.2,8,71840,2807,1295,1716,421,1295,71840,421,1716,48.4813278,1.64868603,2.215767635,44824.26694,690.9377593,3.987551867,98718.40387,0.452727074,0.006959652,4.19493E-05,0.245337995,0.023886414,104,16
D:1| T0: 0.10| T1: 515.00| I0: 400.0| I1: 125.0| WTP: 1000000,1,0.096153846,515,1000000,1,0.2,400,125,-1897380583,773789021,8608.970154,1466932075,146693207.5,8,69060,3016,1080,1430,350,1080,69060,350,1430,63.23529412,1.74567474,2.335640138,47481.24913,811.6816609,4.223183391,98946.90657,0.478726033,0.008161808,4.36655E-05,0.244755245,0.020706632,83,16
D:1| T0: 0.10| T1: 515.00| I0: 400.0| I1: 125.0| WTP: 1000000,1,0.096153846,515,1000000,1,0.2,400,125,-1618199969,850936611,10020.55179,1117172380,111717238,6,69867,2894,1127,1665,538,1127,69867,538,1665,57.07142857,1.641304348,2.448757764,44639.63509,575.613354,4.187888199,98709.67081,0.451028243,0.005796502,4.36564E-05,0.323123123,0.023830993,92,12
D:1| T0: 0.10| T1: 515.00| I0: 400.0| I1: 125.0| WTP: 1000000,1,0.096153846,515,1000000,1,0.2,400,125,-1568445633,1701318364,8982.293752,1119330945,111933094.5,6,70496,3025,1075,1492,417,1075,70496,417,1492,60.82250396,1.580031696,2.228209192,42821.13154,470.340729,3.93977813,98808.25674,0.43253079,0.004732987,4.09292E-05,0.279490617,0.021164321,91,12
D:1| T0: 0.10| T1: 515.00| I0: 400.0| I1: 125.0| WTP: 1000000,1,0.096153846,515,1000000,1,0.2,400,125,-3525584487,778708269,6394.292181,3205869878,320586987.8,18,50300,2259,1062,1062,0,1062,50300,0,1062,18.20770202,0.517676768,0.517676768,62806.15278,245.5625,1.193181818,99223.0202,0.632489342,0.002469286,1.34719E-05,0,0.02111332,227,36
D:1| T0: 0.10| T1: 515.00| I0: 400.0| I1: 125.0| WTP: 1000000,1,0.096153846,515,1000000,1,0.2,400,125,-2491144927,1391938506,8360.408284,2073124512,207312451.2,14,59257,2493,1364,1389,25,1364,59257,25,1389,34.9379085,1.275599129,1.300653595,59129.40523,229.8877996,2.784313725,99048.55773,0.596309364,0.002315,3.0166E-05,0.01799856,0.023440269,132,23
D:1| T0: 0.10| T1: 515.00| I0: 400.0| I1: 125.0| WTP: 1000000,1,0.096153846,515,1000000,1,0.2,400,125,-3676533402,43418681,6085.022284,3372282287,337228228.7,20,46238,1987,1011,1011,0,1011,46238,0,1011,15.68372093,0.465780731,0.465780731,71937.45714,172.4259136,1.151495017,99396.59468,0.723284964,0.001734203,1.34944E-05,0,0.021865133,215,38
D:1| T0: 0.10| T1: 515.00| I0: 400.0| I1: 125.0| WTP: 1000000,1,0.096153846,515,1000000,1,0.2,400,125,-1417547193,817384966,12692.12962,782940711.9,78294071.19,4,90602,3756,789,2109,1320,789,90602,1320,2109,252.4456522,4.195652174,11.2826087,40878.88587,1341.407609,15.5923913,98743.14674,0.411496812,0.013472938,0.000158227,0.625889047,0.023277632,27,8
D:1| T0: 0.10| T1: 515.00| I0: 400.0| I1: 125.0| WTP: 1000000,1,0.096153846,515,1000000,1,0.2,400,125,-1329680087,762053968,10908.90403,784234885.7,78423488.57,4,89409,3903,706,1812,1106,706,89409,1106,1812,233.9460784,3.362745098,8.730392157,42878.75,1366.02451,12.18627451,98936.04902,0.430944848,0.013709946,0.000123882,0.610375276,0.020266416,30,8
D:1| T0: 0.10| T1: 515.00| I0: 400.0| I1: 125.0| WTP: 1000000,1,0.096153846,515,1000000,1,0.2,400,125,-1875569597,1692506311,8129.27901,1469105647,146910564.7,8,68062,3054,1210,1350,140,1210,68062,140,1350,47.73081761,1.38490566,1.553459119,47667.30189,568.436478,3.059119497,98987.66289,0.480621105,0.005717023,3.23789E-05,0.103703704,0.019835148,113,16
D:1| T0: 0.10| T1: 515.00| I0: 400.0| I1: 125.0| WTP: 1000000,1,0.096153846,515,1000000,1,0.2,400,125,-3010642777,1037620300,6681.459416,2676569806,267656980.6,16,51618,2155,1110,1110,0,1110,51618,0,1110,22.50423012,0.736886633,0.736886633,69539.22335,182.965313,1.668358714,99357.38494,0.69929811,0.001840729,1.88704E-05,0,0.021505376,169,30
D:1| T0: 0.10| T1: 515.00| I0: 400.0| I1: 125.0| WTP: 1000000,1,0.096153846,515,1000000,1,0.2,400,125,-2726144237,301400999,7778.205654,2337233955,233723395.5,14,61823,2676,1292,1292,0,1292,61823,0,1292,31.93895349,1.062015504,1.062015504,58362.11822,248.9253876,2.310077519,99150.75097,0.587935185,0.002505054,2.51768E-05,0,0.020898371,148,26
D:1| T0: 0.10| T1: 515.00| I0: 400.0| I1: 125.0| WTP: 1000000,1,0.096153846,515,1000000,1,0.2,400,125,-1336895639,1868336855,11035.35716,785127780.7,78512778.07,4,88867,3905,818,1833,1015,818,88867,1015,1833,214.8928571,3.53125,8.035714286,45474.58482,1548.191964,11.6875,98973.66518,0.456759151,0.015547365,0.000118855,0.553737043,0.020626329,32,8
D:1| T0: 0.10| T1: 515.00| I0: 400.0| I1: 125.0| WTP: 1000000,1,0.096153846,515,1000000,1,0.2,400,125,-1328426135,1868498144,11020.78071,777387099.5,77738709.95,4,83064,3574,738,1831,1093,738,83064,1093,1831,154.2624113,2.468085106,6.308510638,43508.91489,1229.22695,8.946808511,98828.9078,0.437946382,0.012357932,9.15984E-05,0.596941562,0.022043244,41,8
D:1| T0: 0.10| T1: 515.00| I0: 400.0| I1: 125.0| WTP: 1000000,1,0.096153846,515,1000000,1,0.2,400,125,-2773869689,2101566889,7085.828934,2419578243,241957824.3,14,53913,2379,1171,1177,6,1171,53913,6,1177,26.28809107,0.854640981,0.859894921,59798.71191,268.767951,1.888791594,99133.47198,0.602659978,0.002703667,2.06636E-05,0.005097706,0.021831469,164,27
D:1| T0: 0.10| T1: 515.00| I0: 400.0| I1: 125.0| WTP: 1000000,1,0.096153846,515,1000000,1,0.2,400,125,-1326607715,1665097450,12466.49921,703282753.9,70328275.39,4,95376,4092,712,2071,1359,712,95376,1359,2071,268.265625,3.651041667,10.65625,33922.08333,1700.838542,14.359375,98663.69271,0.341408236,0.017091824,0.000145674,0.656204732,0.021714058,28,7
D:1| T0: 0.10| T1: 515.00| I0: 400.0| I1: 125.0| WTP: 1000000,1,0.096153846,515,1000000,1,0.2,400,125,-1337506518,1716179948,10775.50476,798731279.7,79873127.97,4,97436,4498,713,1789,1076,713,97436,1076,1789,304.7365591,3.747311828,9.478494624,36982.23118,1808.892473,13.31182796,98946.6129,0.371245615,0.018147954,0.000134933,0.601453326,0.01836077,27,8
D:1| T0: 0.10| T1: 515.00| I0: 400.0| I1: 125.0| WTP: 1000000,1,0.096153846,515,1000000,1,0.2,400,125,-2541638605,1560278715,7793.03322,2151986944,215198694.4,14,51156,2063,1284,1295,11,1284,51156,11,1295,29.22608696,1.192391304,1.206521739,65534.45217,189.7945652,2.594565217,99149.26848,0.660363029,0.001910558,2.81845E-05,0.008494208,0.025314724,131,24
D:1| T0: 0.10| T1: 515.00| I0: 400.0| I1: 125.0| WTP: 1000000,1,0.096153846,515,1000000,1,0.2,400,125,-1400544680,991019385,12343.8999,783349685.4,78334968.54,4,90105,3827,713,2051,1338,713,90105,1338,2051,176.2255639,2.560150376,7.567669173,38985.35338,2004.496241,10.26691729,98708.37218,0.392013411,0.020164468,0.000104562,0.6523647,0.022762333,38,8
D:1| T0: 0.10| T1: 515.00| I0: 400.0| I1: 125.0| WTP: 1000000,1,0.096153846,515,1000000,1,0.2,400,125,-1350120201,118052103,11293.66053,785437174.6,78543717.46,4,87357,3891,765,1876,1111,765,87357,1111,1876,180.4701493,2.720149254,6.824626866,45449.93657,1649.537313,9.701492537,98919.63433,0.456590564,0.016581293,9.90906E-05,0.592217484,0.021475096,39,8
D:1| T0: 0.10| T1: 515.00| I0: 400.0| I1: 125.0| WTP: 1000000,1,0.096153846,515,1000000,1,0.2,400,125,-1405055439,1209758844,12434.00238,783355320.1,78335532.01,4,89402,3728,691,2066,1375,691,89402,1375,2066,240.5179487,3.441025641,10.44102564,45146.83077,1345.369231,13.96410256,98835.05128,0.45362038,0.013515966,0.000142049,0.66553727,0.023109103,28,8
D:1| T0: 0.10| T1: 515.00| I0: 400.0| I1: 125.0| WTP: 1000000,1,0.096153846,515,1000000,1,0.2,400,125,-4721512746,70671723,7505.53451,4346236021,434623602.1,26,56268,2425,1247,1247,0,1247,56268,0,1247,16.68864679,0.51662844,0.51662844,65113.27752,198.0900229,1.236811927,99245.94094,0.655483176,0.001994459,1.43819E-05,0,0.022161797,250,49
D:1| T0: 0.10| T1: 515.00| I0: 400.0| I1: 125.0| WTP: 1000000,1,0.096153846,515,1000000,1,0.2,400,125,-2841836380,1722612191,6659.903054,2508841227,250884122.7,14,55199,2488,1106,1106,0,1106,55199,0,1106,26.96721311,0.754961173,0.754961173,65582.39431,262.9974116,1.716134599,99329.13891,0.659608161,0.002644378,1.91747E-05,0,0.020036595,165,28
D:1| T0: 0.10| T1: 515.00| I0: 400.0| I1: 125.0| WTP: 1000000,1,0.096153846,515,1000000,1,0.2,400,125,-2811973997,1968291596,6088.944564,2507526769,250752676.9,14,53337,2427,1011,1011,0,1011,53337,0,1011,29.22116301,0.7607245,0.7607245,68510.72259,204.013346,1.721639657,99412.93136,0.688602737,0.002051086,1.93548E-05,0,0.018955302,150,28
D:1| T0: 0.10| T1: 515.00| I0: 400.0| I1: 125.0| WTP: 1000000,1,0.096153846,515,1000000,1,0.2,400,125,-1449474365,1877569084,13169.17406,791015662.1,79101566.21,4,96488,4069,745,2188,1443,745,96488,1443,2188,266.1295337,3.813471503,11.21243523,35133.56995,1600.093264,15.05181347,98644.61658,0.353250926,0.016087307,0.00015278,0.659506399,0.022676395,28,8
D:1| T0: 0.10| T1: 515.00| I0: 400.0| I1: 125.0| WTP: 1000000,1,0.096153846,515,1000000,1,0.2,400,125,-1400909269,1726322189,12190.40189,791389174.1,79138917.41,4,95421,4151,742,2025,1283,742,95421,1283,2025,268.4352332,3.777202073,10.33678756,36894.84456,1673.772021,14.19170984,98778.33161,0.370759373,0.0168105,0.000144015,0.633580247,0.021221744,28,8
D:1| T0: 0.10| T1: 515.00| I0: 400.0| I1: 125.0| WTP: 1000000,1,0.096153846,515,1000000,1,0.2,400,125,-1390977632,307848836,12063.07059,787824102.3,78782410.23,4,91431,4027,613,2004,1391,613,91431,1391,2004,231.5627907,2.772093023,9.195348837,41100.16744,1495.390698,12.03255814,98811.69767,0.412902006,0.015021828,0.000122332,0.694111776,0.021918168,31,8
D:1| T0: 0.10| T1: 515.00| I0: 400.0| I1: 125.0| WTP: 1000000,1,0.096153846,515,1000000,1,0.2,400,125,-1256273041,1154000220,11067.13265,702916408,70291640.8,4,91009,4125,749,1838,1089,749,91009,1089,1838,280.1630435,3.983695652,9.836956522,33230.30978,1286.51087,13.89673913,98752.70652,0.335189924,0.012907515,0.000141173,0.592491839,0.020195805,27,7
D:1| T0: 0.10| T1: 515.00| I0: 400.0| I1: 125.0| WTP: 1000000,1,0.096153846,515,1000000,1,0.2,400,125,-3912792968,2028661055,7103.267602,3557629588,355762958.8,22,53789,2403,1180,1180,0,1180,53789,0,1180,21.04874552,0.623655914,0.623655914,67914.22652,201.5820789,1.478853047,99312.92473,0.683274707,0.002028635,1.70057E-05,0,0.021937571,200,40
D:1| T0: 0.10| T1: 515.00| I0: 400.0| I1: 125.0| WTP: 1000000,1,0.096153846,515,1000000,1,0.2,400,125,-1881607245,1629114640,9872.933435,1387960573,138796057.3,8,77706,3400,1070,1640,570,1070,77706,570,1640,121.5146199,3.005847953,4.622807018,50148.26608,1410.076023,7.748538012,99020.85965,0.504481775,0.014172465,7.96657E-05,0.347560976,0.021105463,49,15
D:1| T0: 0.10| T1: 515.00| I0: 400.0| I1: 125.0| WTP: 1000000,1,0.096153846,515,1000000,1,0.2,400,125,-1448079271,1439048174,13026.9009,796734226.2,79673422.62,4,96599,4308,746,2164,1418,746,96599,1418,2164,300.1748634,4,11.66666667,38851.43169,2247.836066,15.75956284,98756.08743,0.390137629,0.022590817,0.000159786,0.655268022,0.022401888,27,8
D:1| T0: 0.10| T1: 515.00| I0: 400.0| I1: 125.0| WTP: 1000000,1,0.096153846,515,1000000,1,0.2,400,125,-1292416835,865227006,11976.89732,693571969.4,69357196.94,4,88440,3679,705,1990,1285,705,88440,1285,1990,275.0722892,4.120481928,11.79518072,34329.10843,1429.783133,16.08433735,98636.85542,0.346731923,0.014345885,0.000163076,0.645728643,0.02250164,24,7
D:1| T0: 0.10| T1: 515.00| I0: 400.0| I1: 125.0| WTP: 1000000,1,0.096153846,515,1000000,1,0.2,400,125,-1621086639,890479738,11355.36228,1053318525,105331852.5,6,90197,3992,809,1886,1077,809,90197,1077,1886,218.5914894,3.310638298,7.846808511,44940.32766,2739.4,11.3106383,98964.15745,0.45120578,0.027521137,0.000115252,0.571049841,0.020909786,34,11
D:1| T0: 0.10| T1: 515.00| I0: 400.0| I1: 125.0| WTP: 1000000,1,0.096153846,515,1000000,1,0.2,400,125,-3139757444,1017049163,7250.25051,2777244919,277724491.9,20,61163,2770,1203,1204,1,1203,61163,1,1204,33.96039604,0.982178218,0.983168317,62715.34653,216.4049505,2.176237624,99284.59505,0.631032007,0.002177238,2.3952E-05,0.000830565,0.019685104,145,31
D:1| T0: 0.10| T1: 515.00| I0: 400.0| I1: 125.0| WTP: 1000000,1,0.096153846,515,1000000,1,0.2,400,125,-3525124691,1707305064,6340.919541,3208078714,320807871.4,18,53097,2413,1053,1053,0,1053,53097,0,1053,21.83549784,0.564935065,0.564935065,65713.18615,200.7330447,1.336219336,99323.15152,0.661102099,0.002019018,1.52641E-05,0,0.019831629,198,36
D:1| T0: 0.10| T1: 515.00| I0: 400.0| I1: 125.0| WTP: 1000000,1,0.096153846,515,1000000,1,0.2,400,125,-1286251020,400145663,11803.58029,696072005.8,69607200.58,4,86942,3738,730,1961,1231,730,86942,1231,1961,245.9270833,3.723958333,10.078125,32762.4375,1214.723958,13.875,98577.98958,0.331264071,0.012196606,0.000140896,0.627740948,0.022555267,28,7
D:1| T0: 0.10| T1: 515.00| I0: 400.0| I1: 125.0| WTP: 1000000,1,0.096153846,515,1000000,1,0.2,400,125,-2828203242,1662654181,8013.261934,2427540145,242754014.5,16,63572,2863,1311,1331,20,1311,63572,20,1331,34.61685055,1.110330993,1.127382146,59643.35406,261.998997,2.426278837,99166.43731,0.600712747,0.002637388,2.66505E-05,0.015026296,0.02093722,143,27
D:1| T0: 0.10| T1: 515.00| I0: 400.0| I1: 125.0| WTP: 1000000,1,0.096153846,515,1000000,1,0.2,400,125,-1362182916,182136456,11380.26596,793169618,79316961.8,4,95282,4251,770,1890,1120,770,95282,1120,1890,282.1489362,4.037234043,9.909574468,37686.44149,1749.590426,14,98864.92021,0.378761919,0.017562797,0.000142007,0.592592593,0.019835856,27,8
D:1| T0: 0.10| T1: 515.00| I0: 400.0| I1: 125.0| WTP: 1000000,1,0.096153846,515,1000000,1,0.2,400,125,-3854660163,979575387,6032.753309,3553022497,355302249.7,20,50872,2299,1002,1002,0,1002,50872,0,1002,18.0983165,0.488215488,0.488215488,67681.95084,230.7367003,1.167003367,99367.69832,0.68064368,0.00232005,1.35537E-05,0,0.019696493,213,40
D:1| T0: 0.10| T1: 515.00| I0: 400.0| I1: 125.0| WTP: 1000000,1,0.096153846,515,1000000,1,0.2,400,125,-1414555815,2142525414,12519.76766,788567431.6,78856743.16,4,93670,3990,711,2080,1369,711,93670,1369,2080,256.7384615,3.523076923,10.48717949,45475.51282,1895.589744,14.17435897,98908.51282,0.456217912,0.019047371,0.000143821,0.658173077,0.022205615,28,8
D:1| T0: 0.10| T1: 515.00| I0: 400.0| I1: 125.0| WTP: 1000000,1,0.096153846,515,1000000,1,0.2,400,125,-1308353211,1464057597,10553.45839,780680291.3,78068029.13,4,83440,3665,765,1753,988,765,83440,988,1753,168.3247232,2.6900369,6.287822878,47638.99262,1154.653137,9.103321033,98981.90406,0.478795989,0.011598857,9.33721E-05,0.563605248,0.021010116,39,8
D:1| T0: 0.10| T1: 515.00| I0: 400.0| I1: 125.0| WTP: 1000000,1,0.096153846,515,1000000,1,0.2,400,125,-1363136256,364562610,11575.53304,784359603.8,78435960.38,4,90373,3854,667,1923,1256,667,90373,1256,1923,239.7939698,3.246231156,9.497487437,43443.79899,1533.854271,12.86432161,98892.47739,0.436426742,0.015401995,0.000130688,0.653146126,0.021278479,29,8
D:1| T0: 0.10| T1: 515.00| I0: 400.0| I1: 125.0| WTP: 1000000,1,0.096153846,515,1000000,1,0.2,400,125,-1378858728,40350784,11893.77738,784169859.3,78416985.93,4,90261,3748,686,1976,1290,686,90261,1290,1976,227.5502392,3.148325359,9.267942584,45322.52632,1657.406699,12.54545455,98905.97608,0.455083565,0.016649277,0.000127961,0.652834008,0.021892069,30,8
D:1| T0: 0.10| T1: 515.00| I0: 400.0| I1: 125.0| WTP: 1000000,1,0.096153846,515,1000000,1,0.2,400,125,-1273483426,804064356,9720.873859,787439732.7,78743973.27,4,86882,4047,690,1614,924,690,86882,924,1614,242.6941748,3.247572816,7.669902913,46469.7767,1217.18932,11.01941748,99087.15534,0.466785178,0.012203156,0.000112138,0.572490706,0.018577134,30,8
D:1| T0: 0.10| T1: 515.00| I0: 400.0| I1: 125.0| WTP: 1000000,1,0.096153846,515,1000000,1,0.2,400,125,-2149141079,2125493986,8475.39719,1725371219,172537121.9,12,63529,2704,1211,1408,197,1211,63529,197,1408,44.95086321,1.415670651,1.67065073,52944.7012,266.5697211,3.274900398,98964.22842,0.534246903,0.002683834,3.49836E-05,0.139914773,0.022164851,108,19
D:1| T0: 0.10| T1: 515.00| I0: 400.0| I1: 125.0| WTP: 1000000,1,0.096153846,515,1000000,1,0.2,400,125,-1238899457,23154253,9166.195974,780589658.5,78058965.85,4,78757,3560,713,1522,809,713,78757,809,1522,180.2627451,2.670588235,5.815686275,47154.9451,824.9607843,8.62745098,99039.89804,0.474417196,0.0082769,8.79372E-05,0.531537451,0.019325266,37,8
D:1| T0: 0.10| T1: 515.00| I0: 400.0| I1: 125.0| WTP: 1000000,1,0.096153846,515,1000000,1,0.2,400,125,-2416272439,1391367689,6953.574094,2068593735,206859373.5,12,54774,2422,1155,1155,0,1155,54774,0,1155,30.81282316,1,1,64324.61013,191.0672182,2.178903826,99251.08687,0.647531681,0.001922405,2.40018E-05,0,0.021086647,139,23
D:1| T0: 0.10| T1: 515.00| I0: 400.0| I1: 125.0| WTP: 1000000,1,0.096153846,515,1000000,1,0.2,400,125,-1552896132,574142276,8711.360882,1117328088,111732808.8,6,68260,3027,1028,1447,419,1028,68260,419,1447,58.45525903,1.489795918,2.128728414,45664.82418,492.7974882,3.739403454,98876.81319,0.460916927,0.004956339,3.90818E-05,0.289564616,0.021198359,91,12
D:1| T0: 0.10| T1: 515.00| I0: 400.0| I1: 125.0| WTP: 1000000,1,0.096153846,515,1000000,1,0.2,400,125,-4236571669,898736779,6610.068845,3906068227,390606822.7,22,51970,2330,1098,1098,0,1098,51970,0,1098,16.28859447,0.44297235,0.44297235,67029.11406,220.3317972,1.081797235,99309.51613,0.674426379,0.002216861,1.27122E-05,0,0.021127574,248,44
D:1| T0: 0.10| T1: 515.00| I0: 400.0| I1: 125.0| WTP: 1000000,1,0.096153846,515,1000000,1,0.2,400,125,-1506516216,346473503,9138.095581,1049611437,104961143.7,6,83832,4006,710,1517,807,710,83832,807,1517,186.7067669,2.522556391,5.522556391,47172.19925,1789.176692,8.19924812,99116.6015,0.473840971,0.017954444,8.40425E-05,0.531970995,0.018095715,38,11
D:1| T0: 0.10| T1: 515.00| I0: 400.0| I1: 125.0| WTP: 1000000,1,0.096153846,515,1000000,1,0.2,400,125,-1614837646,445552282,9771.244653,1126275413,112627541.3,6,74932,3334,1023,1623,600,1023,74932,600,1623,92.79039301,2.100436681,3.390829694,44598.56332,935.5764192,5.626637555,98843.41703,0.449686464,0.009411044,5.81305E-05,0.369685767,0.021659638,65,12
D:1| T0: 0.10| T1: 515.00| I0: 400.0| I1: 125.0| WTP: 1000000,1,0.096153846,515,1000000,1,0.2,400,125,-1270786973,911758476,11284.51619,706561163.2,70656116.32,4,92449,4212,736,1874,1138,736,92449,1138,1874,252.5492958,3.384976526,8.638497653,28949.4554,1215.075117,12.10798122,98646.93427,0.292196282,0.012203292,0.000123144,0.607257204,0.020270636,31,7
D:1| T0: 0.10| T1: 515.00| I0: 400.0| I1: 125.0| WTP: 1000000,1,0.096153846,515,1000000,1,0.2,400,125,-1381815226,1464197940,11687.88935,797420758.4,79742075.84,4,96108,4386,679,1941,1262,679,96108,1262,1941,277.2636816,3.278606965,9.527363184,38605.37313,2774.383085,12.90547264,98875.17413,0.387457565,0.027857109,0.000130907,0.650180319,0.020196029,29,8
D:1| T0: 0.10| T1: 515.00| I0: 400.0| I1: 125.0| WTP: 1000000,1,0.096153846,515,1000000,1,0.2,400,125,-2055414881,500405854,8384.807806,1636174490,163617449,10,63617,2698,1259,1393,134,1259,63617,134,1393,39.03562945,1.305225653,1.458432304,51808.63064,306.8978622,2.956057007,98956.17815,0.522910342,0.003089481,3.16812E-05,0.096195262,0.021896663,121,18
D:1| T0: 0.10| T1: 515.00| I0: 400.0| I1: 125.0| WTP: 1000000,1,0.096153846,515,1000000,1,0.2,400,125,-1367557469,772037341,11777.84409,778665265.1,77866526.51,4,84909,3608,627,1957,1330,627,84909,1330,1957,214.6699029,2.917475728,9.32038835,47682.80583,1350.533981,12.36893204,98881.03398,0.47935571,0.013564432,0.000125993,0.67961165,0.023048205,30,8
D:1| T0: 0.10| T1: 515.00| I0: 400.0| I1: 125.0| WTP: 1000000,1,0.096153846,515,1000000,1,0.2,400,125,-3211813062,1543158763,5586.093992,2932508362,293250836.2,18,43929,1916,928,928,0,928,43929,0,928,17.13844996,0.501128668,0.501128668,72751.538,159.890143,1.203160271,99425.16328,0.731303247,0.001607753,1.40198E-05,0,0.021124997,190,33
D:1| T0: 0.10| T1: 515.00| I0: 400.0| I1: 125.0| WTP: 1000000,1,0.096153846,515,1000000,1,0.2,400,125,-1367589056,1604932531,13312.83604,701947253.7,70194725.37,4,94923,4067,763,2212,1449,763,94923,1449,2212,277.0054945,4.131868132,12.01648352,36485.52747,1533.351648,16.18681319,98629.94505,0.367242845,0.015414737,0.000164333,0.655063291,0.023303098,26,7
D:1| T0: 0.10| T1: 515.00| I0: 400.0| I1: 125.0| WTP: 1000000,1,0.096153846,515,1000000,1,0.2,400,125,-1368832810,539051477,11601.00889,788782365.3,78878236.53,4,91936,4058,718,1927,1209,718,91936,1209,1927,224.8883929,3.107142857,8.446428571,42742.0625,2343.183036,11.64285714,98910.42857,0.429129865,0.02354521,0.000118658,0.627400104,0.020960233,32,8
D:1| T0: 0.10| T1: 515.00| I0: 400.0| I1: 125.0| WTP: 1000000,1,0.096153846,515,1000000,1,0.2,400,125,-2752485334,1743124675,6712.542139,2416858227,241685822.7,20,53458,2321,1115,1115,0,1115,53458,0,1115,26.1510989,0.808608059,0.808608059,68661.48901,165.8351648,1.83974359,99350.72802,0.690475449,0.001668815,2.05167E-05,0,0.020857496,156,27
D:1| T0: 0.10| T1: 515.00| I0: 400.0| I1: 125.0| WTP: 1000000,1,0.096153846,515,1000000,1,0.2,400,125,-1924639129,1965983789,9149.584792,1467159889,146715988.9,8,67612,2919,1130,1520,390,1130,67612,390,1520,86.10849057,2.54245283,3.429245283,55063.81132,931.7382075,6.099056604,99037.48349,0.554457073,0.009367031,6.28291E-05,0.256578947,0.022481216,61,16
D:1| T0: 0.10| T1: 515.00| I0: 400.0| I1: 125.0| WTP: 1000000,1,0.096153846,515,1000000,1,0.2,400,125,-2837393288,516774280,8175.769837,2428604796,242860479.6,14,65573,2821,1334,1358,24,1334,65573,24,1358,31.99454049,1.018198362,1.037306642,53669.78344,383.2747953,2.263876251,99050.37398,0.541047571,0.003857988,2.46402E-05,0.017673049,0.020709743,156,27
D:1| T0: 0.10| T1: 515.00| I0: 400.0| I1: 125.0| WTP: 1000000,1,0.096153846,515,1000000,1,0.2,400,125,-998389498.6,86603142,11251.91933,435793532.2,43579353.22,2,88466,3815,624,1869,1245,624,88466,1245,1869,285.6569767,3.534883721,10.72674419,32496.5407,1333.540698,14.31976744,98668.77907,0.32826279,0.013375069,0.000145509,0.666131621,0.021126999,25,4
D:1| T0: 0.10| T1: 515.00| I0: 400.0| I1: 125.0| WTP: 1000000,1,0.096153846,515,1000000,1,0.2,400,125,-5381233324,1431870609,6629.497996,5049758424,504975842.4,30,53955,2434,1101,1101,0,1101,53955,0,1101,15.1526755,0.388807069,0.388807069,62298.47815,182.8389789,0.922434953,99248.64703,0.6271812,0.001839834,1.08645E-05,0,0.020405894,291,57
D:1| T0: 0.10| T1: 515.00| I0: 400.0| I1: 125.0| WTP: 1000000,1,0.096153846,515,1000000,1,0.2,400,125,-1241929708,1592383984,9320.840289,775887694,77588769.4,4,75834,3394,816,1548,732,816,75834,732,1548,142.5348837,2.594684385,5.003322259,48621.0897,734.4053156,7.707641196,99004.48837,0.489411742,0.007375628,7.88586E-05,0.472868217,0.020413007,43,8
D:1| T0: 0.10| T1: 515.00| I0: 400.0| I1: 125.0| WTP: 1000000,1,0.096153846,515,1000000,1,0.2,400,125,-1525685022,1440183867,8176.73623,1116848210,111684821,6,67584,3004,1053,1358,305,1053,67584,305,1358,56.20637329,1.474962064,1.918057663,46558.82246,494.0622155,3.509863429,98949.02124,0.46969305,0.004968516,3.67834E-05,0.224594993,0.020093513,95,12
D:1| T0: 0.10| T1: 515.00| I0: 400.0| I1: 125.0| WTP: 1000000,1,0.096153846,515,1000000,1,0.2,400,125,-1564916020,1696510588,8987.047175,1115563661,111556366.1,6,68836,2924,1114,1493,379,1114,68836,379,1493,50.93220339,1.415254237,1.940677966,46325.5113,456.1483051,3.514124294,98855.14831,0.467626388,0.004591065,3.70537E-05,0.253851306,0.021689232,102,12
D:1| T0: 0.10| T1: 515.00| I0: 400.0| I1: 125.0| WTP: 1000000,1,0.096153846,515,1000000,1,0.2,400,125,-1377059077,895039877,11834.12517,785352818.9,78535281.89,4,89167,3768,700,1966,1266,700,89167,1266,1966,198.7037037,2.781893004,7.95473251,40717.83128,1933.230453,10.81893004,98795.68313,0.409387433,0.019434156,0.000110336,0.643947101,0.022048516,35,8
D:1| T0: 0.10| T1: 515.00| I0: 400.0| I1: 125.0| WTP: 1000000,1,0.096153846,515,1000000,1,0.2,400,125,-1934228476,129565953,9329.962588,1467730347,146773034.7,8,68647,2898,1264,1550,286,1264,68647,286,1550,49.80487805,1.592140921,1.963414634,45897.94715,657.098916,3.66395664,98807.27507,0.463438098,0.006615092,3.83759E-05,0.184516129,0.022579282,105,16
D:1| T0: 0.10| T1: 515.00| I0: 400.0| I1: 125.0| WTP: 1000000,1,0.096153846,515,1000000,1,0.2,400,125,-1920573248,1902565669,7359.177667,1552614364,155261436.4,10,63872,2859,1100,1222,122,1100,63872,122,1222,36.87835052,0.992783505,1.112371134,49511.70515,253.3938144,2.231958763,99053.91649,0.499218227,0.002549,2.40604E-05,0.099836334,0.019132014,139,17
D:1| T0: 0.10| T1: 515.00| I0: 400.0| I1: 125.0| WTP: 1000000,1,0.096153846,515,1000000,1,0.2,400,125,-4654887647,1984179288,7831.393083,4263317993,426331799.3,26,59772,2580,1300,1301,1,1300,59772,1,1301,16.24389002,0.485234216,0.485743381,56630.71792,229.2556008,1.152240326,99060.50916,0.571085583,0.002308886,1.33232E-05,0.00076864,0.021766044,281,48
D:1| T0: 0.10| T1: 515.00| I0: 400.0| I1: 125.0| WTP: 1000000,1,0.096153846,515,1000000,1,0.2,400,125,-1672883771,677377223,10776.64854,1134051344,113405134.4,6,84378,3760,982,1790,808,982,84378,808,1790,137.5146199,2.754385965,5.076023392,44094.5,2006.149123,7.964912281,98893.07018,0.443490911,0.020177447,8.15647E-05,0.451396648,0.021214061,48,12
D:1| T0: 0.10| T1: 515.00| I0: 400.0| I1: 125.0| WTP: 1000000,1,0.096153846,515,1000000,1,0.2,400,125,-1636446099,973583301,10114.98174,1130697012,113069701.2,6,83161,3652,1049,1680,631,1049,83161,631,1680,116.6813472,2.593264249,4.191709845,43396.62953,1753.088083,6.904145078,98924.07772,0.436575097,0.017627865,7.11207E-05,0.375595238,0.020201777,56,12
D:1| T0: 0.10| T1: 515.00| I0: 400.0| I1: 125.0| WTP: 1000000,1,0.096153846,515,1000000,1,0.2,400,125,-1756950570,781062938,7445.623955,1384669372,138466937.2,8,67582,3268,1062,1236,174,1062,67582,174,1236,49.94789082,1.167493797,1.377171216,45631.03598,384.1650124,2.688585608,99030.55211,0.460194728,0.003862004,2.86544E-05,0.140776699,0.018288893,116,15
D:1| T0: 0.10| T1: 515.00| I0: 400.0| I1: 125.0| WTP: 1000000,1,0.096153846,515,1000000,1,0.2,400,125,-1955668869,338783425,9537.685585,1478784589,147878458.9,8,78335,3480,1117,1584,467,1117,78335,467,1584,112.8989637,2.764248705,3.917098446,51237.18135,1650.994819,6.821243523,99078.8057,0.515062453,0.016597431,7.03429E-05,0.294823232,0.020220846,56,16
D:1| T0: 0.10| T1: 515.00| I0: 400.0| I1: 125.0| WTP: 1000000,1,0.096153846,515,1000000,1,0.2,400,125,-5165814274,1027579040,7460.192784,4792804635,479280463.5,28,61900,2766,1239,1239,0,1239,61900,0,1239,17.11338661,0.445054945,0.445054945,58639.99001,232.8301698,1.065434565,99182.94505,0.59060064,0.002343972,1.24485E-05,0,0.020016155,285,54
D:1| T0: 0.10| T1: 515.00| I0: 400.0| I1: 125.0| WTP: 1000000,1,0.096153846,515,1000000,1,0.2,400,125,-1611760109,764973813,9758.464307,1123836894,112383689.4,6,74930,3230,1102,1621,519,1102,74930,519,1621,88.01290323,2.219354839,3.309677419,46362.68172,1098.643011,5.692473118,98888.8172,0.467207518,0.011051039,5.89207E-05,0.320172733,0.021633525,66,12
D:1| T0: 0.10| T1: 515.00| I0: 400.0| I1: 125.0| WTP: 1000000,1,0.096153846,515,1000000,1,0.2,400,125,-1636982850,1245753446,10126.8896,1130638370,113063837,6,82957,3589,791,1682,891,791,82957,891,1682,146.1483871,2.432258065,5.270967742,44432.0129,1834.8,7.822580645,98945.21935,0.446895393,0.018438291,8.02072E-05,0.529726516,0.020275809,45,12
D:1| T0: 0.10| T1: 515.00| I0: 400.0| I1: 125.0| WTP: 1000000,1,0.096153846,515,1000000,1,0.2,400,125,-1558974130,1013177794,8890.602571,1114444001,111444400.1,6,67359,2884,1090,1477,387,1090,67359,387,1477,54.01221374,1.523664122,2.097709924,46385.86107,428.5923664,3.766412214,98854.17252,0.468359867,0.004312399,3.94282E-05,0.262017603,0.021927285,94,12
D:1| T0: 0.10| T1: 515.00| I0: 400.0| I1: 125.0| WTP: 1000000,1,0.096153846,515,1000000,1,0.2,400,125,-3806625254,1395089249,6837.318086,3464759349,346475934.9,20,50220,2126,1136,1136,0,1136,50220,0,1136,15.19526285,0.471403813,0.471403813,68405.46678,150.7383016,1.126516464,99296.82265,0.688356971,0.001517496,1.31926E-05,0,0.02262047,248,39
D:1| T0: 0.10| T1: 515.00| I0: 400.0| I1: 125.0| WTP: 1000000,1,0.096153846,515,1000000,1,0.2,400,125,-3860700516,1339545835,6211.941072,3550103462,355010346.2,20,47262,2031,1032,1032,0,1032,47262,0,1032,12.9343253,0.351462288,0.351462288,74458.66444,185.601334,0.871729092,99458.41252,0.748121422,0.001866987,1.06395E-05,0,0.021835724,279,40
D:1| T0: 0.10| T1: 515.00| I0: 400.0| I1: 125.0| WTP: 1000000,1,0.096153846,515,1000000,1,0.2,400,125,-1332052832,219139554,10832.89656,790408004.2,79040800.42,4,90154,4019,758,1799,1041,758,90154,1041,1799,289.5,4.191011236,9.938202247,41275.98315,1331.713483,14.19101124,98921.76404,0.415222809,0.01335809,0.000144089,0.578654808,0.019954744,26,8
D:1| T0: 0.10| T1: 515.00| I0: 400.0| I1: 125.0| WTP: 1000000,1,0.096153846,515,1000000,1,0.2,400,125,-2095427249,1336508942,7477.235468,1721565476,172156547.6,10,58153,2548,1201,1242,41,1201,58153,41,1242,32.5932377,1.048155738,1.089139344,56565.12705,240.9938525,2.320696721,99094.71824,0.570254422,0.002424474,2.51616E-05,0.033011272,0.021357821,140,19
D:1| T0: 0.10| T1: 515.00| I0: 400.0| I1: 125.0| WTP: 1000000,1,0.096153846,515,1000000,1,0.2,400,125,-4583505956,448559423,6703.442619,4248333825,424833382.5,24,45338,1858,1114,1114,0,1114,45338,0,1114,10.67632184,0.344827586,0.344827586,69649.47862,160.8321839,0.861609195,99249.7108,0.701274793,0.00161938,1.02963E-05,0,0.024571542,311,48
D:1| T0: 0.10| T1: 515.00| I0: 400.0| I1: 125.0| WTP: 1000000,1,0.096153846,515,1000000,1,0.2,400,125,-1911483973,2110028840,8879.417722,1467513087,146751308.7,8,69517,3061,1230,1475,245,1230,69517,245,1475,51.83779972,1.576868829,1.902679831,47762.10014,479.5430183,3.631875882,98924.52186,0.481801812,0.004825597,3.83819E-05,0.166101695,0.021217832,102,16
D:1| T0: 0.10| T1: 515.00| I0: 400.0| I1: 125.0| WTP: 1000000,1,0.096153846,515,1000000,1,0.2,400,125,-1880253901,1982030155,10008.45454,1379831174,137983117.4,8,71774,2961,1141,1663,522,1141,71774,522,1663,85.25,2.542056075,3.731308411,51459.83645,1115.469626,6.397196262,98925.57009,0.51839322,0.011222821,6.5909E-05,0.313890559,0.02316995,62,15
D:1| T0: 0.10| T1: 515.00| I0: 400.0| I1: 125.0| WTP: 1000000,1,0.096153846,515,1000000,1,0.2,400,125,-1249698267,696219407,9589.202629,770238135.2,77023813.52,4,72391,3184,769,1593,824,769,72391,824,1593,117.0385757,2.127596439,4.548961424,50996.23442,716.8071217,6.818991098,98970.63205,0.513530369,0.007201362,7.04406E-05,0.517263026,0.022005498,49,8
D:1| T0: 0.10| T1: 515.00| I0: 400.0| I1: 125.0| WTP: 1000000,1,0.096153846,515,1000000,1,0.2,400,125,-1324873222,1402539442,10665.09851,791618296.9,79161829.69,4,93537,4147,701,1771,1070,701,93537,1070,1771,257.9359606,3.359605911,8.586206897,42599.54187,2112.738916,12.03448276,99011.71921,0.427492934,0.021198924,0.000122191,0.60417843,0.018933684,29,8
D:1| T0: 0.10| T1: 515.00| I0: 400.0| I1: 125.0| WTP: 1000000,1,0.096153846,515,1000000,1,0.2,400,125,-1385425645,1319833493,11848.62318,792994485.5,79299448.55,4,92959,4187,765,1968,1203,765,92959,1203,1968,220.3666667,3.075,8.033333333,38741.50833,2623.029167,11.21666667,98807.0875,0.389199939,0.026370065,0.000114482,0.611280488,0.021170624,35,8
D:1| T0: 0.10| T1: 515.00| I0: 400.0| I1: 125.0| WTP: 1000000,1,0.096153846,515,1000000,1,0.2,400,125,-2137188058,663608076,8211.521647,1726611976,172661197.6,10,64309,2859,1220,1364,144,1220,64309,144,1364,32.84469697,0.991477273,1.12405303,48299.42045,368.6373106,2.285037879,98921.92519,0.487607585,0.003710574,2.46147E-05,0.105571848,0.021210095,151,19
D:1| T0: 0.10| T1: 515.00| I0: 400.0| I1: 125.0| WTP: 1000000,1,0.096153846,515,1000000,1,0.2,400,125,-2171747065,414696500,7225.448381,1810474646,181047464.6,10,58456,2537,1191,1200,9,1191,58456,9,1200,37.55581128,1.18872267,1.20023015,60599.09206,465.127733,2.571921749,99213.35558,0.609952645,0.004675884,2.76479E-05,0.007506255,0.020511154,124,20
D:1| T0: 0.10| T1: 515.00| I0: 400.0| I1: 125.0| WTP: 1000000,1,0.096153846,515,1000000,1,0.2,400,125,-3025509162,1249738535,7017.141822,2674652071,267465207.1,16,48667,2041,1166,1166,0,1166,48667,0,1166,17.64832869,0.627437326,0.627437326,66119.51323,135.7012535,1.447075209,99196.85864,0.666021309,0.001366519,1.63233E-05,0,0.023938192,206,30
D:1| T0: 0.10| T1: 515.00| I0: 400.0| I1: 125.0| WTP: 1000000,1,0.096153846,515,1000000,1,0.2,400,125,-2156400917,614415382,6984.128253,1807194505,180719450.5,10,56348,2458,1119,1160,41,1119,56348,41,1160,28.8768797,0.907894737,0.944548872,55847.77068,337.5197368,1.985902256,99109.12594,0.562941387,0.003393661,2.15232E-05,0.035344828,0.020586356,152,20
D:1| T0: 0.10| T1: 515.00| I0: 400.0| I1: 125.0| WTP: 1000000,1,0.096153846,515,1000000,1,0.2,400,125,-3876773544,524899953,6364.868519,3558530119,355853011.9,20,53757,2495,1057,1057,0,1057,53757,0,1057,22.52989537,0.582212257,0.582212257,68839.64499,233.5949178,1.376681614,99389.21001,0.692089478,0.002349481,1.58717E-05,0,0.019662556,192,40
D:1| T0: 0.10| T1: 515.00| I0: 400.0| I1: 125.0| WTP: 1000000,1,0.096153846,515,1000000,1,0.2,400,125,-1298416506,1338977757,11848.84101,705974455.5,70597445.55,4,93037,4177,742,1968,1226,742,93037,1226,1968,246.6805556,3.384259259,9,30919.31944,1130.555556,12.43518519,98616.37963,0.311861299,0.011361959,0.000126125,0.62296748,0.021152875,31,7
D:1| T0: 0.10| T1: 515.00| I0: 400.0| I1: 125.0| WTP: 1000000,1,0.096153846,515,1000000,1,0.2,400,125,-1509472910,341384587,9564.561546,1031244833,103124483.3,6,72362,3090,882,1589,707,882,72362,707,1589,69.08679928,1.430379747,2.692585895,41771.97288,445.8191682,4.289330922,98747.48463,0.422125918,0.004486588,4.49716E-05,0.444933921,0.021959039,79,11
D:1| T0: 0.10| T1: 515.00| I0: 400.0| I1: 125.0| WTP: 1000000,1,0.096153846,515,1000000,1,0.2,400,125,-1850855691,2032000160,9331.27625,1384291879,138429187.9,8,73252,3177,1096,1550,454,1096,73252,454,1550,97.6039604,2.589108911,3.675742574,50245.84653,1229.831683,6.383663366,98994.06188,0.505922606,0.012365755,6.58456E-05,0.292903226,0.021160121,58,15
D:1| T0: 0.10| T1: 515.00| I0: 400.0| I1: 125.0| WTP: 1000000,1,0.096153846,515,1000000,1,0.2,400,125,-1413790736,779488939,12489.99598,789290936.8,78929093.68,4,93354,4072,777,2075,1298,777,93354,1298,2075,235.5654206,3.537383178,9.542056075,42853.29439,1650.556075,13.17757009,98841.71028,0.430234072,0.016589327,0.000133965,0.625542169,0.022227221,31,8
D:1| T0: 0.10| T1: 515.00| I0: 400.0| I1: 125.0| WTP: 1000000,1,0.096153846,515,1000000,1,0.2,400,125,-2165182613,1449019578,8817.400843,1724312571,172431257.1,10,64438,2654,1362,1465,103,1362,64438,103,1465,32.31047992,1.168462292,1.265426053,50875.42214,391.5945152,2.602350637,98904.68266,0.513529236,0.003942554,2.78658E-05,0.070307167,0.022735032,145,19
D:1| T0: 0.10| T1: 515.00| I0: 400.0| I1: 125.0| WTP: 1000000,1,0.096153846,515,1000000,1,0.2,400,125,-3242316688,351952211,5950.407117,2944796332,294479633.2,18,52497,2508,988,988,0,988,52497,0,988,21.04599303,0.495470383,0.495470383,67685.7777,163.241115,1.189547038,99395.34495,0.680439901,0.001642035,1.38286E-05,0,0.018820123,205,33
D:1| T0: 0.10| T1: 515.00| I0: 400.0| I1: 125.0| WTP: 1000000,1,0.096153846,515,1000000,1,0.2,400,125,-2919863438,486595046,8150.472167,2512339830,251233983,14,62111,2652,1341,1354,13,1341,62111,13,1354,21.69801325,0.739735099,0.748344371,52773.14636,340.3258278,1.634437086,98988.77682,0.532322118,0.00342594,1.79572E-05,0.009601182,0.021799681,214,28
D:1| T0: 0.10| T1: 515.00| I0: 400.0| I1: 125.0| WTP: 1000000,1,0.096153846,515,1000000,1,0.2,400,125,-1549979558,296745624,8615.829681,1119188074,111918807.4,6,71072,3121,892,1431,539,892,71072,539,1431,58.30408472,1.245083207,2.04387292,40663.177,528.570348,3.379727685,98828.86989,0.410672842,0.00531724,3.53468E-05,0.376659679,0.020134511,95,12
D:1| T0: 0.10| T1: 515.00| I0: 400.0| I1: 125.0| WTP: 1000000,1,0.096153846,515,1000000,1,0.2,400,125,-3014815360,1671484194,6688.69449,2680380636,268038063.6,16,53583,2387,1110,1111,1,1110,53583,1,1111,23.77302632,0.721217105,0.721217105,62041.05181,224.4523026,1.638980263,99226.77385,0.624781801,0.002257489,1.83515E-05,0.00090009,0.020735349,174,30
D:1| T0: 0.10| T1: 515.00| I0: 400.0| I1: 125.0| WTP: 1000000,1,0.096153846,515,1000000,1,0.2,400,125,-1400656959,422157396,12131.22765,794095577.1,79409557.71,4,96591,4263,730,2015,1285,730,96591,1285,2015,303.9602273,4.085227273,11.3125,36754.43182,2040.965909,15.46022727,98801.69318,0.369351593,0.02049057,0.000156608,0.637717122,0.020861157,26,8
D:1| T0: 0.10| T1: 515.00| I0: 400.0| I1: 125.0| WTP: 1000000,1,0.096153846,515,1000000,1,0.2,400,125,-1314413236,1916599091,12196.69492,704578489.8,70457848.98,4,94800,4122,739,2026,1287,739,94800,1287,2026,306.1169591,4.263157895,11.69005848,38038.8655,1935.216374,16.00584795,98795.16374,0.382568431,0.019426391,0.000162357,0.635241856,0.021371308,25,7
D:1| T0: 0.10| T1: 515.00| I0: 400.0| I1: 125.0| WTP: 1000000,1,0.096153846,515,1000000,1,0.2,400,125,-1394522098,1005953941,12016.98896,793672650.1,79367265.01,4,96439,4253,739,1996,1257,739,96439,1257,1996,300.8587571,4.107344633,11.1299435,35529.49153,2208.711864,15.31638418,98792.36723,0.357169885,0.022171188,0.000155156,0.629759519,0.020697021,26,8
D:1| T0: 0.10| T1: 515.00| I0: 400.0| I1: 125.0| WTP: 1000000,1,0.096153846,515,1000000,1,0.2,400,125,-1351808627,1422765615,11418.30215,780893519.3,78089351.93,4,84828,3612,733,1897,1164,733,84828,1164,1897,138.1939394,2.115151515,5.615151515,35722.34242,890.2272727,7.851515152,98624.77576,0.360262854,0.008957915,8.01868E-05,0.613600422,0.022362899,48,8
D:1| T0: 0.10| T1: 515.00| I0: 400.0| I1: 125.0| WTP: 1000000,1,0.096153846,515,1000000,1,0.2,400,125,-3781354934,699740192,6380.110906,3462349389,346234938.9,20,46336,1970,1060,1060,0,1060,46336,0,1060,15.138536,0.450695705,0.450695705,71242.14519,166.8596491,1.109497883,99344.93769,0.716652493,0.001679069,1.28856E-05,0,0.022876381,237,39
D:1| T0: 0.10| T1: 515.00| I0: 400.0| I1: 125.0| WTP: 1000000,1,0.096153846,515,1000000,1,0.2,400,125,-4016537899,240885764,5768.421716,3728116813,372811681.3,22,48673,2155,958,958,0,958,48673,0,958,14.81239715,0.351618212,0.351618212,69878.0384,162.5216676,0.879319803,99422.81843,0.702356055,0.001634468,1.05549E-05,0,0.01968237,261,42
D:1| T0: 0.10| T1: 515.00| I0: 400.0| I1: 125.0| WTP: 1000000,1,0.096153846,515,1000000,1,0.2,400,125,-1581553720,2023806564,9122.285902,1125439425,112543942.5,6,76148,3443,814,1515,701,814,76148,701,1515,91.77223427,1.650759219,3.15835141,39103.4859,691.2494577,4.934924078,98828.77007,0.394598588,0.006949047,5.07944E-05,0.462706271,0.019895989,66,12
D:1| T0: 0.10| T1: 515.00| I0: 400.0| I1: 125.0| WTP: 1000000,1,0.096153846,515,1000000,1,0.2,400,125,-3213434041,1907493879,7168.928681,2854987607,285498760.7,16,54038,2265,1191,1191,0,1191,54038,0,1191,16.67254556,0.549088771,0.549088771,59484.78189,198.3862434,1.253380364,99115.08524,0.599607392,0.0019969,1.4079E-05,0,0.022040046,242,32
D:1| T0: 0.10| T1: 515.00| I0: 400.0| I1: 125.0| WTP: 1000000,1,0.096153846,515,1000000,1,0.2,400,125,-2006116322,1565815291,10623.41755,1474945445,147494544.5,8,76751,3304,1108,1765,657,1108,76751,657,1765,121.8869048,3.175595238,5.077380952,53762.17857,1840.910714,8.375,99013.96131,0.540680734,0.018513514,8.60053E-05,0.37223796,0.022996443,48,16
D:1| T0: 0.10| T1: 515.00| I0: 400.0| I1: 125.0| WTP: 1000000,1,0.096153846,515,1000000,1,0.2,400,125,-3662046819,784442364,5708.11003,3376641317,337664131.7,20,49344,2163,948,948,0,948,49344,0,948,18.08087731,0.461274846,0.461274846,69085.81563,178.0185058,1.106237149,99406.96847,0.694540766,0.001790158,1.3048E-05,0,0.019212062,208,38
D:1| T0: 0.10| T1: 515.00| I0: 400.0| I1: 125.0| WTP: 1000000,1,0.096153846,515,1000000,1,0.2,400,125,-1328696419,206369745,10808.1209,788290373.8,78829037.38,4,89831,3978,651,1795,1144,651,89831,1144,1795,221.8854626,2.748898678,7.735682819,43566.67401,1652.828194,10.59911894,98966.01322,0.437483646,0.016592473,0.000108216,0.637325905,0.019981966,33,8
D:1| T0: 0.10| T1: 515.00| I0: 400.0| I1: 125.0| WTP: 1000000,1,0.096153846,515,1000000,1,0.2,400,125,-1399854953,2087235992,12154.60119,792124894.1,79212489.41,4,96085,4163,716,2019,1303,716,96085,1303,2019,244.4439252,3.271028037,9.299065421,35212.33178,1958.341121,12.64485981,98751.13084,0.353717758,0.019681409,0.000128441,0.645368995,0.021012645,31,8
D:1| T0: 0.10| T1: 515.00| I0: 400.0| I1: 125.0| WTP: 1000000,1,0.096153846,515,1000000,1,0.2,400,125,-1874302414,1019092536,8235.211007,1462541864,146254186.4,8,65273,2730,1150,1368,218,1150,65273,218,1368,37.9877095,1.147486034,1.381005587,46684.53073,401.9776536,2.654748603,98910.53184,0.471292259,0.004043971,2.82988E-05,0.159356725,0.020958451,128,16
D:1| T0: 0.10| T1: 515.00| I0: 400.0| I1: 125.0| WTP: 1000000,1,0.096153846,515,1000000,1,0.2,400,125,-1516146340,1885906113,8126.405233,1109826079,110982607.9,6,62004,2636,1026,1350,324,1026,62004,324,1350,66.26868687,1.884848485,2.525252525,53878.5596,383.0848485,4.612121212,99027.85657,0.543218206,0.00385044,4.82333E-05,0.24,0.021774545,71,12
D:1| T0: 0.10| T1: 515.00| I0: 400.0| I1: 125.0| WTP: 1000000,1,0.096153846,515,1000000,1,0.2,400,125,-2936427960,2028637200,8350.801954,2518887862,251888786.2,16,65020,2950,1370,1387,17,1370,65020,17,1387,35.74463938,1.133528265,1.150097466,56817.81774,245.2280702,2.479532164,99092.42105,0.572645111,0.002469269,2.70329E-05,0.012256669,0.021332554,147,28
D:1| T0: 0.10| T1: 515.00| I0: 400.0| I1: 125.0| WTP: 1000000,1,0.096153846,515,1000000,1,0.2,400,125,-1364907365,181476086,11452.03695,792305517.9,79230551.79,4,93283,4189,738,1902,1164,738,93283,1164,1902,253.8792271,3.487922705,9.038647343,41593.16425,2103.729469,12.61352657,98916.02899,0.417604489,0.021124338,0.000128072,0.611987382,0.020389567,30,8
D:1| T0: 0.10| T1: 515.00| I0: 400.0| I1: 125.0| WTP: 1000000,1,0.096153846,515,1000000,1,0.2,400,125,-1373254053,2097578470,11685.14698,788996704.4,78899670.44,4,89677,4071,709,1941,1232,709,89677,1232,1941,204.465587,2.761133603,7.71659919,39028.49798,1979.57085,10.57894737,98772.87449,0.392509754,0.019896899,0.00010786,0.634724369,0.021644346,36,8
D:1| T0: 0.10| T1: 515.00| I0: 400.0| I1: 125.0| WTP: 1000000,1,0.096153846,515,1000000,1,0.2,400,125,-1912530852,119646392,8909.355244,1467063090,146706309,8,66475,2877,1148,1480,332,1148,66475,332,1480,80.0372807,2.401315789,3.10745614,54870.66009,920.9802632,5.61622807,99036.08114,0.55261572,0.009258779,5.79312E-05,0.224324324,0.022264009,66,16
D:1| T0: 0.10| T1: 515.00| I0: 400.0| I1: 125.0| WTP: 1000000,1,0.096153846,515,1000000,1,0.2,400,125,-1370247682,1298895859,11601.48818,790173272.4,79017327.24,4,93306,4115,776,1927,1151,776,93306,1151,1927,241.3113208,3.566037736,8.938679245,37637.36321,1834.410377,12.61320755,98806.64151,0.378343302,0.018428409,0.000128055,0.597301505,0.020652477,31,8
D:1| T0: 0.10| T1: 515.00| I0: 400.0| I1: 125.0| WTP: 1000000,1,0.096153846,515,1000000,1,0.2,400,125,-1281086956,1489316290,10024.69192,779852360.3,77985236.03,4,79345,3565,660,1665,1005,660,79345,1005,1665,180.0277778,2.492063492,6.44047619,46518.76587,1094.714286,9.075396825,98935.94841,0.468242795,0.010993592,9.26423E-05,0.603603604,0.020984309,36,8
D:1| T0: 0.10| T1: 515.00| I0: 400.0| I1: 125.0| WTP: 1000000,1,0.096153846,515,1000000,1,0.2,400,125,-1452302520,855602142,13311.86476,786709281.5,78670928.15,4,96804,3861,655,2212,1557,655,96804,1557,2212,211.2857143,2.761904762,9.454545455,32627.65368,1496.593074,12.29004329,98553.32468,0.327857515,0.015056015,0.000124876,0.703887884,0.022850295,33,8
D:1| T0: 0.10| T1: 515.00| I0: 400.0| I1: 125.0| WTP: 1000000,1,0.096153846,515,1000000,1,0.2,400,125,-1814548709,1438649896,8640.058816,1382545768,138254576.8,8,69989,3087,1053,1435,382,1053,69989,382,1435,62.58995138,1.585089141,2.196110211,45529.67585,577.2155592,3.904376013,98911.89465,0.459269985,0.00580605,4.0552E-05,0.266202091,0.020503222,88,15
D:1| T0: 0.10| T1: 515.00| I0: 400.0| I1: 125.0| WTP: 1000000,1,0.096153846,515,1000000,1,0.2,400,125,-4877362913,952489126,7233.362173,4515694804,451569480.4,26,53337,2144,1202,1202,0,1202,53337,0,1202,12.62536873,0.410521141,0.410521141,63660.34267,201.3053097,0.993608653,99197.56785,0.641232282,0.002026472,1.18846E-05,0,0.022536373,291,51
D:1| T0: 0.10| T1: 515.00| I0: 400.0| I1: 125.0| WTP: 1000000,1,0.096153846,515,1000000,1,0.2,400,125,-1139908859,1550779155,10709.2349,604447113.9,60444711.39,4,84344,3554,549,1779,1230,549,84344,1230,1779,228.5606061,2.666666667,8.833333333,31327.41919,1191.515152,11.61616162,98631.5101,0.317057843,0.011953381,0.00011807,0.691399663,0.021092194,29,6
D:1| T0: 0.10| T1: 515.00| I0: 400.0| I1: 125.0| WTP: 1000000,1,0.096153846,515,1000000,1,0.2,400,125,-4015012121,607323321,7373.87029,3646318606,364631860.6,22,54719,2428,1225,1225,0,1225,54719,0,1225,18.75282309,0.574654956,0.574654956,65276.77729,166.3933501,1.343161857,99227.5207,0.657175599,0.001675661,1.54551E-05,0,0.022387514,228,41
D:1| T0: 0.10| T1: 515.00| I0: 400.0| I1: 125.0| WTP: 1000000,1,0.096153846,515,1000000,1,0.2,400,125,-1508441244,2103646485,7946.611489,1111110670,111111067,6,62287,2719,864,1320,456,864,62287,456,1320,63.35084428,1.491557223,2.335834897,50390.0863,351.3320826,3.943714822,98970.16135,0.508481349,0.003531716,4.11747E-05,0.345454545,0.021192223,77,12
D:1| T0: 0.10| T1: 515.00| I0: 400.0| I1: 125.0| WTP: 1000000,1,0.096153846,515,1000000,1,0.2,400,125,-1187916302,258120157,9816.134032,697109600.8,69710960.08,4,86490,3877,765,1630,865,765,86490,865,1630,274.125,4.25,9.079545455,37882.96023,1249.409091,13.42045455,98913.35227,0.38198227,0.012523214,0.000136465,0.530674847,0.018846109,26,7
D:1| T0: 0.10| T1: 515.00| I0: 400.0| I1: 125.0| WTP: 1000000,1,0.096153846,515,1000000,1,0.2,400,125,-2626944558,1068951401,7490.816471,2252403734,225240373.4,14,63708,2831,1209,1244,35,1209,63708,35,1244,32.46461825,0.936685289,0.969273743,53506.94041,231.726257,2.086592179,99103.25605,0.539290571,0.002332053,2.29615E-05,0.028135048,0.01952659,154,25
D:1| T0: 0.10| T1: 515.00| I0: 400.0| I1: 125.0| WTP: 1000000,1,0.096153846,515,1000000,1,0.2,400,125,-1881809274,635956235,8361.764757,1463721036,146372103.6,8,64161,2810,1281,1389,108,1281,64161,108,1389,35.946875,1.210416667,1.323958333,49276.47813,507.6072917,2.651041667,98924.76146,0.497201967,0.0051075,2.79771E-05,0.07775378,0.021648665,137,16
D:1| T0: 0.10| T1: 515.00| I0: 400.0| I1: 125.0| WTP: 1000000,1,0.096153846,515,1000000,1,0.2,400,125,-3568450223,1346693470,5688.492439,3284025601,328402560.1,20,45622,1902,945,945,0,945,45622,0,945,15.69468729,0.453261601,0.453261601,71544.16207,158.2138534,1.088096839,99416.2347,0.719201945,0.0015911,1.27618E-05,0,0.020714145,213,37
D:1| T0: 0.10| T1: 515.00| I0: 400.0| I1: 125.0| WTP: 1000000,1,0.096153846,515,1000000,1,0.2,400,125,-1436811384,847102011,12905.10747,791556010.2,79155601.02,4,96205,4107,751,2144,1393,751,96205,1393,2144,273.8465608,3.899470899,11.17989418,35680.60317,1746.306878,15.15873016,98687.22751,0.35874908,0.017551088,0.000153949,0.649720149,0.022285744,27,8
D:1| T0: 0.10| T1: 515.00| I0: 400.0| I1: 125.0| WTP: 1000000,1,0.096153846,515,1000000,1,0.2,400,125,-1714735427,812083272,11705.96907,1129436974,112943697.4,6,83229,3514,929,1945,1016,929,83229,1016,1945,144.9046053,2.927631579,6.226973684,47286.86513,1685.930921,9.289473684,98850.78289,0.475603073,0.016966441,9.51709E-05,0.522365039,0.023369258,44,12
D:1| T0: 0.10| T1: 515.00| I0: 400.0| I1: 125.0| WTP: 1000000,1,0.096153846,515,1000000,1,0.2,400,125,-1329200586,2146825809,10784.68261,789966455.8,78996645.58,4,92017,4213,791,1791,1000,791,92017,1000,1791,304.4285714,4.642857143,10.5,37555.85714,1728.714286,15.19642857,98890.13095,0.378191999,0.017334485,0.000154162,0.558347292,0.019463795,24,8
D:1| T0: 0.10| T1: 515.00| I0: 400.0| I1: 125.0| WTP: 1000000,1,0.096153846,515,1000000,1,0.2,400,125,-1422160518,226186520,12664.04666,788958184.6,78895818.46,4,95343,4023,741,2104,1363,741,95343,1363,2104,260.0829016,3.797927461,10.79274611,37185.46114,1436.834197,14.62176166,98720.09845,0.373754352,0.014436702,0.00014812,0.647813688,0.022067692,28,8
D:1| T0: 0.10| T1: 515.00| I0: 400.0| I1: 125.0| WTP: 1000000,1,0.096153846,515,1000000,1,0.2,400,125,-1671403457,1110225441,10793.9403,1131706442,113170644.2,6,83782,3620,1052,1793,741,1052,83782,741,1793,109.9299517,2.446859903,4.200483092,41402.09903,1563.417874,6.734299517,98811.07971,0.416752734,0.015736354,6.91861E-05,0.413273843,0.021400778,60,12
D:1| T0: 0.10| T1: 515.00| I0: 400.0| I1: 125.0| WTP: 1000000,1,0.096153846,515,1000000,1,0.2,400,125,-1476708782,1190767082,8726.770981,1040370233,104037023.3,6,77819,3533,779,1449,670,779,77819,670,1449,141.0673077,2.371794872,4.483974359,48107.46795,1328.407051,6.990384615,99089.77564,0.483816933,0.013336309,7.16953E-05,0.462387854,0.018620131,45,11
D:1| T0: 0.10| T1: 515.00| I0: 400.0| I1: 125.0| WTP: 1000000,1,0.096153846,515,1000000,1,0.2,400,125,-2212943786,2108234095,8077.766464,1809055463,180905546.3,10,60123,2523,1284,1342,58,1284,60123,58,1342,33.97516199,1.205183585,1.264578834,56197.4622,396.7645788,2.660907127,99043.5432,0.566638564,0.003991683,2.85197E-05,0.043219076,0.022320909,133,20
D:1| T0: 0.10| T1: 515.00| I0: 400.0| I1: 125.0| WTP: 1000000,1,0.096153846,515,1000000,1,0.2,400,125,-1427185703,465621985,12659.72959,794199223.5,79419922.35,4,95321,4277,739,2103,1364,739,95321,1364,2103,254.4666667,3.428571429,9.880952381,29536.09524,1563.871429,13.39047619,98550.21429,0.297670185,0.015724434,0.000136115,0.648597242,0.022062295,30,8
D:1| T0: 0.10| T1: 515.00| I0: 400.0| I1: 125.0| WTP: 1000000,1,0.096153846,515,1000000,1,0.2,400,125,-2048856581,1487072553,8104.989387,1643607111,164360711.1,10,66117,2996,1241,1346,105,1241,66117,105,1346,47.94501279,1.410485934,1.539641944,53089.45908,303.6943734,3.121483376,99049.47698,0.53522799,0.00305626,3.32653E-05,0.078066914,0.020343649,112,18
D:1| T0: 0.10| T1: 515.00| I0: 400.0| I1: 125.0| WTP: 1000000,1,0.096153846,515,1000000,1,0.2,400,125,-1585188215,1213733847,9300.804262,1120148002,112014800.2,6,70532,3040,894,1545,651,894,70532,651,1545,119.8707692,2.618461538,4.593846154,51998.73538,921.44,7.335384615,99000.21846,0.523719141,0.009257401,7.54013E-05,0.421359223,0.021904951,47,12
D:1| T0: 0.10| T1: 515.00| I0: 400.0| I1: 125.0| WTP: 1000000,1,0.096153846,515,1000000,1,0.2,400,125,-1284823097,2003658337,10197.28708,774958743.2,77495874.32,4,78538,3342,749,1694,945,749,78538,945,1694,140.7766667,2.353333333,5.473333333,47004.39,1069.653333,7.96,98919.34667,0.473175567,0.010748333,8.18436E-05,0.55785124,0.021570001,43,8
D:1| T0: 0.10| T1: 515.00| I0: 400.0| I1: 125.0| WTP: 1000000,1,0.096153846,515,1000000,1,0.2,400,125,-4826783444,1170868072,6224.385083,4515564190,451556419,28,50641,2195,1034,1034,0,1034,50641,0,1034,11.32487976,0.313948404,0.313948404,63656.10101,129.0432882,0.773939659,99270.60735,0.640734694,0.001298935,9.08538E-06,0,0.020418641,327,51
D:1| T0: 0.10| T1: 515.00| I0: 400.0| I1: 125.0| WTP: 1000000,1,0.096153846,515,1000000,1,0.2,400,125,-1248387758,569919592,10946.42582,701066467.4,70106646.74,4,90927,4036,754,1818,1064,754,90927,1064,1818,253.4723618,3.698492462,8.979899497,30524.05528,1191.648241,12.79396985,98700.54774,0.30818856,0.011961138,0.000129833,0.585258526,0.019994061,29,7
D:1| T0: 0.10| T1: 515.00| I0: 400.0| I1: 125.0| WTP: 1000000,1,0.096153846,515,1000000,1,0.2,400,125,-1536052886,1833180623,8233.200098,1124392881,112439288.1,6,73609,3467,1010,1367,357,1010,73609,357,1367,94.02031603,2.119638826,2.898419865,46665.58916,775.4740406,5.162528217,99053.39278,0.469996077,0.007789716,5.39094E-05,0.261155816,0.018571099,64,12
D:1| T0: 0.10| T1: 515.00| I0: 400.0| I1: 125.0| WTP: 1000000,1,0.096153846,515,1000000,1,0.2,400,125,-1449906411,1123666637,13169.32017,791440402.2,79144040.22,4,93680,4045,755,2188,1433,755,93680,1433,2188,305.5621302,4.384615385,12.77514793,40612.14201,1667.100592,17.24260355,98739.3432,0.408409567,0.01674863,0.000174963,0.654936015,0.023356106,25,8
D:1| T0: 0.10| T1: 515.00| I0: 400.0| I1: 125.0| WTP: 1000000,1,0.096153846,515,1000000,1,0.2,400,125,-1704109548,1682024981,11412.92154,1133463471,113346347.1,6,89643,3842,764,1896,1132,764,89643,1132,1896,188.3951613,2.943548387,7.475806452,45053.7621,2954.197581,10.55241935,98945.47581,0.452364142,0.029691437,0.000107839,0.597046414,0.021150564,35,12
D:1| T0: 0.10| T1: 515.00| I0: 400.0| I1: 125.0| WTP: 1000000,1,0.096153846,515,1000000,1,0.2,400,125,-1614347386,1687523543,9853.780441,1121658364,112165836.4,6,73916,3191,910,1637,727,910,73916,727,1637,121.412844,2.660550459,4.856269113,51852.32722,863.6544343,7.617737003,98992.85015,0.521887287,0.008680329,7.82927E-05,0.44410507,0.02214736,47,12
D:1| T0: 0.10| T1: 515.00| I0: 400.0| I1: 125.0| WTP: 1000000,1,0.096153846,515,1000000,1,0.2,400,125,-1345635842,178034412,11156.26963,787822360.1,78782236.01,4,88629,4029,653,1853,1200,653,88629,1200,1853,261.5811518,3.287958115,9.523560209,46469.73822,1635.806283,12.93717277,98981.01571,0.466733283,0.016413064,0.000131658,0.647598489,0.020907378,28,8
D:1| T0: 0.10| T1: 515.00| I0: 400.0| I1: 125.0| WTP: 1000000,1,0.096153846,515,1000000,1,0.2,400,125,-1343632261,739490003,11055.20661,790871930.9,79087193.09,4,91593,4084,689,1836,1147,689,91593,1147,1836,260.4773869,3.376884422,9.085427136,41796.68844,1289.628141,12.54271357,98924.0804,0.419874794,0.012941805,0.00012734,0.624727669,0.0200452,29,8
D:1| T0: 0.10| T1: 515.00| I0: 400.0| I1: 125.0| WTP: 1000000,1,0.096153846,515,1000000,1,0.2,400,125,-1553233087,178482706,10405.85626,1032940274,103294027.4,6,74832,3109,748,1729,981,748,74832,981,1729,105.8054054,1.886486486,4.510810811,44486.69189,865.7702703,6.52972973,98771.49189,0.44878558,0.008704529,6.73512E-05,0.567379988,0.023105397,53,11
D:1| T0: 0.10| T1: 515.00| I0: 400.0| I1: 125.0| WTP: 1000000,1,0.096153846,515,1000000,1,0.2,400,125,-1531958326,1919366370,9979.550375,1032980808,103298080.8,6,71648,3083,914,1658,744,914,71648,744,1658,65.85016835,1.427609428,2.668350168,41756.26263,416.1902357,4.19023569,98679.4899,0.422029262,0.004190934,4.35861E-05,0.448733414,0.023140911,85,11
D:1| T0: 0.10| T1: 515.00| I0: 400.0| I1: 125.0| WTP: 1000000,1,0.096153846,515,1000000,1,0.2,400,125,-1350194507,1819796913,11110.46298,794671358.1,79467135.81,4,96556,4424,693,1845,1152,693,96556,1152,1845,305.4971751,3.858757062,10.31638418,39525.46893,2242.305085,14.22033898,98959.40113,0.396708982,0.022489033,0.000143838,0.624390244,0.019108082,26,8
D:1| T0: 0.10| T1: 515.00| I0: 400.0| I1: 125.0| WTP: 1000000,1,0.096153846,515,1000000,1,0.2,400,125,-1687407474,1866591913,11129.97502,1130908723,113090872.3,6,83745,3646,1088,1849,761,1088,83745,761,1849,108.7070218,2.520581114,4.319612591,44543.16949,1673.42615,6.96125908,98850.49395,0.448054997,0.016843643,7.16161E-05,0.411573824,0.02207893,59,12
D:1| T0: 0.10| T1: 515.00| I0: 400.0| I1: 125.0| WTP: 1000000,1,0.096153846,515,1000000,1,0.2,400,125,-1283167706,1219425989,11643.03443,701015984.6,70101598.46,4,90737,4104,792,1934,1142,792,90737,1142,1934,271.2054054,4.194594595,10.29189189,32771.8973,1265.313514,14.56216216,98674.60541,0.330799664,0.012702179,0.000148043,0.590486039,0.021314348,27,7
D:1| T0: 0.10| T1: 515.00| I0: 400.0| I1: 125.0| WTP: 1000000,1,0.096153846,515,1000000,1,0.2,400,125,-1375186767,502409586,11691.69309,790602112.6,79060211.26,4,94589,4132,740,1942,1202,740,94589,1202,1942,234.9086758,3.292237443,8.716894977,35365.22374,1740.424658,12.12328767,98775.38813,0.355504956,0.017480772,0.000123025,0.618949537,0.020530929,32,8
D:1| T0: 0.10| T1: 515.00| I0: 400.0| I1: 125.0| WTP: 1000000,1,0.096153846,515,1000000,1,0.2,400,125,-1298231005,1405887957,10390.66199,778697905.8,77869790.58,4,81475,3596,731,1726,995,731,81475,995,1726,190.7467811,3.017167382,7.253218884,47510.91416,1061.261803,10.39484979,98959.02575,0.477923174,0.010656147,0.000105861,0.576477404,0.021184412,34,8
D:1| T0: 0.10| T1: 515.00| I0: 400.0| I1: 125.0| WTP: 1000000,1,0.096153846,515,1000000,1,0.2,400,125,-1310750888,283033753,10772.86618,772107578.5,77210757.85,4,78441,3243,736,1790,1054,736,78441,1054,1790,159.4703557,2.754940711,6.865612648,46613.99605,821.6679842,9.794466403,98849.01581,0.469582242,0.008255853,0.000100309,0.588826816,0.022819699,37,8
D:1| T0: 0.10| T1: 515.00| I0: 400.0| I1: 125.0| WTP: 1000000,1,0.096153846,515,1000000,1,0.2,400,125,-1631707308,1083157068,10178.47526,1122783545,112278354.5,6,75552,3236,1104,1691,587,1104,75552,587,1691,82.34836066,2.096311475,3.266393443,42607.33607,785.3504098,5.540983607,98773.31967,0.429969257,0.007901423,5.76564E-05,0.347131875,0.022381936,70,12
D:1| T0: 0.10| T1: 515.00| I0: 400.0| I1: 125.0| WTP: 1000000,1,0.096153846,515,1000000,1,0.2,400,125,-1575601853,1988704626,9315.465025,1109828602,110982860.2,6,64252,2684,1092,1548,456,1092,64252,456,1548,52.1364366,1.566613162,2.290529695,49615.64045,264.8988764,4.048154093,98808.39647,0.501301032,0.002667251,4.26434E-05,0.294573643,0.024092635,89,12
D:1| T0: 0.10| T1: 515.00| I0: 400.0| I1: 125.0| WTP: 1000000,1,0.096153846,515,1000000,1,0.2,400,125,-1235553535,884761309,10818.19661,694643704,69464370.4,4,83967,3749,680,1797,1117,680,83967,1117,1797,191.8065844,2.703703704,7.279835391,29886.15226,898.345679,10.08230453,98566.96708,0.302686556,0.009023984,0.000102489,0.621591541,0.02140152,35,7
D:1| T0: 0.10| T1: 515.00| I0: 400.0| I1: 125.0| WTP: 1000000,1,0.096153846,515,1000000,1,0.2,400,125,-2279905245,533485933,7415.176021,1909146444,190914644.4,12,65699,3162,1217,1231,14,1217,65699,14,1231,47.74605103,1.286755772,1.303766707,57249.90522,216.5917375,2.760631835,99202.00851,0.576363907,0.002179364,2.98923E-05,0.011372868,0.018737537,118,21
D:1| T0: 0.10| T1: 515.00| I0: 400.0| I1: 125.0| WTP: 1000000,1,0.096153846,515,1000000,1,0.2,400,125,-1989318748,632196071,8764.063121,1551115592,155111559.2,10,66174,2816,1371,1456,85,1371,66174,85,1456,52.57076923,1.910769231,2.035384615,57452.12615,263.6984615,4.138461538,99085.57846,0.578903034,0.002654629,4.37469E-05,0.058379121,0.022003264,93,17
D:1| T0: 0.10| T1: 515.00| I0: 400.0| I1: 125.0| WTP: 1000000,1,0.096153846,515,1000000,1,0.2,400,125,-1367451527,393400457,11482.34108,793334472.9,79333447.29,4,94442,4189,581,1907,1326,581,94442,1326,1907,266.935,2.815,9.385,40691.735,1473.695,12.275,98891.985,0.408448052,0.014792933,0.000124897,0.695332984,0.020192287,29,8
D:1| T0: 0.10| T1: 515.00| I0: 400.0| I1: 125.0| WTP: 1000000,1,0.096153846,515,1000000,1,0.2,400,125,-1308958325,398973227,10671.83767,775366441.6,77536644.16,4,79252,3307,687,1773,1086,687,79252,1086,1773,156.6273063,2.420664207,6.383763838,44968.54613,876.2804428,8.915129151,98833.99631,0.453017302,0.00880499,9.123E-05,0.612521151,0.02237224,39,8
D:1| T0: 0.10| T1: 515.00| I0: 400.0| I1: 125.0| WTP: 1000000,1,0.096153846,515,1000000,1,0.2,400,125,-1632435487,1402256491,10019.10245,1131480364,113148036.4,6,81489,3659,898,1664,766,898,81489,766,1664,145.1238095,2.720634921,5.126984127,46008.50794,1633.187302,7.984126984,98967.87302,0.462769249,0.016412544,8.17556E-05,0.460336538,0.020419934,45,12
D:1| T0: 0.10| T1: 515.00| I0: 400.0| I1: 125.0| WTP: 1000000,1,0.096153846,515,1000000,1,0.2,400,125,-1417702314,2102527413,12585.78621,788413003.6,78841300.36,4,91625,3900,698,2091,1393,698,91625,1393,2091,198.4365079,2.662698413,8.154761905,39848.72619,2102.353175,10.92063492,98734.33333,0.400390378,0.021147796,0.000111369,0.666188427,0.022821282,36,8
D:1| T0: 0.10| T1: 515.00| I0: 400.0| I1: 125.0| WTP: 1000000,1,0.096153846,515,1000000,1,0.2,400,125,-1376646080,1748031099,11822.1405,785539054.7,78553905.47,4,91504,3881,672,1964,1292,672,91504,1292,1964,205.0805085,2.737288136,8.177966102,38983.5339,2100.516949,11.00847458,98797.72458,0.39176593,0.021109395,0.000112304,0.657841141,0.021464012,34,8
D:1| T0: 0.10| T1: 515.00| I0: 400.0| I1: 125.0| WTP: 1000000,1,0.096153846,515,1000000,1,0.2,400,125,-1773041693,1946754629,7917.645678,1377159409,137715940.9,8,62689,2791,1079,1315,236,1079,62689,236,1315,50.22457627,1.357344633,1.676553672,50949.50282,339.2612994,3.216101695,98999.26836,0.513942736,0.003411154,3.39925E-05,0.179467681,0.020976567,102,15
D:1| T0: 0.10| T1: 515.00| I0: 400.0| I1: 125.0| WTP: 1000000,1,0.096153846,515,1000000,1,0.2,400,125,-1513576986,2097712204,8013.258541,1112914059,111291405.9,6,64921,2912,1013,1331,318,1013,64921,318,1331,62.7920434,1.638336347,2.198915009,51456.95118,366.3562387,4.048824593,99031.05606,0.518807863,0.003683309,4.25992E-05,0.238918107,0.020501841,79,12
D:1| T0: 0.10| T1: 515.00| I0: 400.0| I1: 125.0| WTP: 1000000,1,0.096153846,515,1000000,1,0.2,400,125,-1885383761,1198827119,8427.924174,1463987552,146398755.2,8,61458,2695,1235,1400,165,1235,61458,165,1400,46.82479784,1.517520216,1.735849057,54867.54582,532.3989218,3.396226415,98998.42453,0.553175636,0.005355092,3.57125E-05,0.117857143,0.022779785,106,16
D:1| T0: 0.10| T1: 515.00| I0: 400.0| I1: 125.0| WTP: 1000000,1,0.096153846,515,1000000,1,0.2,400,125,-3771998302,109253198,6229.331607,3460531722,346053172.2,20,47631,1997,1035,1035,0,1035,47631,0,1035,12.12999494,0.352048558,0.352048558,70261.67274,168.7723824,0.881638847,99353.77795,0.706658839,0.00169826,1.05195E-05,0,0.021729546,282,39
D:1| T0: 0.10| T1: 515.00| I0: 400.0| I1: 125.0| WTP: 1000000,1,0.096153846,515,1000000,1,0.2,400,125,-2799123084,314481292,7537.107589,2422267705,242226770.5,16,59936,2590,1247,1252,5,1247,59936,5,1252,29.35541045,0.972014925,0.975746269,59849.70149,166.6669776,2.145522388,99168.05597,0.602840642,0.001678045,2.34363E-05,0.00399361,0.020888948,154,27
