Scenario,Decision Rule,Time of starting social distancing,Duration of Social Distancing,WTP,R_t Switch threshold if social distancing is off,R_t Switch threshold if social distancing is on,% I Switch threshold if social distancing is off,% I Switch threshold if social distancing is on,Objective Function,RNG Seed,DALY,Total Cost,Annual Cost,Number of Switches,Total New: I,Total New: H,Total New: ICU,Total New: ICU-Queue,Total New: COVID Death | Waiting for ICU,Total New: COVID Death | Not Waiting for ICU,Total: Incident,Total: COVID Death | Waiting for ICU,Total: COVID-Death,Average Size: H,Average Size: ICU,Average Size: ICU-Queue,Averge size: S,Averge size: I,Averge size: Waiting for or in ICU,Averge size: Population size,Average ratio: % Susceptible,Average ratio: % Infectious,Average ratio: % Waiting for or in ICU,Average ratio: % Death While Waiting for ICU,Average ratio: Case-fatality,Utilization (unit of time): Default,Utilization (unit of time): Social Distancing
Base,0,10,0,0,0,0,0,0,-617314354,1178568022,10828.61095,75883806.41,7588380.641,0,81991,3539,950,1799,849,950,81991,849,1799,137.2579618,2.917197452,5.582802548,56509.78344,1341.041401,8.589171975,99121.03503,0.567165912,0.013485093,8.80556E-05,0.471928849,0.021941433,44,0
Base,0,10,0,0,0,0,0,0,-695200574.1,2029998696,12005.65528,94917810.29,9491781.029,0,98264,4412,479,1994,1515,479,98264,1515,1994,280.8826531,2.37755102,10.06122449,31707.22959,1694.683673,12.51020408,98719.52041,0.281958529,0.017921992,0.000133548,0.759779338,0.020292274,27,0
Base,0,10,0,0,0,0,0,0,-754810398.7,776062361,13301.19084,89750856.92,8975085.692,0,98223,4202,637,2210,1573,637,98223,1573,2210,217.7542373,2.618644068,9.233050847,42308.02119,2582.466102,11.93644068,98829.44492,0.355913367,0.029048319,0.00013578,0.711764706,0.022499822,30,0
Base,0,10,0,0,0,0,0,0,-632979343.9,1813046880,11099.57292,78000698.05,7800069.805,0,83445,3511,981,1844,863,981,83445,863,1844,152.962069,3.25862069,6.175862069,56734.86207,1826.32069,9.572413793,99123.13793,0.569341545,0.018370334,9.79801E-05,0.468004338,0.022098388,42,0
Base,0,10,0,0,0,0,0,0,-612070786,2032407216,10555.00822,84320374.91,8432037.491,0,87730,3910,680,1753,1073,680,87730,1073,1753,237.2780488,3.23902439,8.414634146,51715.37561,1495.82439,11.72682927,99119.54634,0.486388281,0.01602248,0.000127166,0.612093554,0.019981762,28,0
Base,0,10,0,0,0,0,0,0,-561498180.2,1507873352,9930.362108,64980074.8,6498007.48,0,71651,2930,1164,1650,486,1164,71651,486,1650,79.22173913,2.4,3.430434783,68619.32826,1128.784783,5.969565217,99330.06522,0.675720983,0.011816048,6.40466E-05,0.294545455,0.02302829,63,0
Base,0,10,0,0,0,0,0,0,-545732523.1,1855899401,9511.581761,70153435.09,7015343.509,0,74059,3232,943,1580,637,943,74059,637,1580,118.7738095,2.702380952,4.556547619,55602.33036,827.5119048,7.354166667,99105.84524,0.5576231,0.008340362,7.56842E-05,0.403164557,0.021334342,48,0
Base,0,10,0,0,0,0,0,0,-698116260.2,1819459251,12248.90771,85670874.69,8567087.469,0,94027,4049,596,2035,1439,596,94027,1439,2035,282.4885057,3.327586207,11.54022989,41151.57471,1939.591954,14.95977011,98846.42529,0.413198444,0.01946725,0.000151861,0.707125307,0.02164272,25,0
Base,0,10,0,0,0,0,0,0,-555831137.5,909791748,9638.903499,73885962.58,7388596.258,0,75990,3337,883,1601,718,883,75990,718,1601,144.6883562,2.938356164,5.352739726,55376.63356,845.0273973,8.380136986,99120.30137,0.556453283,0.008486946,8.54538E-05,0.448469706,0.021068562,42,0
Base,0,10,0,0,0,0,0,0,-705277199.6,1339092841,12511.2541,79714494.6,7971449.46,0,88559,3668,650,2079,1429,650,88559,1429,2079,242.8342246,3.374331551,10.96256684,46415.67914,1700.374332,14.43315508,98842.6738,0.46640418,0.017082808,0.000146656,0.687349687,0.023475875,27,0
Base,0,10,0,0,0,0,0,0,-727335922.2,1365866345,12642.327,95219572.09,9521957.209,0,98911,4412,491,2100,1609,491,98911,1609,2100,263.569378,2.277511962,9.928229665,47173.92344,1480.210526,12.28229665,98982.79426,0.307192879,0.019521242,0.000163629,0.766190476,0.021231208,23,0
Base,0,10,0,0,0,0,0,0,-666696783.1,825453433,11441.15592,94638986.97,9463898.697,0,93935,4242,655,1900,1245,655,93935,1245,1900,270.3596059,3.118226601,9.187192118,42220.30049,2354.507389,12.4137931,98948.53202,0.423656396,0.023636044,0.00012643,0.655263158,0.020226753,29,0
Base,0,10,0,0,0,0,0,0,-728451839.3,939711378,12695.84445,93659616.78,9365961.678,0,98897,4387,449,2109,1660,449,98897,1660,2109,336.2795031,2.714285714,12.95652174,30668.30435,2413.645963,15.74534161,98655.29814,0.308199101,0.024218371,0.00015955,0.787102892,0.021325217,23,0
Base,0,10,0,0,0,0,0,0,-663599370.3,638950699,11475.6419,89817275.17,8981727.517,0,92702,4181,793,1906,1113,793,92702,1113,1906,227.7444934,3.370044053,8.202643172,44253.14537,2570.008811,11.71365639,98970.36564,0.444060988,0.025822641,0.000119507,0.583945435,0.020560506,33,0
Base,0,10,0,0,0,0,0,0,-621494453.1,938699148,10747.1414,84137382.84,8413738.284,0,86981,3864,724,1785,1061,724,86981,1061,1785,197.7959184,2.865306122,7.151020408,52813.24082,1194.722449,10.11020408,99106.71837,0.481288743,0.013239532,0.000113513,0.594397759,0.020521723,32,0
Base,0,10,0,0,0,0,0,0,-568529313,121790188,9778.923271,79583149.44,7958314.944,0,80993,3572,1010,1624,614,1010,80993,614,1624,128.4591549,2.74084507,4.43943662,58222.61127,1649.453521,7.256338028,99226.88169,0.584111724,0.016580231,7.45874E-05,0.378078818,0.020051116,50,0
Base,0,10,0,0,0,0,0,0,-719006687.6,1331335240,12521.54221,92929577.28,9292957.728,0,98109,4303,642,2080,1438,642,98109,1438,2080,242.1809955,2.850678733,9.298642534,37447.52036,2919.371041,12.17647059,98803.88235,0.336659633,0.031169551,0.000131599,0.691346154,0.021200909,30,0
Base,0,10,0,0,0,0,0,0,-758771517.8,470935411,13326.06748,92468143.6,9246814.36,0,98975,4158,470,2214,1744,470,98975,1744,2214,302.8465909,2.596590909,12.47727273,35632,1455.460227,15.125,98680.1875,0.270936276,0.016588043,0.000173941,0.787714544,0.022369285,23,0
Base,0,10,0,0,0,0,0,0,-716564045.7,823434397,12668.54484,83136803.63,8313680.363,0,91798,3750,709,2105,1396,709,91798,1396,2105,220.6186047,3.227906977,9.651162791,46808.49767,2193.618605,12.93953488,98895.94884,0.469692775,0.022052463,0.000131646,0.663182898,0.022930783,31,0
Base,0,10,0,0,0,0,0,0,-562850724.8,493045351,9723.849831,76658233.25,7665823.325,0,78717,3460,819,1615,796,819,78717,796,1615,163.0333333,2.922222222,5.840740741,54338.93704,740.1259259,8.885185185,99125.22593,0.542467537,0.007488666,9.12173E-05,0.492879257,0.020516534,39,0
Base,0,10,0,0,0,0,0,0,-605772953.6,1700216563,10334.36868,89054519.44,8905451.944,0,88673,4155,758,1716,958,758,88673,958,1716,201.9960784,2.898039216,6.6,48117.67843,1878.6,9.568627451,99071.76078,0.482862414,0.018870697,9.74648E-05,0.558275058,0.019352001,37,0
Base,0,10,0,0,0,0,0,0,-564749685.8,1744119059,9677.077485,80895811.55,8089581.155,0,86383,3836,640,1607,967,640,86383,967,1607,210.6396396,2.792792793,7.099099099,41744.62613,1075.806306,9.990990991,98983.54955,0.419794633,0.010792738,0.000101565,0.601742377,0.018603197,32,0
Base,0,10,0,0,0,0,0,0,-626532959.2,2036906360,10902.51794,81407062.38,8140706.238,0,84696,3657,1015,1811,796,1015,84696,796,1811,122.591029,2.580474934,4.643799472,52291.58575,1558.707124,7.303430079,99052.75198,0.501253436,0.016462144,7.87683E-05,0.439536168,0.021382356,51,0
Base,0,10,0,0,0,0,0,0,-627914997.2,809704121,10766.91401,89569296.58,8956929.658,0,91325,4175,744,1788,1044,744,91325,1044,1788,230.0044444,3.2,7.795555556,49393.05778,2102.137778,11.11111111,99107.21778,0.490754319,0.02129521,0.000114045,0.583892617,0.019578643,31,0
Base,0,10,0,0,0,0,0,0,-689876992.3,1219866412,11874.03504,96175240.13,9617524.013,0,98384,4371,666,1972,1306,666,98384,1306,1972,262.6792453,3.04245283,9.150943396,31383.17453,3812.504717,12.30660377,98763.44811,0.315146158,0.038296738,0.000125074,0.662271805,0.02004391,31,0
Base,0,10,0,0,0,0,0,0,-566746625.8,843498920,9866.95088,73399081.83,7339908.183,0,77365,3362,927,1639,712,927,77365,712,1639,138.0924092,2.95709571,5.254125413,55798.29043,1227.316832,8.320132013,99125.09241,0.560535675,0.012331531,8.50998E-05,0.434411226,0.021185291,44,0
Base,0,10,0,0,0,0,0,0,-760215563.1,107351963,13509.84965,84723080.42,8472308.042,0,93459,3855,828,2245,1417,828,93459,1417,2245,208.9913043,3.517391304,9.613043478,44414.20435,2832.965217,13.20434783,98801.62609,0.443306638,0.028636599,0.000135118,0.631180401,0.024021229,33,0
Base,0,10,0,0,0,0,0,0,-662511521.7,773789021,11439.85065,90518989.38,9051898.938,0,92985,4130,770,1900,1130,770,92985,1130,1900,223.9699571,3.197424893,8.004291845,45276.00858,2705.004292,11.32618026,98993.23176,0.449447407,0.027413046,0.000116181,0.594736842,0.020433403,33,0
Base,0,10,0,0,0,0,0,0,-735732877.5,850936611,13041.05973,83679891.14,8367989.114,0,91161,3774,747,2167,1420,747,91161,1420,2167,194.5265306,2.942857143,8.681632653,46095.76327,1952.579592,11.76326531,98819.50612,0.430287487,0.020835212,0.000126969,0.655283802,0.02377113,33,0
Base,0,10,0,0,0,0,0,0,-692568809,1701318364,12111.26951,87005333.61,8700533.361,0,92608,4009,676,2012,1336,676,92608,1336,2012,242.4902913,3.189320388,9.626213592,43138.96117,1910.849515,12.9223301,98875.82524,0.398177485,0.020376164,0.000139228,0.664015905,0.021725985,28,0
Base,0,10,0,0,0,0,0,0,-589506263.2,778708269,10270.23691,75994417.89,7599441.789,0,77483,3411,1125,1706,581,1125,77483,581,1706,112.9921466,2.832460733,4.306282723,61684.50785,1556.850785,7.248691099,99221.54712,0.616024109,0.015784522,7.51394E-05,0.34056272,0.022017733,55,0
Base,0,10,0,0,0,0,0,0,-667335589.2,1391938506,11813.69249,76650964.47,7665096.447,0,83791,3454,768,1963,1195,768,83791,1195,1963,208.5933014,3.545454545,9.19138756,49894.73684,1431.320574,12.8708134,98915.23445,0.501575178,0.014382938,0.000131325,0.608762099,0.023427337,30,0
Base,0,10,0,0,0,0,0,0,-518340134.3,43418681,9030.118199,66834224.31,6683422.431,0,68458,3066,1060,1500,440,1060,68458,440,1500,102.3351351,2.748648649,3.889189189,61848.52432,1030.340541,6.754054054,99220.35405,0.621433735,0.010350307,6.95197E-05,0.293333333,0.021911245,53,0
Base,0,10,0,0,0,0,0,0,-749550521.1,817384966,13187.18309,90191366.49,9019136.649,0,98186,4148,465,2191,1726,465,98186,1726,2191,253.1902439,2.209756098,10.58536585,23011.73659,1303.780488,12.84878049,98381.66341,0.220545355,0.013294958,0.00013225,0.787768142,0.02231479,29,0
Base,0,10,0,0,0,0,0,0,-720616972.6,762053968,12522.00461,94516742,9451674.2,0,97860,4382,507,2080,1573,507,97860,1573,2080,323.3491124,2.952662722,12.20118343,30718.36095,1809.591716,15.20118343,98656.75148,0.300627422,0.018376546,0.000155577,0.75625,0.021254854,24,0
Base,0,10,0,0,0,0,0,0,-664653268.8,1692506311,11487.82279,90262129.47,9026212.947,0,91311,4147,818,1908,1090,818,91311,1090,1908,177.9109589,2.719178082,6.400684932,46499.97945,2075.506849,9.212328767,98971.54795,0.437708372,0.022004105,9.89969E-05,0.571278826,0.02089562,39,0
Base,0,10,0,0,0,0,0,0,-532247164.8,1037620300,9300.43547,67225391.33,6722539.133,0,71917,3080,928,1545,617,928,71917,617,1545,109.7557471,2.545977011,4.281609195,69201.1408,872.9568966,6.954022989,99381.73563,0.6403694,0.01030799,8.39115E-05,0.399352751,0.021483099,43,0
Base,0,10,0,0,0,0,0,0,-634659062.3,301400999,11052.78363,82019880.55,8201988.055,0,84013,3657,821,1836,1015,821,84013,1015,1836,191.9510204,3.240816327,7.318367347,49291.91837,1418.718367,10.67346939,98973.35102,0.495349725,0.014257306,0.000108998,0.552832244,0.021853761,35,0
Base,0,10,0,0,0,0,0,0,-718769186,1868336855,12509.64306,93287033.1,9328703.31,0,97065,4219,596,2078,1482,596,97065,1482,2078,244.7818182,2.622727273,9.309090909,31378.4,1717.85,12.03181818,98641.36818,0.315295723,0.01726577,0.000122245,0.713185756,0.021408335,32,0
Base,0,10,0,0,0,0,0,0,-732907138.9,1868498144,12845.08639,90652819.26,9065281.926,0,96366,4215,639,2134,1495,639,96366,1495,2134,265.5612245,3.178571429,10.75510204,35889.26531,2046.505102,14,98711.09694,0.360445977,0.020562939,0.00014226,0.700562324,0.02214474,28,0
Base,0,10,0,0,0,0,0,0,-575823523.6,2101566889,9976.219416,77012552.79,7701255.279,0,79895,3525,949,1657,708,949,79895,708,1657,147.2809365,3.036789298,5.347826087,53873.28428,1511.956522,8.56187291,99108.48161,0.54116444,0.015195255,8.75897E-05,0.427278214,0.02074024,43,0
Base,0,10,0,0,0,0,0,0,-741864385.9,1665097450,13007.42655,91493058.35,9149305.835,0,98719,4249,439,2161,1722,439,98719,1722,2161,270.5538462,2.2,10.97948718,40847.35385,1735.358974,13.24102564,98806.04103,0.280851358,0.021227854,0.000163217,0.796853309,0.021890416,23,0
Base,0,10,0,0,0,0,0,0,-662826836.7,1716179948,11345.28405,95562634.37,9556263.437,0,99095,4423,486,1884,1398,486,99095,1398,1884,334.8915663,2.873493976,11.22891566,28923.22892,2058.084337,14.15060241,98773.43976,0.290764589,0.020632686,0.000143238,0.742038217,0.019012059,24,0
Base,0,10,0,0,0,0,0,0,-634158888.6,1560278715,11294.9511,69411333.74,6941133.374,0,75833,3087,910,1877,967,910,75833,967,1877,149.2480916,3.366412214,7.019083969,64183.09542,984.5992366,10.49236641,99183.04198,0.616514747,0.010671048,0.000115289,0.515183804,0.024752084,34,0
Base,0,10,0,0,0,0,0,0,-747816425.2,991019385,13133.49717,91141566.96,9114156.696,0,98318,4162,583,2182,1599,583,98318,1599,2182,283.1027027,3.075675676,11.67567568,34587.07568,3157.908108,14.82702703,98695.38919,0.347170772,0.031726455,0.000150272,0.732813932,0.022193291,27,0
Base,0,10,0,0,0,0,0,0,-736947521.3,118052103,12946.83231,89605905.81,8960590.581,0,96633,4227,656,2151,1495,656,96633,1495,2151,232.3438914,2.895927602,9.610859729,46855.69683,2203.0181,12.57918552,98941,0.416832852,0.024345991,0.000140456,0.69502557,0.022259477,29,0
Base,0,10,0,0,0,0,0,0,-761282297.9,1209758844,13504.17446,86073574.87,8607357.487,0,95860,3925,560,2244,1684,560,95860,1684,2244,261.7340426,2.893617021,11.80319149,45112.64894,1493.898936,14.77659574,98823.84574,0.364886585,0.017415983,0.000173952,0.750445633,0.023409138,24,0
Base,0,10,0,0,0,0,0,0,-603237954.8,70671723,10534.61071,76507419.43,7650741.943,0,79500,3436,1022,1750,728,1022,79500,728,1750,126.8425656,2.89212828,4.976676385,52954.3965,1422.102041,7.950437318,99034.01166,0.526653316,0.014469659,8.2242E-05,0.416,0.022012579,49,0
Base,0,10,0,0,0,0,0,0,-540962547.2,1722612191,9315.090036,75208045.35,7520804.535,0,75249,3375,1019,1547,528,1019,75249,528,1547,118.8314917,2.696132597,4.132596685,62690.39227,1147.138122,6.955801105,99292.93923,0.626964079,0.011590223,7.1633E-05,0.341305753,0.020558686,51,0
Base,0,10,0,0,0,0,0,0,-505605872.8,1968291596,8624.167481,74397498.72,7439749.872,0,72131,3360,929,1432,503,929,72131,503,1432,106.945,2.22,3.445,57257.275,721.1825,5.78,99191.8425,0.563316224,0.007450029,6.09729E-05,0.351256983,0.019852768,56,0
Base,0,10,0,0,0,0,0,0,-772151892.3,1877569084,13602.18262,92042761.34,9204276.134,0,98978,4152,490,2260,1770,490,98978,1770,2260,281.6170213,2.54787234,11.92553191,29500.15426,1681.037234,14.52659574,98514.78723,0.257095747,0.017838756,0.000155355,0.783185841,0.022833357,26,0
Base,0,10,0,0,0,0,0,0,-764972838.5,1726322189,13517.13775,89115951.13,8911595.113,0,98174,4184,534,2246,1712,534,98174,1712,2246,285.2346369,2.905027933,12.40782123,31439.22346,1864.782123,15.40782123,98566.62011,0.292345127,0.019382542,0.000161555,0.762243989,0.022877748,25,0
Base,0,10,0,0,0,0,0,0,-717132070.7,307848836,12491.35485,92564327.97,9256432.797,0,97357,4267,534,2075,1541,534,97357,1541,2075,290.4565217,2.820652174,11.14673913,31311.40761,1866.521739,14.05978261,98654.40761,0.314746647,0.018741872,0.000142482,0.742650602,0.021313311,27,0
Base,0,10,0,0,0,0,0,0,-694525647.2,1154000220,11975.86493,95732400.98,9573240.098,0,99096,4501,433,1989,1556,433,99096,1556,1989,279.3467337,2.115577889,9.899497487,19816.96985,1299.366834,12.08040201,98487.13568,0.19993622,0.013043102,0.000122288,0.782302665,0.020071446,29,0
Base,0,10,0,0,0,0,0,0,-547749686.8,2028661055,9506.31472,72433950.83,7243395.083,0,76239,3296,920,1579,659,920,76239,659,1579,131.7038217,2.821656051,4.869426752,55277.23248,1272.031847,7.808917197,99128.59236,0.555444398,0.012779928,7.99557E-05,0.417352755,0.020711185,45,0
Base,0,10,0,0,0,0,0,0,-689686172.2,1629114640,11903.54156,94509094.32,9450909.432,0,95836,4325,727,1977,1250,727,95836,1250,1977,227.3708333,2.95,8.104166667,36434.00417,2492.175,11.14166667,98809.53333,0.365746896,0.02504853,0.000113312,0.632271118,0.020628991,35,0
Base,0,10,0,0,0,0,0,0,-750778153.5,1439048174,13181.69957,91693175.13,9169317.513,0,98793,4165,519,2190,1671,519,98793,1671,2190,323.809816,3.116564417,13.3190184,32092.77914,2579.619632,16.50306748,98638.17178,0.309780631,0.026386221,0.000170097,0.763013699,0.022167562,23,0
Base,0,10,0,0,0,0,0,0,-761713588,865227006,13439.25341,89750917.52,8975091.752,0,99233,4139,438,2233,1795,438,99233,1795,2233,289.8876404,2.393258427,12.44382022,36498.20787,1498.179775,14.91573034,98688.94382,0.248399924,0.017835693,0.000178847,0.803851321,0.022502595,22,0
Base,0,10,0,0,0,0,0,0,-711807955.5,890479738,12341.98599,94708656.16,9470865.616,0,97864,4288,672,2050,1378,672,97864,1378,2050,251.9354839,3.01843318,9.30875576,34474.97235,3230.56682,12.40552995,98759.06452,0.346010264,0.032472051,0.000126141,0.672195122,0.020947437,31,0
Base,0,10,0,0,0,0,0,0,-609307656.5,1017049163,10554.14155,81600579.04,8160057.904,0,83746,3728,717,1753,1036,717,83746,1036,1753,213.5136364,3.140909091,7.777272727,51424.03636,1362.140909,11.04090909,99057.67273,0.516459805,0.013676023,0.000112735,0.59098688,0.020932343,32,0
Base,0,10,0,0,0,0,0,0,-530456542.1,1707305064,9063.517842,77280649.97,7728064.997,0,76051,3475,958,1505,547,958,76051,547,1505,130.5970588,2.723529412,4.291176471,59943.52059,1170.729412,7.102941176,99263.08235,0.589573523,0.01211463,7.49681E-05,0.36345515,0.019789352,48,0
Base,0,10,0,0,0,0,0,0,-763226687,400145663,13410.17616,92717879,9271787.9,0,99088,4284,408,2228,1820,408,99088,1820,2228,293.7417582,2.181318681,12.15384615,20558.84615,1460.549451,14.41208791,98322.45604,0.207477744,0.01467035,0.000145634,0.816876122,0.022485064,26,0
Base,0,10,0,0,0,0,0,0,-627991242,1662654181,10891.06185,83438149.64,8343814.964,0,86021,3770,744,1809,1065,744,86021,1065,1809,197.5349794,2.962962963,7.296296296,51404.48971,1448.872428,10.34979424,99062.19753,0.515931599,0.014553019,0.00010558,0.588723051,0.021029749,35,0
Base,0,10,0,0,0,0,0,0,-723120148.6,182136456,12564.16388,94911954.51,9491195.451,0,98897,4399,492,2087,1595,492,98897,1595,2087,293.5775401,2.582887701,11.06417112,26820.27273,1832.775401,13.68449198,98573.13904,0.249806983,0.018904701,0.00014239,0.764254911,0.021102763,26,0
Base,0,10,0,0,0,0,0,0,-510805827.8,979575387,8749.985431,73306556.27,7330655.627,0,73446,3306,1071,1453,382,1071,73446,382,1453,114.510929,2.81420765,3.816939891,60939.7541,1352.377049,6.759562842,99283.5929,0.611757537,0.013584382,6.92741E-05,0.262904336,0.019783242,53,0
Base,0,10,0,0,0,0,0,0,-752865721.7,2142525414,13253.29308,90201067.86,9020106.786,0,97981,4132,577,2202,1625,577,97981,1625,2202,282.9071038,3.076502732,11.90163934,41529.85246,2099.333333,15.04918033,98821.76503,0.371897656,0.022698971,0.000164296,0.737965486,0.022473745,25,0
Base,0,10,0,0,0,0,0,0,-669374779.2,1464057597,11595.62435,89593561.73,8959356.173,0,94756,4165,637,1926,1289,637,94756,1289,1926,250.9466019,3.009708738,9.203883495,42277.09709,1719.048544,12.31553398,98932.28641,0.421312851,0.017348916,0.000125611,0.669262721,0.02032589,30,0
Base,0,10,0,0,0,0,0,0,-717781660.4,364562610,12574.29869,89066726.1,8906672.61,0,96029,4108,544,2089,1545,544,96029,1545,2089,296.3121387,3.057803468,11.93063584,37171.42197,1875.219653,15.09248555,98755.56069,0.354767598,0.019381356,0.000157415,0.73958832,0.021753845,24,0
Base,0,10,0,0,0,0,0,0,-739123549.4,40350784,12994.79264,89383917.23,8938391.723,0,96707,4119,577,2159,1582,577,96707,1582,2159,293.2571429,3.205714286,12.21142857,37783.58857,2141.005714,15.50857143,98742.28,0.379308437,0.021504096,0.000157128,0.732746642,0.022325168,25,0
Base,0,10,0,0,0,0,0,0,-630320686.5,804064356,10690.75706,95782833.57,9578283.357,0,96699,4465,469,1775,1306,469,96699,1306,1775,294.1473684,2.410526316,9.242105263,37196.85263,1473.078947,11.69473684,98934.62632,0.327467534,0.015851822,0.000127174,0.735774648,0.018355929,26,0
Base,0,10,0,0,0,0,0,0,-685991650.3,2125493986,12055.98206,83192547.17,8319254.717,0,89136,3772,638,2003,1365,638,89136,1365,2003,264.9333333,3.444444444,10.97222222,44803.41667,1565.522222,14.50555556,98860.06111,0.447203762,0.015805759,0.000148186,0.681477783,0.02247128,26,0
Base,0,10,0,0,0,0,0,0,-593797431.9,23154253,10046.8236,91456251.81,9145625.181,0,92235,4223,568,1668,1100,568,92235,1100,1668,297.7039106,3.067039106,9.17877095,44327.50838,1371.122905,12.37430168,99084.05587,0.415550581,0.014463954,0.000131843,0.659472422,0.018084241,25,0
Base,0,10,0,0,0,0,0,0,-558924058.9,1391367689,9752.159013,71316108.24,7131610.824,0,75735,3244,877,1620,743,877,75735,743,1620,148.9084249,3.098901099,5.776556777,56940.77656,937.3260073,8.996336996,99136.60806,0.555887137,0.009771367,9.53439E-05,0.458641975,0.021390374,38,0
Base,0,10,0,0,0,0,0,0,-645565870.7,574142276,11186.19609,86256066.06,8625606.606,0,91196,3996,678,1858,1180,678,91196,1180,1858,229.0184332,3.036866359,8.419354839,45229.31797,1929.700461,11.55760369,98978.50691,0.443715522,0.019740069,0.000119607,0.635091496,0.020373701,31,0
Base,0,10,0,0,0,0,0,0,-555434148.1,898736779,9709.763895,69945953.4,6994595.34,0,74196,3227,1138,1613,475,1138,74196,475,1613,98.06203474,2.709677419,3.863523573,63157.36973,1366.801489,6.697270471,99252.32258,0.61881962,0.014310927,7.14708E-05,0.294482331,0.021739716,56,0
Base,0,10,0,0,0,0,0,0,-616130920,346473503,10355.32283,98364778.3,9836477.83,0,97542,4624,578,1719,1141,578,97542,1141,1719,218.3574144,2.117870722,6.429657795,56045.79468,2102.444867,8.646387833,99308.44106,0.395819988,0.029026163,0.000120658,0.663757999,0.017623178,28,0
Base,0,10,0,0,0,0,0,0,-695358939.5,445552282,12106.23608,90047135.26,9004713.526,0,94991,4212,677,2011,1334,677,94991,1334,2011,214.0702479,2.70661157,8.181818182,58063.40083,2240.305785,10.97933884,99212.69008,0.464212257,0.028806681,0.000142894,0.663351566,0.021170427,26,0
Base,0,10,0,0,0,0,0,0,-693418273.8,911758476,11892.8024,98778153.77,9877815.377,0,99257,4509,432,1975,1543,432,99257,1543,1975,307.6951872,2.235294118,10.44919786,35451.77005,1486.171123,12.77540107,98816.3369,0.247418936,0.017413658,0.000150958,0.781265823,0.019897841,23,0
Base,0,10,0,0,0,0,0,0,-682420205.5,1464197940,11641.14532,100362939.5,10036293.95,0,98729,4592,565,1933,1368,565,98729,1368,1933,319.1639344,3.016393443,10.44808743,29949.21858,3144.420765,13.53005464,98755.02186,0.300938917,0.031555308,0.000137068,0.707708226,0.019578847,27,0
Base,0,10,0,0,0,0,0,0,-672442760.2,500405854,11856.65665,79609927.7,7960992.77,0,88003,3750,755,1970,1215,755,88003,1215,1970,207.0730594,3.342465753,8.831050228,50326.6895,1632.506849,12.26940639,98982.6484,0.476609454,0.017354382,0.000132303,0.616751269,0.0223856,30,0
Base,0,10,0,0,0,0,0,0,-717230902.9,772037341,12621.36541,86162632.14,8616263.214,0,96894,4044,487,2097,1610,487,96894,1610,2097,311.3081761,2.987421384,13.06289308,34017.59119,1997.371069,16.11949686,98692.80503,0.341901555,0.020039729,0.000163166,0.767763472,0.021642207,23,0
Base,0,10,0,0,0,0,0,0,-505771492.3,1543158763,8795.603304,65991327.09,6599132.709,0,69390,3038,992,1461,469,992,69390,469,1461,108.9593023,2.747093023,4.069767442,63574.03779,977.2005814,6.968023256,99277.22674,0.625358985,0.010168947,7.41951E-05,0.321013005,0.02105521,48,0
Base,0,10,0,0,0,0,0,0,-778892987.2,1604932531,13763.8525,90700362.31,9070036.231,0,98943,4191,439,2287,1848,439,98943,1848,2287,338.2987013,2.792207792,14.75324675,37714.41558,1895.422078,17.58441558,98695.74675,0.306701045,0.021215747,0.000198321,0.808045474,0.023114318,20,0
Base,0,10,0,0,0,0,0,0,-734323694.5,539051477,12762.81044,96183172.55,9618317.255,0,98459,4348,601,2120,1519,601,98459,1519,2120,236.5234043,2.485106383,8.885106383,40983.81702,2403.617021,11.43404255,98847.81277,0.321484261,0.027831208,0.000134137,0.716509434,0.021531805,30,0
Base,0,10,0,0,0,0,0,0,-548227284.1,1743124675,9470.998305,74677368.9,7467736.89,0,76233,3354,850,1573,723,850,76233,723,1573,149.7412587,2.877622378,5.36013986,57588.34965,902.6153846,8.311188811,99175.16084,0.570895005,0.009226293,8.65954E-05,0.459631278,0.020634109,41,0
Base,0,10,0,0,0,0,0,0,-674434843.3,1965983789,11833.71598,82749044.39,8274904.439,0,89740,3776,856,1966,1110,856,89740,1110,1966,185.1686275,3.254901961,7.549019608,49267.55686,2050.968627,10.90980392,98995.6549,0.482185986,0.0211164,0.000113996,0.564598169,0.021907733,36,0
Base,0,10,0,0,0,0,0,0,-646551797.6,516774280,11204.33785,86334905.15,8633490.515,0,87385,3866,861,1861,1000,861,87385,1000,1861,175.822695,2.971631206,6.475177305,46358.20213,1993.879433,9.521276596,98943.13121,0.461852872,0.020191309,9.77697E-05,0.537345513,0.021296561,39,0
Base,0,10,0,0,0,0,0,0,-713550984.2,86603142,12383.81147,94360410.94,9436041.094,0,98898,4265,403,2057,1654,403,98898,1654,2057,374.9657534,2.705479452,13.99315068,33144.34247,1757.890411,16.74657534,98726.05479,0.278952662,0.019046616,0.000182696,0.804083617,0.020799207,20,0
Base,0,10,0,0,0,0,0,0,-573761478.6,1431870609,9886.929183,79415019.48,7941501.948,0,82998,3636,946,1642,696,946,82998,696,1642,130.7758621,2.637931034,4.58908046,50437.72414,1655.818966,7.295977011,99087.63218,0.506501078,0.016641673,7.4763E-05,0.423873325,0.019783609,50,0
Base,0,10,0,0,0,0,0,0,-648270298.7,1592383984,11240.22261,86259168.06,8625916.806,0,91945,3987,618,1867,1249,618,91945,1249,1867,224.1486486,2.698198198,8.274774775,40154.41892,1210.855856,11.05855856,98867.63514,0.395220387,0.012328099,0.000114003,0.668987681,0.020305617,32,0
Base,0,10,0,0,0,0,0,0,-649246888.5,1440183867,11240.57629,87218073.97,8721807.397,0,90401,4012,712,1867,1155,712,90401,1155,1867,241.5673077,3.336538462,8.822115385,46862.13942,2099.067308,12.22596154,99007.34135,0.470314749,0.021075583,0.000124547,0.618639529,0.020652426,30,0
Base,0,10,0,0,0,0,0,0,-676799220.2,1696510588,11822.59613,85669413.63,8566941.363,0,91617,3904,699,1964,1265,699,91617,1265,1964,225.6376147,3.123853211,8.862385321,48743.10092,1980.633028,12.05963303,99010.26147,0.486481376,0.019985704,0.000123356,0.644093686,0.02143707,31,0
Base,0,10,0,0,0,0,0,0,-734758884,895039877,12827.95857,93360955.29,9336095.529,0,98327,4226,601,2131,1530,601,98327,1530,2131,290.8216216,3.189189189,11.38378378,39566.34595,2786.610811,14.62162162,98840.4,0.347554789,0.03026429,0.000160528,0.717972783,0.021672582,25,0
Base,0,10,0,0,0,0,0,0,-712524408.7,129565953,12495.93698,87727559.62,8772755.962,0,91996,3956,864,2076,1212,864,91996,1212,2076,198.9285714,3.333333333,8.091269841,44701.78175,2580.968254,11.50396825,98869.60714,0.444315446,0.026174086,0.000118352,0.583815029,0.022566199,35,0
Base,0,10,0,0,0,0,0,0,-617331711.1,1902565669,10651.24023,84769699.35,8476969.935,0,88098,3916,684,1769,1085,684,88098,1085,1769,213.5676856,2.895196507,7.585152838,49960.0917,1471.60262,10.5720524,99075.9476,0.49019222,0.015103927,0.000109978,0.613340871,0.020079911,32,0
Base,0,10,0,0,0,0,0,0,-673541249.6,1984179288,11809.87474,83047512.77,8304751.277,0,85286,3698,1024,1962,938,1024,85286,938,1962,146.7515528,3.080745342,5.947204969,53041.86025,1997.118012,9.118012422,99012.79193,0.49827358,0.021565166,0.000100176,0.478083588,0.023004948,43,0
Base,0,10,0,0,0,0,0,0,-747857677.9,677377223,13115.84607,92065374.24,9206537.424,0,96280,4223,770,2179,1409,770,96280,1409,2179,221.5756303,3.147058824,9.012605042,39363.58403,3290.365546,12.24789916,98768.97479,0.394909604,0.033104249,0.000124738,0.646626893,0.022631907,33,0
Base,0,10,0,0,0,0,0,0,-675178391.6,973583301,11526.63031,98846876.14,9884687.614,0,95958,4478,760,1914,1154,760,95958,1154,1914,257,3.304932735,8.421524664,44354.38117,3503.856502,11.8161435,99014.91031,0.439586763,0.035519439,0.000121604,0.60292581,0.019946226,32,0
Base,0,10,0,0,0,0,0,0,-568218003.9,781062938,9524.574277,91989290.07,9198929.007,0,91908,4283,703,1581,878,703,91908,878,1581,248.0185185,3.157407407,7.166666667,42947.40278,1958.810185,10.4212963,99104.86111,0.431010423,0.019647004,0.000106081,0.555344719,0.017201985,31,0
Base,0,10,0,0,0,0,0,0,-682307978.3,338783425,11871.66043,88724956.98,8872495.698,0,95372,4169,834,1972,1138,834,95372,1138,1972,197.8560311,3.171206226,7.544747082,45889.47471,3026.474708,10.78599222,98999.2179,0.442658151,0.031412057,0.000113348,0.577079108,0.020676928,36,0
D:0| T0: 0.10| T1: 0.00| R0: 0.0| R1: 0.0| WTP: 0,0,0.096153846,0,0,0,0,0,0,-617314354,1178568022,10828.61095,75883806.41,7588380.641,0,81991,3539,950,1799,849,950,81991,849,1799,137.2579618,2.917197452,5.582802548,56509.78344,1341.041401,8.589171975,99121.03503,0.567165912,0.013485093,8.80556E-05,0.471928849,0.021941433,44,0
D:0| T0: 0.10| T1: 0.00| R0: 0.0| R1: 0.0| WTP: 0,0,0.096153846,0,0,0,0,0,0,-695200574.1,2029998696,12005.65528,94917810.29,9491781.029,0,98264,4412,479,1994,1515,479,98264,1515,1994,280.8826531,2.37755102,10.06122449,31707.22959,1694.683673,12.51020408,98719.52041,0.281958529,0.017921992,0.000133548,0.759779338,0.020292274,27,0
D:0| T0: 0.10| T1: 0.00| R0: 0.0| R1: 0.0| WTP: 0,0,0.096153846,0,0,0,0,0,0,-754810398.7,776062361,13301.19084,89750856.92,8975085.692,0,98223,4202,637,2210,1573,637,98223,1573,2210,217.7542373,2.618644068,9.233050847,42308.02119,2582.466102,11.93644068,98829.44492,0.355913367,0.029048319,0.00013578,0.711764706,0.022499822,30,0
D:0| T0: 0.10| T1: 0.00| R0: 0.0| R1: 0.0| WTP: 0,0,0.096153846,0,0,0,0,0,0,-632979343.9,1813046880,11099.57292,78000698.05,7800069.805,0,83445,3511,981,1844,863,981,83445,863,1844,152.962069,3.25862069,6.175862069,56734.86207,1826.32069,9.572413793,99123.13793,0.569341545,0.018370334,9.79801E-05,0.468004338,0.022098388,42,0
D:0| T0: 0.10| T1: 0.00| R0: 0.0| R1: 0.0| WTP: 0,0,0.096153846,0,0,0,0,0,0,-612070786,2032407216,10555.00822,84320374.91,8432037.491,0,87730,3910,680,1753,1073,680,87730,1073,1753,237.2780488,3.23902439,8.414634146,51715.37561,1495.82439,11.72682927,99119.54634,0.486388281,0.01602248,0.000127166,0.612093554,0.019981762,28,0
D:0| T0: 0.10| T1: 0.00| R0: 0.0| R1: 0.0| WTP: 0,0,0.096153846,0,0,0,0,0,0,-561498180.2,1507873352,9930.362108,64980074.8,6498007.48,0,71651,2930,1164,1650,486,1164,71651,486,1650,79.22173913,2.4,3.430434783,68619.32826,1128.784783,5.969565217,99330.06522,0.675720983,0.011816048,6.40466E-05,0.294545455,0.02302829,63,0
D:0| T0: 0.10| T1: 0.00| R0: 0.0| R1: 0.0| WTP: 0,0,0.096153846,0,0,0,0,0,0,-545732523.1,1855899401,9511.581761,70153435.09,7015343.509,0,74059,3232,943,1580,637,943,74059,637,1580,118.7738095,2.702380952,4.556547619,55602.33036,827.5119048,7.354166667,99105.84524,0.5576231,0.008340362,7.56842E-05,0.403164557,0.021334342,48,0
D:0| T0: 0.10| T1: 0.00| R0: 0.0| R1: 0.0| WTP: 0,0,0.096153846,0,0,0,0,0,0,-698116260.2,1819459251,12248.90771,85670874.69,8567087.469,0,94027,4049,596,2035,1439,596,94027,1439,2035,282.4885057,3.327586207,11.54022989,41151.57471,1939.591954,14.95977011,98846.42529,0.413198444,0.01946725,0.000151861,0.707125307,0.02164272,25,0
D:0| T0: 0.10| T1: 0.00| R0: 0.0| R1: 0.0| WTP: 0,0,0.096153846,0,0,0,0,0,0,-555831137.5,909791748,9638.903499,73885962.58,7388596.258,0,75990,3337,883,1601,718,883,75990,718,1601,144.6883562,2.938356164,5.352739726,55376.63356,845.0273973,8.380136986,99120.30137,0.556453283,0.008486946,8.54538E-05,0.448469706,0.021068562,42,0
D:0| T0: 0.10| T1: 0.00| R0: 0.0| R1: 0.0| WTP: 0,0,0.096153846,0,0,0,0,0,0,-705277199.6,1339092841,12511.2541,79714494.6,7971449.46,0,88559,3668,650,2079,1429,650,88559,1429,2079,242.8342246,3.374331551,10.96256684,46415.67914,1700.374332,14.43315508,98842.6738,0.46640418,0.017082808,0.000146656,0.687349687,0.023475875,27,0
D:0| T0: 0.10| T1: 0.00| R0: 0.0| R1: 0.0| WTP: 0,0,0.096153846,0,0,0,0,0,0,-727335922.2,1365866345,12642.327,95219572.09,9521957.209,0,98911,4412,491,2100,1609,491,98911,1609,2100,263.569378,2.277511962,9.928229665,47173.92344,1480.210526,12.28229665,98982.79426,0.307192879,0.019521242,0.000163629,0.766190476,0.021231208,23,0
D:0| T0: 0.10| T1: 0.00| R0: 0.0| R1: 0.0| WTP: 0,0,0.096153846,0,0,0,0,0,0,-666696783.1,825453433,11441.15592,94638986.97,9463898.697,0,93935,4242,655,1900,1245,655,93935,1245,1900,270.3596059,3.118226601,9.187192118,42220.30049,2354.507389,12.4137931,98948.53202,0.423656396,0.023636044,0.00012643,0.655263158,0.020226753,29,0
D:0| T0: 0.10| T1: 0.00| R0: 0.0| R1: 0.0| WTP: 0,0,0.096153846,0,0,0,0,0,0,-728451839.3,939711378,12695.84445,93659616.78,9365961.678,0,98897,4387,449,2109,1660,449,98897,1660,2109,336.2795031,2.714285714,12.95652174,30668.30435,2413.645963,15.74534161,98655.29814,0.308199101,0.024218371,0.00015955,0.787102892,0.021325217,23,0
D:0| T0: 0.10| T1: 0.00| R0: 0.0| R1: 0.0| WTP: 0,0,0.096153846,0,0,0,0,0,0,-663599370.3,638950699,11475.6419,89817275.17,8981727.517,0,92702,4181,793,1906,1113,793,92702,1113,1906,227.7444934,3.370044053,8.202643172,44253.14537,2570.008811,11.71365639,98970.36564,0.444060988,0.025822641,0.000119507,0.583945435,0.020560506,33,0
D:0| T0: 0.10| T1: 0.00| R0: 0.0| R1: 0.0| WTP: 0,0,0.096153846,0,0,0,0,0,0,-621494453.1,938699148,10747.1414,84137382.84,8413738.284,0,86981,3864,724,1785,1061,724,86981,1061,1785,197.7959184,2.865306122,7.151020408,52813.24082,1194.722449,10.11020408,99106.71837,0.481288743,0.013239532,0.000113513,0.594397759,0.020521723,32,0
D:0| T0: 0.10| T1: 0.00| R0: 0.0| R1: 0.0| WTP: 0,0,0.096153846,0,0,0,0,0,0,-568529313,121790188,9778.923271,79583149.44,7958314.944,0,80993,3572,1010,1624,614,1010,80993,614,1624,128.4591549,2.74084507,4.43943662,58222.61127,1649.453521,7.256338028,99226.88169,0.584111724,0.016580231,7.45874E-05,0.378078818,0.020051116,50,0
D:0| T0: 0.10| T1: 0.00| R0: 0.0| R1: 0.0| WTP: 0,0,0.096153846,0,0,0,0,0,0,-719006687.6,1331335240,12521.54221,92929577.28,9292957.728,0,98109,4303,642,2080,1438,642,98109,1438,2080,242.1809955,2.850678733,9.298642534,37447.52036,2919.371041,12.17647059,98803.88235,0.336659633,0.031169551,0.000131599,0.691346154,0.021200909,30,0
D:0| T0: 0.10| T1: 0.00| R0: 0.0| R1: 0.0| WTP: 0,0,0.096153846,0,0,0,0,0,0,-758771517.8,470935411,13326.06748,92468143.6,9246814.36,0,98975,4158,470,2214,1744,470,98975,1744,2214,302.8465909,2.596590909,12.47727273,35632,1455.460227,15.125,98680.1875,0.270936276,0.016588043,0.000173941,0.787714544,0.022369285,23,0
D:0| T0: 0.10| T1: 0.00| R0: 0.0| R1: 0.0| WTP: 0,0,0.096153846,0,0,0,0,0,0,-716564045.7,823434397,12668.54484,83136803.63,8313680.363,0,91798,3750,709,2105,1396,709,91798,1396,2105,220.6186047,3.227906977,9.651162791,46808.49767,2193.618605,12.93953488,98895.94884,0.469692775,0.022052463,0.000131646,0.663182898,0.022930783,31,0
D:0| T0: 0.10| T1: 0.00| R0: 0.0| R1: 0.0| WTP: 0,0,0.096153846,0,0,0,0,0,0,-562850724.8,493045351,9723.849831,76658233.25,7665823.325,0,78717,3460,819,1615,796,819,78717,796,1615,163.0333333,2.922222222,5.840740741,54338.93704,740.1259259,8.885185185,99125.22593,0.542467537,0.007488666,9.12173E-05,0.492879257,0.020516534,39,0
D:0| T0: 0.10| T1: 0.00| R0: 0.0| R1: 0.0| WTP: 0,0,0.096153846,0,0,0,0,0,0,-605772953.6,1700216563,10334.36868,89054519.44,8905451.944,0,88673,4155,758,1716,958,758,88673,958,1716,201.9960784,2.898039216,6.6,48117.67843,1878.6,9.568627451,99071.76078,0.482862414,0.018870697,9.74648E-05,0.558275058,0.019352001,37,0
D:0| T0: 0.10| T1: 0.00| R0: 0.0| R1: 0.0| WTP: 0,0,0.096153846,0,0,0,0,0,0,-564749685.8,1744119059,9677.077485,80895811.55,8089581.155,0,86383,3836,640,1607,967,640,86383,967,1607,210.6396396,2.792792793,7.099099099,41744.62613,1075.806306,9.990990991,98983.54955,0.419794633,0.010792738,0.000101565,0.601742377,0.018603197,32,0
D:0| T0: 0.10| T1: 0.00| R0: 0.0| R1: 0.0| WTP: 0,0,0.096153846,0,0,0,0,0,0,-626532959.2,2036906360,10902.51794,81407062.38,8140706.238,0,84696,3657,1015,1811,796,1015,84696,796,1811,122.591029,2.580474934,4.643799472,52291.58575,1558.707124,7.303430079,99052.75198,0.501253436,0.016462144,7.87683E-05,0.439536168,0.021382356,51,0
D:0| T0: 0.10| T1: 0.00| R0: 0.0| R1: 0.0| WTP: 0,0,0.096153846,0,0,0,0,0,0,-627914997.2,809704121,10766.91401,89569296.58,8956929.658,0,91325,4175,744,1788,1044,744,91325,1044,1788,230.0044444,3.2,7.795555556,49393.05778,2102.137778,11.11111111,99107.21778,0.490754319,0.02129521,0.000114045,0.583892617,0.019578643,31,0
D:0| T0: 0.10| T1: 0.00| R0: 0.0| R1: 0.0| WTP: 0,0,0.096153846,0,0,0,0,0,0,-689876992.3,1219866412,11874.03504,96175240.13,9617524.013,0,98384,4371,666,1972,1306,666,98384,1306,1972,262.6792453,3.04245283,9.150943396,31383.17453,3812.504717,12.30660377,98763.44811,0.315146158,0.038296738,0.000125074,0.662271805,0.02004391,31,0
D:0| T0: 0.10| T1: 0.00| R0: 0.0| R1: 0.0| WTP: 0,0,0.096153846,0,0,0,0,0,0,-566746625.8,843498920,9866.95088,73399081.83,7339908.183,0,77365,3362,927,1639,712,927,77365,712,1639,138.0924092,2.95709571,5.254125413,55798.29043,1227.316832,8.320132013,99125.09241,0.560535675,0.012331531,8.50998E-05,0.434411226,0.021185291,44,0
D:0| T0: 0.10| T1: 0.00| R0: 0.0| R1: 0.0| WTP: 0,0,0.096153846,0,0,0,0,0,0,-760215563.1,107351963,13509.84965,84723080.42,8472308.042,0,93459,3855,828,2245,1417,828,93459,1417,2245,208.9913043,3.517391304,9.613043478,44414.20435,2832.965217,13.20434783,98801.62609,0.443306638,0.028636599,0.000135118,0.631180401,0.024021229,33,0
D:0| T0: 0.10| T1: 0.00| R0: 0.0| R1: 0.0| WTP: 0,0,0.096153846,0,0,0,0,0,0,-662511521.7,773789021,11439.85065,90518989.38,9051898.938,0,92985,4130,770,1900,1130,770,92985,1130,1900,223.9699571,3.197424893,8.004291845,45276.00858,2705.004292,11.32618026,98993.23176,0.449447407,0.027413046,0.000116181,0.594736842,0.020433403,33,0
D:0| T0: 0.10| T1: 0.00| R0: 0.0| R1: 0.0| WTP: 0,0,0.096153846,0,0,0,0,0,0,-735732877.5,850936611,13041.05973,83679891.14,8367989.114,0,91161,3774,747,2167,1420,747,91161,1420,2167,194.5265306,2.942857143,8.681632653,46095.76327,1952.579592,11.76326531,98819.50612,0.430287487,0.020835212,0.000126969,0.655283802,0.02377113,33,0
D:0| T0: 0.10| T1: 0.00| R0: 0.0| R1: 0.0| WTP: 0,0,0.096153846,0,0,0,0,0,0,-692568809,1701318364,12111.26951,87005333.61,8700533.361,0,92608,4009,676,2012,1336,676,92608,1336,2012,242.4902913,3.189320388,9.626213592,43138.96117,1910.849515,12.9223301,98875.82524,0.398177485,0.020376164,0.000139228,0.664015905,0.021725985,28,0
D:0| T0: 0.10| T1: 0.00| R0: 0.0| R1: 0.0| WTP: 0,0,0.096153846,0,0,0,0,0,0,-589506263.2,778708269,10270.23691,75994417.89,7599441.789,0,77483,3411,1125,1706,581,1125,77483,581,1706,112.9921466,2.832460733,4.306282723,61684.50785,1556.850785,7.248691099,99221.54712,0.616024109,0.015784522,7.51394E-05,0.34056272,0.022017733,55,0
D:0| T0: 0.10| T1: 0.00| R0: 0.0| R1: 0.0| WTP: 0,0,0.096153846,0,0,0,0,0,0,-667335589.2,1391938506,11813.69249,76650964.47,7665096.447,0,83791,3454,768,1963,1195,768,83791,1195,1963,208.5933014,3.545454545,9.19138756,49894.73684,1431.320574,12.8708134,98915.23445,0.501575178,0.014382938,0.000131325,0.608762099,0.023427337,30,0
D:0| T0: 0.10| T1: 0.00| R0: 0.0| R1: 0.0| WTP: 0,0,0.096153846,0,0,0,0,0,0,-518340134.3,43418681,9030.118199,66834224.31,6683422.431,0,68458,3066,1060,1500,440,1060,68458,440,1500,102.3351351,2.748648649,3.889189189,61848.52432,1030.340541,6.754054054,99220.35405,0.621433735,0.010350307,6.95197E-05,0.293333333,0.021911245,53,0
D:0| T0: 0.10| T1: 0.00| R0: 0.0| R1: 0.0| WTP: 0,0,0.096153846,0,0,0,0,0,0,-749550521.1,817384966,13187.18309,90191366.49,9019136.649,0,98186,4148,465,2191,1726,465,98186,1726,2191,253.1902439,2.209756098,10.58536585,23011.73659,1303.780488,12.84878049,98381.66341,0.220545355,0.013294958,0.00013225,0.787768142,0.02231479,29,0
D:0| T0: 0.10| T1: 0.00| R0: 0.0| R1: 0.0| WTP: 0,0,0.096153846,0,0,0,0,0,0,-720616972.6,762053968,12522.00461,94516742,9451674.2,0,97860,4382,507,2080,1573,507,97860,1573,2080,323.3491124,2.952662722,12.20118343,30718.36095,1809.591716,15.20118343,98656.75148,0.300627422,0.018376546,0.000155577,0.75625,0.021254854,24,0
D:0| T0: 0.10| T1: 0.00| R0: 0.0| R1: 0.0| WTP: 0,0,0.096153846,0,0,0,0,0,0,-664653268.8,1692506311,11487.82279,90262129.47,9026212.947,0,91311,4147,818,1908,1090,818,91311,1090,1908,177.9109589,2.719178082,6.400684932,46499.97945,2075.506849,9.212328767,98971.54795,0.437708372,0.022004105,9.89969E-05,0.571278826,0.02089562,39,0
D:0| T0: 0.10| T1: 0.00| R0: 0.0| R1: 0.0| WTP: 0,0,0.096153846,0,0,0,0,0,0,-532247164.8,1037620300,9300.43547,67225391.33,6722539.133,0,71917,3080,928,1545,617,928,71917,617,1545,109.7557471,2.545977011,4.281609195,69201.1408,872.9568966,6.954022989,99381.73563,0.6403694,0.01030799,8.39115E-05,0.399352751,0.021483099,43,0
D:0| T0: 0.10| T1: 0.00| R0: 0.0| R1: 0.0| WTP: 0,0,0.096153846,0,0,0,0,0,0,-634659062.3,301400999,11052.78363,82019880.55,8201988.055,0,84013,3657,821,1836,1015,821,84013,1015,1836,191.9510204,3.240816327,7.318367347,49291.91837,1418.718367,10.67346939,98973.35102,0.495349725,0.014257306,0.000108998,0.552832244,0.021853761,35,0
D:0| T0: 0.10| T1: 0.00| R0: 0.0| R1: 0.0| WTP: 0,0,0.096153846,0,0,0,0,0,0,-718769186,1868336855,12509.64306,93287033.1,9328703.31,0,97065,4219,596,2078,1482,596,97065,1482,2078,244.7818182,2.622727273,9.309090909,31378.4,1717.85,12.03181818,98641.36818,0.315295723,0.01726577,0.000122245,0.713185756,0.021408335,32,0
D:0| T0: 0.10| T1: 0.00| R0: 0.0| R1: 0.0| WTP: 0,0,0.096153846,0,0,0,0,0,0,-732907138.9,1868498144,12845.08639,90652819.26,9065281.926,0,96366,4215,639,2134,1495,639,96366,1495,2134,265.5612245,3.178571429,10.75510204,35889.26531,2046.505102,14,98711.09694,0.360445977,0.020562939,0.00014226,0.700562324,0.02214474,28,0
D:0| T0: 0.10| T1: 0.00| R0: 0.0| R1: 0.0| WTP: 0,0,0.096153846,0,0,0,0,0,0,-575823523.6,2101566889,9976.219416,77012552.79,7701255.279,0,79895,3525,949,1657,708,949,79895,708,1657,147.2809365,3.036789298,5.347826087,53873.28428,1511.956522,8.56187291,99108.48161,0.54116444,0.015195255,8.75897E-05,0.427278214,0.02074024,43,0
D:0| T0: 0.10| T1: 0.00| R0: 0.0| R1: 0.0| WTP: 0,0,0.096153846,0,0,0,0,0,0,-741864385.9,1665097450,13007.42655,91493058.35,9149305.835,0,98719,4249,439,2161,1722,439,98719,1722,2161,270.5538462,2.2,10.97948718,40847.35385,1735.358974,13.24102564,98806.04103,0.280851358,0.021227854,0.000163217,0.796853309,0.021890416,23,0
D:0| T0: 0.10| T1: 0.00| R0: 0.0| R1: 0.0| WTP: 0,0,0.096153846,0,0,0,0,0,0,-662826836.7,1716179948,11345.28405,95562634.37,9556263.437,0,99095,4423,486,1884,1398,486,99095,1398,1884,334.8915663,2.873493976,11.22891566,28923.22892,2058.084337,14.15060241,98773.43976,0.290764589,0.020632686,0.000143238,0.742038217,0.019012059,24,0
D:0| T0: 0.10| T1: 0.00| R0: 0.0| R1: 0.0| WTP: 0,0,0.096153846,0,0,0,0,0,0,-634158888.6,1560278715,11294.9511,69411333.74,6941133.374,0,75833,3087,910,1877,967,910,75833,967,1877,149.2480916,3.366412214,7.019083969,64183.09542,984.5992366,10.49236641,99183.04198,0.616514747,0.010671048,0.000115289,0.515183804,0.024752084,34,0
D:0| T0: 0.10| T1: 0.00| R0: 0.0| R1: 0.0| WTP: 0,0,0.096153846,0,0,0,0,0,0,-747816425.2,991019385,13133.49717,91141566.96,9114156.696,0,98318,4162,583,2182,1599,583,98318,1599,2182,283.1027027,3.075675676,11.67567568,34587.07568,3157.908108,14.82702703,98695.38919,0.347170772,0.031726455,0.000150272,0.732813932,0.022193291,27,0
D:0| T0: 0.10| T1: 0.00| R0: 0.0| R1: 0.0| WTP: 0,0,0.096153846,0,0,0,0,0,0,-736947521.3,118052103,12946.83231,89605905.81,8960590.581,0,96633,4227,656,2151,1495,656,96633,1495,2151,232.3438914,2.895927602,9.610859729,46855.69683,2203.0181,12.57918552,98941,0.416832852,0.024345991,0.000140456,0.69502557,0.022259477,29,0
D:0| T0: 0.10| T1: 0.00| R0: 0.0| R1: 0.0| WTP: 0,0,0.096153846,0,0,0,0,0,0,-761282297.9,1209758844,13504.17446,86073574.87,8607357.487,0,95860,3925,560,2244,1684,560,95860,1684,2244,261.7340426,2.893617021,11.80319149,45112.64894,1493.898936,14.77659574,98823.84574,0.364886585,0.017415983,0.000173952,0.750445633,0.023409138,24,0
D:0| T0: 0.10| T1: 0.00| R0: 0.0| R1: 0.0| WTP: 0,0,0.096153846,0,0,0,0,0,0,-603237954.8,70671723,10534.61071,76507419.43,7650741.943,0,79500,3436,1022,1750,728,1022,79500,728,1750,126.8425656,2.89212828,4.976676385,52954.3965,1422.102041,7.950437318,99034.01166,0.526653316,0.014469659,8.2242E-05,0.416,0.022012579,49,0
D:0| T0: 0.10| T1: 0.00| R0: 0.0| R1: 0.0| WTP: 0,0,0.096153846,0,0,0,0,0,0,-540962547.2,1722612191,9315.090036,75208045.35,7520804.535,0,75249,3375,1019,1547,528,1019,75249,528,1547,118.8314917,2.696132597,4.132596685,62690.39227,1147.138122,6.955801105,99292.93923,0.626964079,0.011590223,7.1633E-05,0.341305753,0.020558686,51,0
D:0| T0: 0.10| T1: 0.00| R0: 0.0| R1: 0.0| WTP: 0,0,0.096153846,0,0,0,0,0,0,-505605872.8,1968291596,8624.167481,74397498.72,7439749.872,0,72131,3360,929,1432,503,929,72131,503,1432,106.945,2.22,3.445,57257.275,721.1825,5.78,99191.8425,0.563316224,0.007450029,6.09729E-05,0.351256983,0.019852768,56,0
D:0| T0: 0.10| T1: 0.00| R0: 0.0| R1: 0.0| WTP: 0,0,0.096153846,0,0,0,0,0,0,-772151892.3,1877569084,13602.18262,92042761.34,9204276.134,0,98978,4152,490,2260,1770,490,98978,1770,2260,281.6170213,2.54787234,11.92553191,29500.15426,1681.037234,14.52659574,98514.78723,0.257095747,0.017838756,0.000155355,0.783185841,0.022833357,26,0
D:0| T0: 0.10| T1: 0.00| R0: 0.0| R1: 0.0| WTP: 0,0,0.096153846,0,0,0,0,0,0,-764972838.5,1726322189,13517.13775,89115951.13,8911595.113,0,98174,4184,534,2246,1712,534,98174,1712,2246,285.2346369,2.905027933,12.40782123,31439.22346,1864.782123,15.40782123,98566.62011,0.292345127,0.019382542,0.000161555,0.762243989,0.022877748,25,0
D:0| T0: 0.10| T1: 0.00| R0: 0.0| R1: 0.0| WTP: 0,0,0.096153846,0,0,0,0,0,0,-717132070.7,307848836,12491.35485,92564327.97,9256432.797,0,97357,4267,534,2075,1541,534,97357,1541,2075,290.4565217,2.820652174,11.14673913,31311.40761,1866.521739,14.05978261,98654.40761,0.314746647,0.018741872,0.000142482,0.742650602,0.021313311,27,0
D:0| T0: 0.10| T1: 0.00| R0: 0.0| R1: 0.0| WTP: 0,0,0.096153846,0,0,0,0,0,0,-694525647.2,1154000220,11975.86493,95732400.98,9573240.098,0,99096,4501,433,1989,1556,433,99096,1556,1989,279.3467337,2.115577889,9.899497487,19816.96985,1299.366834,12.08040201,98487.13568,0.19993622,0.013043102,0.000122288,0.782302665,0.020071446,29,0
D:0| T0: 0.10| T1: 0.00| R0: 0.0| R1: 0.0| WTP: 0,0,0.096153846,0,0,0,0,0,0,-547749686.8,2028661055,9506.31472,72433950.83,7243395.083,0,76239,3296,920,1579,659,920,76239,659,1579,131.7038217,2.821656051,4.869426752,55277.23248,1272.031847,7.808917197,99128.59236,0.555444398,0.012779928,7.99557E-05,0.417352755,0.020711185,45,0
D:0| T0: 0.10| T1: 0.00| R0: 0.0| R1: 0.0| WTP: 0,0,0.096153846,0,0,0,0,0,0,-689686172.2,1629114640,11903.54156,94509094.32,9450909.432,0,95836,4325,727,1977,1250,727,95836,1250,1977,227.3708333,2.95,8.104166667,36434.00417,2492.175,11.14166667,98809.53333,0.365746896,0.02504853,0.000113312,0.632271118,0.020628991,35,0
D:0| T0: 0.10| T1: 0.00| R0: 0.0| R1: 0.0| WTP: 0,0,0.096153846,0,0,0,0,0,0,-750778153.5,1439048174,13181.69957,91693175.13,9169317.513,0,98793,4165,519,2190,1671,519,98793,1671,2190,323.809816,3.116564417,13.3190184,32092.77914,2579.619632,16.50306748,98638.17178,0.309780631,0.026386221,0.000170097,0.763013699,0.022167562,23,0
D:0| T0: 0.10| T1: 0.00| R0: 0.0| R1: 0.0| WTP: 0,0,0.096153846,0,0,0,0,0,0,-761713588,865227006,13439.25341,89750917.52,8975091.752,0,99233,4139,438,2233,1795,438,99233,1795,2233,289.8876404,2.393258427,12.44382022,36498.20787,1498.179775,14.91573034,98688.94382,0.248399924,0.017835693,0.000178847,0.803851321,0.022502595,22,0
D:0| T0: 0.10| T1: 0.00| R0: 0.0| R1: 0.0| WTP: 0,0,0.096153846,0,0,0,0,0,0,-711807955.5,890479738,12341.98599,94708656.16,9470865.616,0,97864,4288,672,2050,1378,672,97864,1378,2050,251.9354839,3.01843318,9.30875576,34474.97235,3230.56682,12.40552995,98759.06452,0.346010264,0.032472051,0.000126141,0.672195122,0.020947437,31,0
D:0| T0: 0.10| T1: 0.00| R0: 0.0| R1: 0.0| WTP: 0,0,0.096153846,0,0,0,0,0,0,-609307656.5,1017049163,10554.14155,81600579.04,8160057.904,0,83746,3728,717,1753,1036,717,83746,1036,1753,213.5136364,3.140909091,7.777272727,51424.03636,1362.140909,11.04090909,99057.67273,0.516459805,0.013676023,0.000112735,0.59098688,0.020932343,32,0
D:0| T0: 0.10| T1: 0.00| R0: 0.0| R1: 0.0| WTP: 0,0,0.096153846,0,0,0,0,0,0,-530456542.1,1707305064,9063.517842,77280649.97,7728064.997,0,76051,3475,958,1505,547,958,76051,547,1505,130.5970588,2.723529412,4.291176471,59943.52059,1170.729412,7.102941176,99263.08235,0.589573523,0.01211463,7.49681E-05,0.36345515,0.019789352,48,0
D:0| T0: 0.10| T1: 0.00| R0: 0.0| R1: 0.0| WTP: 0,0,0.096153846,0,0,0,0,0,0,-763226687,400145663,13410.17616,92717879,9271787.9,0,99088,4284,408,2228,1820,408,99088,1820,2228,293.7417582,2.181318681,12.15384615,20558.84615,1460.549451,14.41208791,98322.45604,0.207477744,0.01467035,0.000145634,0.816876122,0.022485064,26,0
D:0| T0: 0.10| T1: 0.00| R0: 0.0| R1: 0.0| WTP: 0,0,0.096153846,0,0,0,0,0,0,-627991242,1662654181,10891.06185,83438149.64,8343814.964,0,86021,3770,744,1809,1065,744,86021,1065,1809,197.5349794,2.962962963,7.296296296,51404.48971,1448.872428,10.34979424,99062.19753,0.515931599,0.014553019,0.00010558,0.588723051,0.021029749,35,0
D:0| T0: 0.10| T1: 0.00| R0: 0.0| R1: 0.0| WTP: 0,0,0.096153846,0,0,0,0,0,0,-723120148.6,182136456,12564.16388,94911954.51,9491195.451,0,98897,4399,492,2087,1595,492,98897,1595,2087,293.5775401,2.582887701,11.06417112,26820.27273,1832.775401,13.68449198,98573.13904,0.249806983,0.018904701,0.00014239,0.764254911,0.021102763,26,0
D:0| T0: 0.10| T1: 0.00| R0: 0.0| R1: 0.0| WTP: 0,0,0.096153846,0,0,0,0,0,0,-510805827.8,979575387,8749.985431,73306556.27,7330655.627,0,73446,3306,1071,1453,382,1071,73446,382,1453,114.510929,2.81420765,3.816939891,60939.7541,1352.377049,6.759562842,99283.5929,0.611757537,0.013584382,6.92741E-05,0.262904336,0.019783242,53,0
D:0| T0: 0.10| T1: 0.00| R0: 0.0| R1: 0.0| WTP: 0,0,0.096153846,0,0,0,0,0,0,-752865721.7,2142525414,13253.29308,90201067.86,9020106.786,0,97981,4132,577,2202,1625,577,97981,1625,2202,282.9071038,3.076502732,11.90163934,41529.85246,2099.333333,15.04918033,98821.76503,0.371897656,0.022698971,0.000164296,0.737965486,0.022473745,25,0
D:0| T0: 0.10| T1: 0.00| R0: 0.0| R1: 0.0| WTP: 0,0,0.096153846,0,0,0,0,0,0,-669374779.2,1464057597,11595.62435,89593561.73,8959356.173,0,94756,4165,637,1926,1289,637,94756,1289,1926,250.9466019,3.009708738,9.203883495,42277.09709,1719.048544,12.31553398,98932.28641,0.421312851,0.017348916,0.000125611,0.669262721,0.02032589,30,0
D:0| T0: 0.10| T1: 0.00| R0: 0.0| R1: 0.0| WTP: 0,0,0.096153846,0,0,0,0,0,0,-717781660.4,364562610,12574.29869,89066726.1,8906672.61,0,96029,4108,544,2089,1545,544,96029,1545,2089,296.3121387,3.057803468,11.93063584,37171.42197,1875.219653,15.09248555,98755.56069,0.354767598,0.019381356,0.000157415,0.73958832,0.021753845,24,0
D:0| T0: 0.10| T1: 0.00| R0: 0.0| R1: 0.0| WTP: 0,0,0.096153846,0,0,0,0,0,0,-739123549.4,40350784,12994.79264,89383917.23,8938391.723,0,96707,4119,577,2159,1582,577,96707,1582,2159,293.2571429,3.205714286,12.21142857,37783.58857,2141.005714,15.50857143,98742.28,0.379308437,0.021504096,0.000157128,0.732746642,0.022325168,25,0
D:0| T0: 0.10| T1: 0.00| R0: 0.0| R1: 0.0| WTP: 0,0,0.096153846,0,0,0,0,0,0,-630320686.5,804064356,10690.75706,95782833.57,9578283.357,0,96699,4465,469,1775,1306,469,96699,1306,1775,294.1473684,2.410526316,9.242105263,37196.85263,1473.078947,11.69473684,98934.62632,0.327467534,0.015851822,0.000127174,0.735774648,0.018355929,26,0
D:0| T0: 0.10| T1: 0.00| R0: 0.0| R1: 0.0| WTP: 0,0,0.096153846,0,0,0,0,0,0,-685991650.3,2125493986,12055.98206,83192547.17,8319254.717,0,89136,3772,638,2003,1365,638,89136,1365,2003,264.9333333,3.444444444,10.97222222,44803.41667,1565.522222,14.50555556,98860.06111,0.447203762,0.015805759,0.000148186,0.681477783,0.02247128,26,0
D:0| T0: 0.10| T1: 0.00| R0: 0.0| R1: 0.0| WTP: 0,0,0.096153846,0,0,0,0,0,0,-593797431.9,23154253,10046.8236,91456251.81,9145625.181,0,92235,4223,568,1668,1100,568,92235,1100,1668,297.7039106,3.067039106,9.17877095,44327.50838,1371.122905,12.37430168,99084.05587,0.415550581,0.014463954,0.000131843,0.659472422,0.018084241,25,0
D:0| T0: 0.10| T1: 0.00| R0: 0.0| R1: 0.0| WTP: 0,0,0.096153846,0,0,0,0,0,0,-558924058.9,1391367689,9752.159013,71316108.24,7131610.824,0,75735,3244,877,1620,743,877,75735,743,1620,148.9084249,3.098901099,5.776556777,56940.77656,937.3260073,8.996336996,99136.60806,0.555887137,0.009771367,9.53439E-05,0.458641975,0.021390374,38,0
D:0| T0: 0.10| T1: 0.00| R0: 0.0| R1: 0.0| WTP: 0,0,0.096153846,0,0,0,0,0,0,-645565870.7,574142276,11186.19609,86256066.06,8625606.606,0,91196,3996,678,1858,1180,678,91196,1180,1858,229.0184332,3.036866359,8.419354839,45229.31797,1929.700461,11.55760369,98978.50691,0.443715522,0.019740069,0.000119607,0.635091496,0.020373701,31,0
D:0| T0: 0.10| T1: 0.00| R0: 0.0| R1: 0.0| WTP: 0,0,0.096153846,0,0,0,0,0,0,-555434148.1,898736779,9709.763895,69945953.4,6994595.34,0,74196,3227,1138,1613,475,1138,74196,475,1613,98.06203474,2.709677419,3.863523573,63157.36973,1366.801489,6.697270471,99252.32258,0.61881962,0.014310927,7.14708E-05,0.294482331,0.021739716,56,0
D:0| T0: 0.10| T1: 0.00| R0: 0.0| R1: 0.0| WTP: 0,0,0.096153846,0,0,0,0,0,0,-616130920,346473503,10355.32283,98364778.3,9836477.83,0,97542,4624,578,1719,1141,578,97542,1141,1719,218.3574144,2.117870722,6.429657795,56045.79468,2102.444867,8.646387833,99308.44106,0.395819988,0.029026163,0.000120658,0.663757999,0.017623178,28,0
D:0| T0: 0.10| T1: 0.00| R0: 0.0| R1: 0.0| WTP: 0,0,0.096153846,0,0,0,0,0,0,-695358939.5,445552282,12106.23608,90047135.26,9004713.526,0,94991,4212,677,2011,1334,677,94991,1334,2011,214.0702479,2.70661157,8.181818182,58063.40083,2240.305785,10.97933884,99212.69008,0.464212257,0.028806681,0.000142894,0.663351566,0.021170427,26,0
D:0| T0: 0.10| T1: 0.00| R0: 0.0| R1: 0.0| WTP: 0,0,0.096153846,0,0,0,0,0,0,-693418273.8,911758476,11892.8024,98778153.77,9877815.377,0,99257,4509,432,1975,1543,432,99257,1543,1975,307.6951872,2.235294118,10.44919786,35451.77005,1486.171123,12.77540107,98816.3369,0.247418936,0.017413658,0.000150958,0.781265823,0.019897841,23,0
D:0| T0: 0.10| T1: 0.00| R0: 0.0| R1: 0.0| WTP: 0,0,0.096153846,0,0,0,0,0,0,-682420205.5,1464197940,11641.14532,100362939.5,10036293.95,0,98729,4592,565,1933,1368,565,98729,1368,1933,319.1639344,3.016393443,10.44808743,29949.21858,3144.420765,13.53005464,98755.02186,0.300938917,0.031555308,0.000137068,0.707708226,0.019578847,27,0
D:0| T0: 0.10| T1: 0.00| R0: 0.0| R1: 0.0| WTP: 0,0,0.096153846,0,0,0,0,0,0,-672442760.2,500405854,11856.65665,79609927.7,7960992.77,0,88003,3750,755,1970,1215,755,88003,1215,1970,207.0730594,3.342465753,8.831050228,50326.6895,1632.506849,12.26940639,98982.6484,0.476609454,0.017354382,0.000132303,0.616751269,0.0223856,30,0
D:0| T0: 0.10| T1: 0.00| R0: 0.0| R1: 0.0| WTP: 0,0,0.096153846,0,0,0,0,0,0,-717230902.9,772037341,12621.36541,86162632.14,8616263.214,0,96894,4044,487,2097,1610,487,96894,1610,2097,311.3081761,2.987421384,13.06289308,34017.59119,1997.371069,16.11949686,98692.80503,0.341901555,0.020039729,0.000163166,0.767763472,0.021642207,23,0
D:0| T0: 0.10| T1: 0.00| R0: 0.0| R1: 0.0| WTP: 0,0,0.096153846,0,0,0,0,0,0,-505771492.3,1543158763,8795.603304,65991327.09,6599132.709,0,69390,3038,992,1461,469,992,69390,469,1461,108.9593023,2.747093023,4.069767442,63574.03779,977.2005814,6.968023256,99277.22674,0.625358985,0.010168947,7.41951E-05,0.321013005,0.02105521,48,0
D:0| T0: 0.10| T1: 0.00| R0: 0.0| R1: 0.0| WTP: 0,0,0.096153846,0,0,0,0,0,0,-778892987.2,1604932531,13763.8525,90700362.31,9070036.231,0,98943,4191,439,2287,1848,439,98943,1848,2287,338.2987013,2.792207792,14.75324675,37714.41558,1895.422078,17.58441558,98695.74675,0.306701045,0.021215747,0.000198321,0.808045474,0.023114318,20,0
D:0| T0: 0.10| T1: 0.00| R0: 0.0| R1: 0.0| WTP: 0,0,0.096153846,0,0,0,0,0,0,-734323694.5,539051477,12762.81044,96183172.55,9618317.255,0,98459,4348,601,2120,1519,601,98459,1519,2120,236.5234043,2.485106383,8.885106383,40983.81702,2403.617021,11.43404255,98847.81277,0.321484261,0.027831208,0.000134137,0.716509434,0.021531805,30,0
D:0| T0: 0.10| T1: 0.00| R0: 0.0| R1: 0.0| WTP: 0,0,0.096153846,0,0,0,0,0,0,-548227284.1,1743124675,9470.998305,74677368.9,7467736.89,0,76233,3354,850,1573,723,850,76233,723,1573,149.7412587,2.877622378,5.36013986,57588.34965,902.6153846,8.311188811,99175.16084,0.570895005,0.009226293,8.65954E-05,0.459631278,0.020634109,41,0
D:0| T0: 0.10| T1: 0.00| R0: 0.0| R1: 0.0| WTP: 0,0,0.096153846,0,0,0,0,0,0,-674434843.3,1965983789,11833.71598,82749044.39,8274904.439,0,89740,3776,856,1966,1110,856,89740,1110,1966,185.1686275,3.254901961,7.549019608,49267.55686,2050.968627,10.90980392,98995.6549,0.482185986,0.0211164,0.000113996,0.564598169,0.021907733,36,0
D:0| T0: 0.10| T1: 0.00| R0: 0.0| R1: 0.0| WTP: 0,0,0.096153846,0,0,0,0,0,0,-646551797.6,516774280,11204.33785,86334905.15,8633490.515,0,87385,3866,861,1861,1000,861,87385,1000,1861,175.822695,2.971631206,6.475177305,46358.20213,1993.879433,9.521276596,98943.13121,0.461852872,0.020191309,9.77697E-05,0.537345513,0.021296561,39,0
D:0| T0: 0.10| T1: 0.00| R0: 0.0| R1: 0.0| WTP: 0,0,0.096153846,0,0,0,0,0,0,-713550984.2,86603142,12383.81147,94360410.94,9436041.094,0,98898,4265,403,2057,1654,403,98898,1654,2057,374.9657534,2.705479452,13.99315068,33144.34247,1757.890411,16.74657534,98726.05479,0.278952662,0.019046616,0.000182696,0.804083617,0.020799207,20,0
D:0| T0: 0.10| T1: 0.00| R0: 0.0| R1: 0.0| WTP: 0,0,0.096153846,0,0,0,0,0,0,-573761478.6,1431870609,9886.929183,79415019.48,7941501.948,0,82998,3636,946,1642,696,946,82998,696,1642,130.7758621,2.637931034,4.58908046,50437.72414,1655.818966,7.295977011,99087.63218,0.506501078,0.016641673,7.4763E-05,0.423873325,0.019783609,50,0
D:0| T0: 0.10| T1: 0.00| R0: 0.0| R1: 0.0| WTP: 0,0,0.096153846,0,0,0,0,0,0,-648270298.7,1592383984,11240.22261,86259168.06,8625916.806,0,91945,3987,618,1867,1249,618,91945,1249,1867,224.1486486,2.698198198,8.274774775,40154.41892,1210.855856,11.05855856,98867.63514,0.395220387,0.012328099,0.000114003,0.668987681,0.020305617,32,0
D:0| T0: 0.10| T1: 0.00| R0: 0.0| R1: 0.0| WTP: 0,0,0.096153846,0,0,0,0,0,0,-649246888.5,1440183867,11240.57629,87218073.97,8721807.397,0,90401,4012,712,1867,1155,712,90401,1155,1867,241.5673077,3.336538462,8.822115385,46862.13942,2099.067308,12.22596154,99007.34135,0.470314749,0.021075583,0.000124547,0.618639529,0.020652426,30,0
D:0| T0: 0.10| T1: 0.00| R0: 0.0| R1: 0.0| WTP: 0,0,0.096153846,0,0,0,0,0,0,-676799220.2,1696510588,11822.59613,85669413.63,8566941.363,0,91617,3904,699,1964,1265,699,91617,1265,1964,225.6376147,3.123853211,8.862385321,48743.10092,1980.633028,12.05963303,99010.26147,0.486481376,0.019985704,0.000123356,0.644093686,0.02143707,31,0
D:0| T0: 0.10| T1: 0.00| R0: 0.0| R1: 0.0| WTP: 0,0,0.096153846,0,0,0,0,0,0,-734758884,895039877,12827.95857,93360955.29,9336095.529,0,98327,4226,601,2131,1530,601,98327,1530,2131,290.8216216,3.189189189,11.38378378,39566.34595,2786.610811,14.62162162,98840.4,0.347554789,0.03026429,0.000160528,0.717972783,0.021672582,25,0
D:0| T0: 0.10| T1: 0.00| R0: 0.0| R1: 0.0| WTP: 0,0,0.096153846,0,0,0,0,0,0,-712524408.7,129565953,12495.93698,87727559.62,8772755.962,0,91996,3956,864,2076,1212,864,91996,1212,2076,198.9285714,3.333333333,8.091269841,44701.78175,2580.968254,11.50396825,98869.60714,0.444315446,0.026174086,0.000118352,0.583815029,0.022566199,35,0
D:0| T0: 0.10| T1: 0.00| R0: 0.0| R1: 0.0| WTP: 0,0,0.096153846,0,0,0,0,0,0,-617331711.1,1902565669,10651.24023,84769699.35,8476969.935,0,88098,3916,684,1769,1085,684,88098,1085,1769,213.5676856,2.895196507,7.585152838,49960.0917,1471.60262,10.5720524,99075.9476,0.49019222,0.015103927,0.000109978,0.613340871,0.020079911,32,0
D:0| T0: 0.10| T1: 0.00| R0: 0.0| R1: 0.0| WTP: 0,0,0.096153846,0,0,0,0,0,0,-673541249.6,1984179288,11809.87474,83047512.77,8304751.277,0,85286,3698,1024,1962,938,1024,85286,938,1962,146.7515528,3.080745342,5.947204969,53041.86025,1997.118012,9.118012422,99012.79193,0.49827358,0.021565166,0.000100176,0.478083588,0.023004948,43,0
D:0| T0: 0.10| T1: 0.00| R0: 0.0| R1: 0.0| WTP: 0,0,0.096153846,0,0,0,0,0,0,-747857677.9,677377223,13115.84607,92065374.24,9206537.424,0,96280,4223,770,2179,1409,770,96280,1409,2179,221.5756303,3.147058824,9.012605042,39363.58403,3290.365546,12.24789916,98768.97479,0.394909604,0.033104249,0.000124738,0.646626893,0.022631907,33,0
D:0| T0: 0.10| T1: 0.00| R0: 0.0| R1: 0.0| WTP: 0,0,0.096153846,0,0,0,0,0,0,-675178391.6,973583301,11526.63031,98846876.14,9884687.614,0,95958,4478,760,1914,1154,760,95958,1154,1914,257,3.304932735,8.421524664,44354.38117,3503.856502,11.8161435,99014.91031,0.439586763,0.035519439,0.000121604,0.60292581,0.019946226,32,0
D:0| T0: 0.10| T1: 0.00| R0: 0.0| R1: 0.0| WTP: 0,0,0.096153846,0,0,0,0,0,0,-568218003.9,781062938,9524.574277,91989290.07,9198929.007,0,91908,4283,703,1581,878,703,91908,878,1581,248.0185185,3.157407407,7.166666667,42947.40278,1958.810185,10.4212963,99104.86111,0.431010423,0.019647004,0.000106081,0.555344719,0.017201985,31,0
D:0| T0: 0.10| T1: 0.00| R0: 0.0| R1: 0.0| WTP: 0,0,0.096153846,0,0,0,0,0,0,-682307978.3,338783425,11871.66043,88724956.98,8872495.698,0,95372,4169,834,1972,1138,834,95372,1138,1972,197.8560311,3.171206226,7.544747082,45889.47471,3026.474708,10.78599222,98999.2179,0.442658151,0.031412057,0.000113348,0.577079108,0.020676928,36,0
D:0| T0: 0.10| T1: 4.00| R0: 0.0| R1: 0.0| WTP: 0,0,0.096153846,4,0,0,0,0,0,-1009495572,650073325,11474.10286,435790428.8,43579042.88,2,92917,4067,744,1906,1162,744,92917,1162,1906,129.3306878,1.891534392,4.941798942,68967.56085,1572.902116,6.912698413,99427.03439,0.529928024,0.023994153,0.000107013,0.609653725,0.020512931,36,4
D:0| T0: 0.10| T1: 4.00| R0: 0.0| R1: 0.0| WTP: 0,0,0.096153846,4,0,0,0,0,0,-1052235497,2029998696,12155.52808,444459092.9,44445909.29,2,97821,4327,673,2019,1346,673,97821,1346,2019,268.1287129,3.237623762,9.851485149,42777.59901,1639.173267,13.18811881,98920.83663,0.399188202,0.017319533,0.000140824,0.666666667,0.02063974,28,4
D:0| T0: 0.10| T1: 4.00| R0: 0.0| R1: 0.0| WTP: 0,0,0.096153846,4,0,0,0,0,0,-1126410295,776062361,13721.61194,440329698.3,44032969.83,2,98030,4061,704,2280,1576,704,98030,1576,2280,205.8714859,2.730923695,9.020080321,48186.47791,2440.578313,11.84337349,98917.36546,0.424950448,0.027304165,0.000134123,0.69122807,0.023258186,31,4
D:0| T0: 0.10| T1: 4.00| R0: 0.0| R1: 0.0| WTP: 0,0,0.096153846,4,0,0,0,0,0,-955976332,1813046880,10570.72704,427439979.8,42743997.98,2,83821,3469,982,1756,774,982,83821,774,1756,129.0560472,2.805309735,5.038348083,60164.75516,1577.466077,7.94100295,99236.66962,0.603211864,0.015862046,8.12383E-05,0.440774487,0.020949404,49,4
D:0| T0: 0.10| T1: 4.00| R0: 0.0| R1: 0.0| WTP: 0,0,0.096153846,4,0,0,0,0,0,-962004554,2032407216,10578.43021,433083043.3,43308304.33,2,87655,3841,706,1757,1051,706,87655,1051,1757,188.468254,2.694444444,6.813492063,57990.44444,1217.809524,9.615079365,99230.23016,0.55840963,0.012893398,0.000103521,0.598178714,0.020044493,35,4
D:0| T0: 0.10| T1: 4.00| R0: 0.0| R1: 0.0| WTP: 0,0,0.096153846,4,0,0,0,0,0,-908062345.3,1507873352,9858.158694,415154410.6,41515441.06,2,71427,2921,1161,1638,477,1161,71427,477,1638,79.53626374,2.428571429,3.446153846,68247.00879,1135.010989,6.004395604,99324.46813,0.671741634,0.011886307,6.44281E-05,0.291208791,0.022932505,62,4
D:0| T0: 0.10| T1: 4.00| R0: 0.0| R1: 0.0| WTP: 0,0,0.096153846,4,0,0,0,0,0,-891862714,1855899401,9397.878986,421968764.6,42196876.46,2,73326,3268,954,1561,607,954,73326,607,1561,109.9540541,2.478378378,4.072972973,66404.92432,739.8162162,6.656756757,99332.06757,0.665189433,0.007456279,6.85013E-05,0.388853299,0.021288783,53,4
D:0| T0: 0.10| T1: 4.00| R0: 0.0| R1: 0.0| WTP: 0,0,0.096153846,4,0,0,0,0,0,-1067571461,1819459251,12615.44652,436799135.4,43679913.54,2,93578,3943,639,2096,1457,639,93578,1457,2096,231.9248826,2.906103286,9.690140845,47105.62911,1576.464789,12.6713615,98917.76526,0.472370854,0.015844292,0.000129125,0.695133588,0.022398427,31,4
D:0| T0: 0.10| T1: 4.00| R0: 0.0| R1: 0.0| WTP: 0,0,0.096153846,4,0,0,0,0,0,-350960853.1,909791748,6.024030199,350659651.6,35065965.16,1,60,2,1,1,0,1,60,0,1,0.590163934,0,0,99965.06557,2.770491803,0.016393443,99999.70492,0.999655805,3.03226E-05,3.22581E-07,0,0.016949153,9,4
D:0| T0: 0.10| T1: 4.00| R0: 0.0| R1: 0.0| WTP: 0,0,0.096153846,4,0,0,0,0,0,-1062087781,1339092841,12631.45861,430514849.9,43051484.99,2,88365,3638,726,2099,1373,726,88365,1373,2099,175.4633205,2.706563707,7.957528958,47160.17761,1224.722008,10.76447876,98816.53668,0.473707265,0.012325755,0.000109781,0.65412101,0.023753749,37,4
D:0| T0: 0.10| T1: 4.00| R0: 0.0| R1: 0.0| WTP: 0,0,0.096153846,4,0,0,0,0,0,-1068679179,1365866345,12468.09428,445274464.8,44527446.48,2,98437,4371,725,2071,1346,725,98437,1346,2071,212.9648438,2.765625,7.98828125,48898.74219,1206.125,10.80078125,99006.37109,0.366274656,0.015061949,0.000136395,0.649927571,0.021038837,30,4
D:0| T0: 0.10| T1: 4.00| R0: 0.0| R1: 0.0| WTP: 0,0,0.096153846,4,0,0,0,0,0,-1017140178,825453433,11411.58685,446560835.5,44656083.55,2,93791,4266,698,1895,1197,698,93791,1197,1895,237.8461538,2.905982906,7.965811966,49686.25214,2037.722222,10.93589744,99083.12821,0.497874342,0.020472507,0.000111383,0.631662269,0.020204497,34,4
D:0| T0: 0.10| T1: 4.00| R0: 0.0| R1: 0.0| WTP: 0,0,0.096153846,4,0,0,0,0,0,-1052309374,939711378,12137.81949,445418399.2,44541839.92,2,98420,4346,650,2016,1366,650,98420,1366,2016,297.7663043,3.440217391,10.79891304,39671.91848,2102.347826,14.31521739,98882.04891,0.397856851,0.021103068,0.000145487,0.677579365,0.020483642,27,4
D:0| T0: 0.10| T1: 4.00| R0: 0.0| R1: 0.0| WTP: 0,0,0.096153846,4,0,0,0,0,0,-1015323053,638950699,11452.3897,442703568,44270356.8,2,92886,4187,801,1902,1101,801,92886,1101,1902,185.1149826,2.703832753,6.494773519,47477.70732,2038.815331,9.275261324,99012.05923,0.476027585,0.020507575,9.47423E-05,0.578864353,0.020476713,41,4
D:0| T0: 0.10| T1: 4.00| R0: 0.0| R1: 0.0| WTP: 0,0,0.096153846,4,0,0,0,0,0,-956025103.6,938699148,10393.35371,436357418.2,43635741.82,2,87391,3892,724,1726,1002,724,87391,1002,1726,168.5986395,2.37755102,5.727891156,57156.07823,1004.789116,8.18707483,99216.32313,0.53668982,0.010951177,9.08453E-05,0.580533024,0.019750318,39,4
D:0| T0: 0.10| T1: 4.00| R0: 0.0| R1: 0.0| WTP: 0,0,0.096153846,4,0,0,0,0,0,-1007561179,1412065496,11307.98917,442161720.5,44216172.05,2,93909,4277,617,1878,1261,617,93909,1261,1878,173.3104575,1.944444444,6.032679739,56852.62418,901.3823529,8.035947712,99194.50654,0.432316485,0.011941064,0.000108064,0.671458999,0.019998083,34,4
D:0| T0: 0.10| T1: 4.00| R0: 0.0| R1: 0.0| WTP: 0,0,0.096153846,4,0,0,0,0,0,-1058528379,1331335240,12293.46149,443855304.9,44385530.49,2,98003,4248,668,2042,1374,668,98003,1374,2042,244.4909091,2.940909091,9.136363636,47407.31364,2935.622727,12.16818182,99029.64091,0.441849881,0.031349721,0.000131601,0.672869736,0.020836097,30,4
D:0| T0: 0.10| T1: 4.00| R0: 0.0| R1: 0.0| WTP: 0,0,0.096153846,4,0,0,0,0,0,-1092103615,470935411,13031.1067,440548279.7,44054827.97,2,94708,4014,757,2165,1408,757,94708,1408,2165,266.8238342,3.85492228,11.06217617,41231.2487,1270.611399,14.97409326,98770.69948,0.343077685,0.014322156,0.000170773,0.65034642,0.022859737,25,4
D:0| T0: 0.10| T1: 4.00| R0: 0.0| R1: 0.0| WTP: 0,0,0.096153846,4,0,0,0,0,0,-1056167954,823434397,12452.28374,433553767.5,43355376.75,2,91487,3830,749,2069,1320,749,91487,1320,2069,190.7419355,2.931451613,8.189516129,52813.06452,1883.471774,11.2016129,99026.77016,0.529380489,0.018950375,0.00011434,0.637989367,0.022615235,36,4
D:0| T0: 0.10| T1: 4.00| R0: 0.0| R1: 0.0| WTP: 0,0,0.096153846,4,0,0,0,0,0,-921145018.4,493045351,9939.04057,424192989.9,42419298.99,2,78607,3396,831,1651,820,831,78607,820,1651,145.4359862,2.795847751,5.581314879,62464.15917,692.1280277,8.453287197,99270.20415,0.623892224,0.007002775,8.6896E-05,0.496668686,0.021003219,41,4
D:0| T0: 0.10| T1: 4.00| R0: 0.0| R1: 0.0| WTP: 0,0,0.096153846,4,0,0,0,0,0,-940256920.7,1700216563,10016.01887,439455977.3,43945597.73,2,88559,4122,761,1663,902,761,88559,902,1663,183.8642857,2.621428571,5.796428571,54528.13571,1709.910714,8.517857143,99216.75357,0.546517022,0.017175873,8.69791E-05,0.542393265,0.018778441,40,4
D:0| T0: 0.10| T1: 4.00| R0: 0.0| R1: 0.0| WTP: 0,0,0.096153846,4,0,0,0,0,0,-942367679.1,1744119059,10164.4122,434147068.9,43414706.89,2,86227,3880,705,1688,983,705,86227,983,1688,200.153527,2.834024896,6.863070539,53428.94606,989.1742739,9.763485477,99157.25311,0.535938801,0.009929985,9.97102E-05,0.582345972,0.019576235,35,4
D:0| T0: 0.10| T1: 4.00| R0: 0.0| R1: 0.0| WTP: 0,0,0.096153846,4,0,0,0,0,0,-970981998.2,2036906360,10817.80868,430091564.1,43009156.41,2,84679,3594,988,1797,809,988,84679,809,1797,117.4015544,2.471502591,4.53626943,60934.32383,1531.621762,7.10880829,99240.5285,0.591786117,0.01616186,7.6151E-05,0.450194769,0.021221819,52,4
D:0| T0: 0.10| T1: 4.00| R0: 0.0| R1: 0.0| WTP: 0,0,0.096153846,4,0,0,0,0,0,-975115181.3,809704121,10742.18388,438005987.3,43800598.73,2,90994,4103,757,1784,1027,757,90994,1027,1784,176.8877193,2.561403509,6.105263158,52398.27719,1646.529825,8.757894737,99141.99298,0.521782095,0.016665946,9.02642E-05,0.575672646,0.019605688,40,4
D:0| T0: 0.10| T1: 4.00| R0: 0.0| R1: 0.0| WTP: 0,0,0.096153846,4,0,0,0,0,0,-1056902557,1219866412,12216.12851,446096132.1,44609613.21,2,98291,4407,719,2029,1310,719,98291,1310,2029,244.8933333,3.106666667,8.871111111,40384.16,3591.702222,12.05777778,98898.16,0.404788312,0.03610505,0.000122815,0.645638245,0.020642785,33,4
D:0| T0: 0.10| T1: 4.00| R0: 0.0| R1: 0.0| WTP: 0,0,0.096153846,4,0,0,0,0,0,-900267914.6,843498920,9577.825629,421376633.2,42137663.32,2,77217,3239,902,1591,689,902,77217,689,1591,113.3230337,2.421348315,4.320224719,64872.34551,1046.932584,6.853932584,99326.16011,0.650492361,0.010521341,7.03863E-05,0.433060968,0.020604805,51,4
D:0| T0: 0.10| T1: 4.00| R0: 0.0| R1: 0.0| WTP: 0,0,0.096153846,4,0,0,0,0,0,-1108135118,107351963,13473.52929,434458654.2,43445865.42,2,93412,3870,850,2239,1389,850,93412,1389,2239,170.2867384,2.953405018,7.885304659,50572.32616,2324.394265,10.91397849,98929.1828,0.505128208,0.023493371,0.000111958,0.620366235,0.02396934,40,4
D:0| T0: 0.10| T1: 4.00| R0: 0.0| R1: 0.0| WTP: 0,0,0.096153846,4,0,0,0,0,0,-1014237104,773789021,11463.83127,441045541.1,44104554.11,2,92800,4187,763,1904,1141,763,92800,1141,1904,186.15,2.632142857,6.667857143,50295.71429,2241.639286,9.392857143,99074.775,0.500467106,0.022699933,9.65007E-05,0.599264706,0.020517241,40,4
D:0| T0: 0.10| T1: 4.00| R0: 0.0| R1: 0.0| WTP: 0,0,0.096153846,4,0,0,0,0,0,-1094932889,850936611,13244.72093,432696842.9,43269684.29,2,91377,3769,759,2201,1442,759,91377,1442,2201,187.124498,2.947791165,8.686746988,55347.89558,1938.168675,11.74297189,99032.40562,0.528207086,0.020660774,0.000126806,0.655454545,0.024076344,34,4
D:0| T0: 0.10| T1: 4.00| R0: 0.0| R1: 0.0| WTP: 0,0,0.096153846,4,0,0,0,0,0,-1052212814,1701318364,12232.35605,440595011.4,44059501.14,2,92193,4147,717,2032,1315,717,92193,1315,2032,203.6614173,2.724409449,7.850393701,47808.73622,1539.838583,10.68110236,98937.07087,0.453819533,0.016253364,0.000114267,0.647145669,0.022040719,35,4
D:0| T0: 0.10| T1: 4.00| R0: 0.0| R1: 0.0| WTP: 0,0,0.096153846,4,0,0,0,0,0,-948239545.2,778708269,10450.12589,425733250.5,42573325.05,2,77820,3342,1129,1736,607,1129,77820,607,1736,92.00431965,2.343412527,3.61987041,62457.18143,1289.647948,6.060475162,99218.66307,0.624220228,0.013064336,6.26873E-05,0.349654378,0.02230789,66,4
D:0| T0: 0.10| T1: 4.00| R0: 0.0| R1: 0.0| WTP: 0,0,0.096153846,4,0,0,0,0,0,-1031795959,1391938506,12101.75551,426708183.4,42670818.34,2,84017,3522,798,2011,1213,798,84017,1213,2011,159.2287823,2.793357934,7.225092251,55852.67897,1110.413284,10.19926199,99018.27675,0.56059192,0.01116999,0.000104304,0.603182496,0.023935632,39,4
D:0| T0: 0.10| T1: 4.00| R0: 0.0| R1: 0.0| WTP: 0,0,0.096153846,4,0,0,0,0,0,-873499277.1,43418681,9173.401921,414829181.1,41482918.11,2,68759,3017,1116,1524,408,1116,68759,408,1524,85.87885986,2.520190024,3.458432304,64477.61045,917.4418052,6.116389549,99258.10689,0.647500794,0.00922284,6.30343E-05,0.267716535,0.022164371,61,4
D:0| T0: 0.10| T1: 4.00| R0: 0.0| R1: 0.0| WTP: 0,0,0.096153846,4,0,0,0,0,0,-1112185433,817384966,13504.39097,436965884.5,43696588.45,2,95501,3941,861,2244,1383,861,95501,1383,2244,220.8558559,3.801801802,9.968468468,34032.61261,1172.157658,13.86936937,98558.08559,0.333580387,0.011951767,0.000142675,0.61631016,0.023497136,32,4
D:0| T0: 0.10| T1: 4.00| R0: 0.0| R1: 0.0| WTP: 0,0,0.096153846,4,0,0,0,0,0,-1026762752,762053968,11692.37512,442143996.3,44214399.63,2,96835,4291,732,1942,1210,732,96835,1210,1942,256.038835,3.461165049,9.291262136,39527.7767,1463.684466,12.8592233,98883.95146,0.39082413,0.01484493,0.000131643,0.623069001,0.020054732,30,4
D:0| T0: 0.10| T1: 4.00| R0: 0.0| R1: 0.0| WTP: 0,0,0.096153846,4,0,0,0,0,0,-980336029.7,1692506311,10832.51931,438710064,43871006.4,2,91526,4143,835,1799,964,835,91526,964,1799,159.0595611,2.510971787,5.492163009,51945.92163,1921.470219,8.119122257,99133.94984,0.496992794,0.02027266,8.71328E-05,0.535853252,0.019655617,43,4
D:0| T0: 0.10| T1: 4.00| R0: 0.0| R1: 0.0| WTP: 0,0,0.096153846,4,0,0,0,0,0,-1033732846,883828863,11771.43186,445161252.8,44516125.28,2,95746,4301,681,1955,1274,681,95746,1274,1955,186.6587031,2.283276451,6.580204778,63742.31741,852.1365188,8.911262799,99323.40614,0.369712138,0.014900566,0.000157479,0.651662404,0.020418608,24,4
D:0| T0: 0.10| T1: 4.00| R0: 0.0| R1: 0.0| WTP: 0,0,0.096153846,4,0,0,0,0,0,-978728792.1,301400999,10962.046,430626492.1,43062649.21,2,83934,3675,850,1821,971,850,83934,971,1821,163.9605735,2.953405018,6.369175627,58254.39068,1252.971326,9.397849462,99173.35484,0.58424147,0.01259353,9.62581E-05,0.533223504,0.021695876,40,4
D:0| T0: 0.10| T1: 4.00| R0: 0.0| R1: 0.0| WTP: 0,0,0.096153846,4,0,0,0,0,0,-1043941949,1868336855,12016.93183,443095357.2,44309535.72,2,97042,4294,628,1996,1368,628,97042,1368,1996,223.4686192,2.523012552,8.205020921,39694.24268,1586.050209,10.85355649,98856.58996,0.398008463,0.01594321,0.000110417,0.685370741,0.020568414,35,4
D:0| T0: 0.10| T1: 4.00| R0: 0.0| R1: 0.0| WTP: 0,0,0.096153846,4,0,0,0,0,0,-1084864562,1868498144,12910.5231,439338407,43933840.7,2,96193,4122,650,2145,1495,650,96193,1495,2145,225.0486726,2.774336283,9.345132743,42845.67699,1780.10177,12.21238938,98835.52212,0.429597692,0.017902346,0.000124435,0.696969697,0.02229892,33,4
D:0| T0: 0.10| T1: 4.00| R0: 0.0| R1: 0.0| WTP: 0,0,0.096153846,4,0,0,0,0,0,-915673123.3,2101566889,9748.240422,428261102.2,42826110.22,2,79966,3567,966,1619,653,966,79966,653,1619,134.2598187,2.821752266,4.752265861,59084.96677,1365.622356,7.667673716,99236.27492,0.592782377,0.013723285,7.84887E-05,0.403335392,0.020246105,48,4
D:0| T0: 0.10| T1: 4.00| R0: 0.0| R1: 0.0| WTP: 0,0,0.096153846,4,0,0,0,0,0,-1072119386,1665097450,12611.0447,441567150.6,44156715.06,2,96262,4108,733,2095,1362,733,96262,1362,2095,215.8099174,2.979338843,8.549586777,41260.78099,1362.409091,11.5785124,98801.42562,0.315411883,0.016011919,0.000137378,0.650119332,0.02176352,30,4
D:0| T0: 0.10| T1: 4.00| R0: 0.0| R1: 0.0| WTP: 0,0,0.096153846,4,0,0,0,0,0,-990401238.1,1716179948,10817.98784,449501845.9,44950184.59,2,98356,4566,717,1796,1079,717,98356,1079,1796,279.1650485,3.402912621,8.59223301,33150.65049,1647.029126,12.07281553,98871.50971,0.332912052,0.016533888,0.000122437,0.60077951,0.018260198,30,4
D:0| T0: 0.10| T1: 4.00| R0: 0.0| R1: 0.0| WTP: 0,0,0.096153846,4,0,0,0,0,0,-986415224.7,1560278715,11336.84867,419572791,41957279.1,2,75878,3070,917,1884,967,917,75878,967,1884,116.2035928,2.667664671,5.523952096,64231.04192,773.9491018,8.260479042,99170.25449,0.623275388,0.008256223,8.94733E-05,0.513269639,0.024829331,44,4
D:0| T0: 0.10| T1: 4.00| R0: 0.0| R1: 0.0| WTP: 0,0,0.096153846,4,0,0,0,0,0,-1107206707,991019385,13236.78384,445367515,44536751.5,2,98184,4247,619,2199,1580,619,98184,1580,2199,243.7276786,2.65625,9.651785714,39860.35268,2601.928571,12.41964286,98775.26339,0.399550031,0.026171697,0.000126613,0.718508413,0.022396725,32,4
D:0| T0: 0.10| T1: 4.00| R0: 0.0| R1: 0.0| WTP: 0,0,0.096153846,4,0,0,0,0,0,-1070525714,118052103,12551.38593,442956417.4,44295641.74,2,96679,4272,664,2085,1421,664,96679,1421,2085,224.3122363,2.717299578,8.662447257,54694.827,2059.772152,11.4556962,99134.94937,0.505815997,0.022614163,0.000127421,0.681534772,0.021566214,31,4
D:0| T0: 0.10| T1: 4.00| R0: 0.0| R1: 0.0| WTP: 0,0,0.096153846,4,0,0,0,0,0,-1095272860,1209758844,13173.91274,436577223.2,43657722.32,2,94833,3926,723,2189,1466,723,94833,1466,2189,224.9082569,3.233944954,9.912844037,49772.88991,1276.490826,13.23394495,98937.79817,0.431306027,0.014567433,0.000152467,0.669712197,0.023082682,28,4
D:0| T0: 0.10| T1: 4.00| R0: 0.0| R1: 0.0| WTP: 0,0,0.096153846,4,0,0,0,0,0,-962996362.2,70671723,10691.16854,428437935.4,42843793.54,2,79612,3477,1001,1776,775,1001,79612,775,1776,119.1935484,2.591397849,4.63172043,62180.52419,1311.021505,7.309139785,99218.47849,0.61965917,0.013333048,7.5923E-05,0.436373874,0.022308195,53,4
D:0| T0: 0.10| T1: 4.00| R0: 0.0| R1: 0.0| WTP: 0,0,0.096153846,4,0,0,0,0,0,-900198694.2,1722612191,9436.05628,428395880.1,42839588.01,2,75430,3474,1060,1567,507,1060,75430,507,1567,111.35,2.55,3.7775,63893.5025,1045.225,6.44,99302.5525,0.639173009,0.010560496,6.63561E-05,0.323548181,0.020774228,56,4
D:0| T0: 0.10| T1: 4.00| R0: 0.0| R1: 0.0| WTP: 0,0,0.096153846,4,0,0,0,0,0,-855095154.1,1968291596,8612.003855,424494961.3,42449496.13,2,72148,3330,941,1430,489,941,72148,489,1430,118.2479109,2.512534819,3.849582173,66681.25905,801.6072423,6.454038997,99387.83844,0.658316736,0.008303799,6.84224E-05,0.341958042,0.019820369,50,4
D:0| T0: 0.10| T1: 4.00| R0: 0.0| R1: 0.0| WTP: 0,0,0.096153846,4,0,0,0,0,0,-1107084494,1877569084,13301.81287,441993850.8,44199385.08,2,97672,4125,763,2210,1447,763,97672,1447,2210,253.8543689,3.645631068,10.60194175,37254.76699,1518.606796,14.30097087,98689.01456,0.342328256,0.016050067,0.00015253,0.654751131,0.022626751,28,4
D:0| T0: 0.10| T1: 4.00| R0: 0.0| R1: 0.0| WTP: 0,0,0.096153846,4,0,0,0,0,0,-1055638716,1726322189,12268.93048,442192191.4,44219219.14,2,96876,4218,751,2038,1287,751,96876,1287,2038,220.2594142,3.079497908,8.410041841,32242.12134,1371.32636,11.56066946,98667.8159,0.306706717,0.014142078,0.000120356,0.631501472,0.021037202,34,4
D:0| T0: 0.10| T1: 4.00| R0: 0.0| R1: 0.0| WTP: 0,0,0.096153846,4,0,0,0,0,0,-1074944662,307848836,12659.14337,441987494,44198749.4,2,96844,4270,622,2103,1481,622,96844,1481,2103,281.0909091,3.22459893,11.0855615,43323.4385,1823.112299,14.40106952,98890.21925,0.43437999,0.018312128,0.000146422,0.704232049,0.021715336,27,4
D:0| T0: 0.10| T1: 4.00| R0: 0.0| R1: 0.0| WTP: 0,0,0.096153846,4,0,0,0,0,0,-1009264026,1154000220,11349.977,441765175.9,44176517.59,2,93041,4242,794,1885,1091,794,93041,1091,1885,290.2320442,4.276243094,10.24309392,32726.9779,1337.176796,14.62983425,98743.87293,0.329993149,0.01341781,0.000148651,0.578779841,0.020259885,26,4
D:0| T0: 0.10| T1: 4.00| R0: 0.0| R1: 0.0| WTP: 0,0,0.096153846,4,0,0,0,0,0,-913925466.9,2028661055,9800.892743,423880829.8,42388082.98,2,75351,3217,964,1628,664,964,75351,664,1628,124.0445104,2.759643917,4.673590504,62564.18694,1167.183976,7.537091988,99246.18991,0.627874435,0.011731226,7.73095E-05,0.407862408,0.021605553,49,4
D:0| T0: 0.10| T1: 4.00| R0: 0.0| R1: 0.0| WTP: 0,0,0.096153846,4,0,0,0,0,0,-1046883995,1629114640,12147.91676,439488157.1,43948815.71,2,95826,4156,736,2018,1282,736,95826,1282,2018,225.7743363,3.14159292,8.756637168,50237.33628,2635.800885,12.03539823,99072.36283,0.503176615,0.026499036,0.000122535,0.635282458,0.021059003,33,4
D:0| T0: 0.10| T1: 4.00| R0: 0.0| R1: 0.0| WTP: 0,0,0.096153846,4,0,0,0,0,0,-1111173511,1439048174,13285.39122,446903950,44690395,2,98044,4367,774,2207,1433,774,98044,1433,2207,251.35,3.468181818,9.913636364,33415.60455,1896.336364,13.43181818,98609.82727,0.326525163,0.019340953,0.000138195,0.649297689,0.022510301,31,4
D:0| T0: 0.10| T1: 4.00| R0: 0.0| R1: 0.0| WTP: 0,0,0.096153846,4,0,0,0,0,0,-1051249019,865227006,12350.26715,433735660.9,43373566.09,2,90685,3784,767,2052,1285,767,90685,1285,2052,218.6497696,3.405529954,9.276497696,39519.29954,1121.898618,12.8202765,98725.57143,0.308863763,0.012936503,0.000149996,0.626218324,0.022627777,27,4
D:0| T0: 0.10| T1: 4.00| R0: 0.0| R1: 0.0| WTP: 0,0,0.096153846,4,0,0,0,0,0,-1087101921,890479738,12881.71141,443016350.3,44301635.03,2,97683,4340,718,2140,1422,718,97683,1422,2140,251.2796209,3.322274882,9.995260664,45369.49763,3310.146919,13.39336493,98948.19431,0.454505001,0.033281682,0.000136257,0.664485981,0.021907599,31,4
D:0| T0: 0.10| T1: 4.00| R0: 0.0| R1: 0.0| WTP: 0,0,0.096153846,4,0,0,0,0,0,-970474231.5,1017049163,10811.63807,429892328,42989232.8,2,83136,3647,766,1796,1030,766,83136,1030,1796,162.8172043,2.64874552,6.286738351,60960.68459,1055.146953,9.028673835,99216.51971,0.611195384,0.010606854,9.23165E-05,0.573496659,0.021603156,40,4
D:0| T0: 0.10| T1: 4.00| R0: 0.0| R1: 0.0| WTP: 0,0,0.096153846,4,0,0,0,0,0,-350637494.6,1707305064,0.011604396,350636914.4,35063691.44,2,44,2,0,0,0,0,44,0,0,0.268292683,0,0,99977.2439,2.109756098,0,100000,0.999744521,2.61644E-05,0,0,0,11,4
D:0| T0: 0.10| T1: 4.00| R0: 0.0| R1: 0.0| WTP: 0,0,0.096153846,4,0,0,0,0,0,-1052861035,400145663,12338.99798,435911135.8,43591113.58,2,90080,3857,818,2050,1232,818,90080,1232,2050,239.9802956,3.935960591,9.955665025,30172.64039,1190.945813,13.97536946,98509.8867,0.305097797,0.011966272,0.000142152,0.60097561,0.022757549,29,4
D:0| T0: 0.10| T1: 4.00| R0: 0.0| R1: 0.0| WTP: 0,0,0.096153846,4,0,0,0,0,0,-983225808.6,1662654181,11004.8252,432984548.5,43298454.85,2,85452,3753,776,1828,1052,776,85452,1052,1828,159.2020202,2.525252525,6.016835017,58645.13131,1175.084175,8.64983165,99178.39057,0.58791821,0.011816913,8.81805E-05,0.575492341,0.021392127,43,4
D:0| T0: 0.10| T1: 4.00| R0: 0.0| R1: 0.0| WTP: 0,0,0.096153846,4,0,0,0,0,0,-1027613851,182136456,11669.04313,444161694.5,44416169.45,2,97413,4354,794,1938,1144,794,97413,1144,1938,286.8031915,4.159574468,10.15957447,39248.03723,1788.526596,14.36702128,98895.32979,0.377568882,0.018445175,0.000149856,0.590299278,0.019894675,27,4
D:0| T0: 0.10| T1: 4.00| R0: 0.0| R1: 0.0| WTP: 0,0,0.096153846,4,0,0,0,0,0,-350949605,979575387,6.020337891,350648588.1,35064858.81,2,39,2,1,1,0,1,39,0,1,0.397260274,0,0,99973.34247,3.178082192,0.01369863,99999.63014,0.999739188,3.32433E-05,2.7027E-07,0,0.025641026,11,4
D:0| T0: 0.10| T1: 4.00| R0: 0.0| R1: 0.0| WTP: 0,0,0.096153846,4,0,0,0,0,0,-1083278477,2142525414,12921.82009,437187472.1,43718747.21,2,97964,4056,631,2147,1516,631,97964,1516,2147,231.5373832,2.831775701,9.873831776,46402.36916,1799.369159,12.8411215,98943.63084,0.430262424,0.01925138,0.000138984,0.706101537,0.021916214,29,4
D:0| T0: 0.10| T1: 4.00| R0: 0.0| R1: 0.0| WTP: 0,0,0.096153846,4,0,0,0,0,0,-1034936373,1464057597,11895.87578,440142583.9,44014258.39,2,94673,4132,645,1976,1331,645,94673,1331,1976,236.7798165,2.834862385,8.880733945,50994.36697,1627.747706,11.8440367,99082.16514,0.508544286,0.016427916,0.000121404,0.673582996,0.020871843,31,4
D:0| T0: 0.10| T1: 4.00| R0: 0.0| R1: 0.0| WTP: 0,0,0.096153846,4,0,0,0,0,0,-1046802633,364562610,12183.34204,437635531.4,43763553.14,2,95205,4061,700,2024,1324,700,95205,1324,2024,224.8108108,3.067567568,8.977477477,39360.80631,1448.599099,12.15765766,98801.1982,0.38126497,0.014895047,0.00012617,0.654150198,0.021259388,31,4
D:0| T0: 0.10| T1: 4.00| R0: 0.0| R1: 0.0| WTP: 0,0,0.096153846,4,0,0,0,0,0,-1087247342,40350784,12976.28008,438433337.7,43843333.77,2,96534,4041,612,2156,1544,612,96534,1544,2156,256.8928571,3.005102041,10.82653061,44791.70918,1910.857143,13.95918367,98886.33163,0.448968922,0.019203599,0.000142003,0.716141002,0.0223341,28,4
D:0| T0: 0.10| T1: 4.00| R0: 0.0| R1: 0.0| WTP: 0,0,0.096153846,4,0,0,0,0,0,-997136656.3,804064356,11015.09746,446381783.1,44638178.31,2,96326,4390,569,1829,1260,569,96326,1260,1829,287.2886598,2.845360825,9.298969072,51171.84536,1436.659794,12.21134021,99164.79897,0.477525954,0.015441796,0.000132923,0.688901039,0.018987605,26,4
D:0| T0: 0.10| T1: 4.00| R0: 0.0| R1: 0.0| WTP: 0,0,0.096153846,4,0,0,0,0,0,-1038356450,2125493986,12109.742,432869350.4,43286935.04,2,89159,3700,684,2012,1328,684,89159,1328,2012,212.1396396,2.941441441,8.864864865,54223.36036,1274.171171,11.95495495,99050.75225,0.541670096,0.012863632,0.000122643,0.660039761,0.022566426,32,4
D:0| T0: 0.10| T1: 4.00| R0: 0.0| R1: 0.0| WTP: 0,0,0.096153846,4,0,0,0,0,0,-958713742.5,23154253,10299.6174,443732872.5,44373287.25,2,91813,4282,641,1710,1069,641,91813,1069,1710,209.2702703,2.374517375,6.459459459,42439.69884,947.2432432,8.938223938,98997.69112,0.405340361,0.009851203,9.44551E-05,0.625146199,0.018624813,36,4
D:0| T0: 0.10| T1: 4.00| R0: 0.0| R1: 0.0| WTP: 0,0,0.096153846,4,0,0,0,0,0,-900741763.7,1391367689,9595.694184,420957054.5,42095705.45,2,75796,3225,849,1594,745,849,75796,745,1594,131.0947712,2.683006536,5.078431373,62624.72549,840.9673203,7.846405229,99268.45752,0.615830909,0.008731432,8.29079E-05,0.467377666,0.021030134,43,4
D:0| T0: 0.10| T1: 4.00| R0: 0.0| R1: 0.0| WTP: 0,0,0.096153846,4,0,0,0,0,0,-977947135.8,574142276,10843.55497,435769387.4,43576938.74,2,90883,3862,677,1801,1124,677,90883,1124,1801,168.8659794,2.257731959,6.089347079,45926.39519,1436.817869,8.402061856,98993.70103,0.453237361,0.014643343,8.68104E-05,0.624097723,0.019816687,41,4
D:0| T0: 0.10| T1: 4.00| R0: 0.0| R1: 0.0| WTP: 0,0,0.096153846,4,0,0,0,0,0,-887487027.7,898736779,9355.170814,419728487,41972848.7,2,73250,3170,1103,1554,451,1103,73250,451,1554,88.17117117,2.380630631,3.371621622,68043.16892,1221.362613,5.844594595,99374.11712,0.670500449,0.012736427,6.2418E-05,0.29021879,0.021215017,62,4
D:0| T0: 0.10| T1: 4.00| R0: 0.0| R1: 0.0| WTP: 0,0,0.096153846,4,0,0,0,0,0,-968574430.2,346473503,10379.54974,449596943.4,44959694.34,2,97594,4664,592,1723,1131,592,97594,1131,1723,192.013289,1.890365449,5.617940199,57473.41196,1841.053156,7.591362126,99323.42193,0.441731735,0.024282416,0.000101515,0.656413233,0.017654774,33,4
D:0| T0: 0.10| T1: 4.00| R0: 0.0| R1: 0.0| WTP: 0,0,0.096153846,4,0,0,0,0,0,-1053776347,445552282,12191.48601,444202047,44420204.7,2,95005,4296,708,2025,1317,708,95005,1317,2025,183.6088435,2.30952381,6.755102041,58986.15646,1855.442177,9.173469388,99209.47619,0.500574662,0.022757909,0.00011407,0.65037037,0.021314668,34,4
D:0| T0: 0.10| T1: 4.00| R0: 0.0| R1: 0.0| WTP: 0,0,0.096153846,4,0,0,0,0,0,-1018288715,911758476,11465.1436,445031534.5,44503153.45,2,93905,4289,765,1904,1139,765,93905,1139,1904,284.3541667,3.880208333,9.71875,43793.42708,1369.848958,13.71354167,98959.54167,0.348540592,0.01598783,0.000162375,0.598214286,0.020275811,24,4
D:0| T0: 0.10| T1: 4.00| R0: 0.0| R1: 0.0| WTP: 0,0,0.096153846,4,0,0,0,0,0,-1047840915,1464197940,11959.13144,449884343.2,44988434.32,2,98440,4503,695,1986,1291,695,98440,1291,1986,271.4764151,3.16509434,9.216981132,35522.15094,2695.150943,12.50943396,98810.38679,0.356436173,0.0270751,0.000127069,0.650050352,0.020174726,31,4
D:0| T0: 0.10| T1: 4.00| R0: 0.0| R1: 0.0| WTP: 0,0,0.096153846,4,0,0,0,0,0,-1032811073,500405854,11936.63681,435979232.7,43597923.27,2,87934,3873,781,1983,1202,781,87934,1202,1983,185.2386364,2.871212121,7.371212121,55115.76515,1352.162879,10.31439394,99067.91667,0.531482212,0.014245777,0.000110323,0.606152295,0.022551004,36,4
D:0| T0: 0.10| T1: 4.00| R0: 0.0| R1: 0.0| WTP: 0,0,0.096153846,4,0,0,0,0,0,-1102285868,772037341,13282.47413,438162161.7,43816216.17,2,96384,4091,664,2207,1543,664,96384,1543,2207,259.2124352,3.321243523,11.25388601,44049,1635.854922,14.71502591,98821.27461,0.441787021,0.016445118,0.000149556,0.699139103,0.022897991,28,4
D:0| T0: 0.10| T1: 4.00| R0: 0.0| R1: 0.0| WTP: 0,0,0.096153846,4,0,0,0,0,0,-842180565,1543158763,8460.152438,419172943.2,41917294.32,2,69646,3106,993,1405,412,993,69646,412,1405,89.20728929,2.154897494,3.06833713,66952.18907,769.7790433,5.332574032,99371.51708,0.662479861,0.007950861,5.64196E-05,0.293238434,0.020173449,61,4
D:0| T0: 0.10| T1: 4.00| R0: 0.0| R1: 0.0| WTP: 0,0,0.096153846,4,0,0,0,0,0,-1117430218,1604932531,13535.591,440650667.7,44065066.77,2,96460,4105,791,2249,1458,791,96460,1458,2249,245.7464115,3.732057416,10.64593301,38986.43541,1355.808612,14.41148325,98675.7177,0.341527349,0.014766384,0.000158442,0.648288128,0.023315364,28,4
D:0| T0: 0.10| T1: 4.00| R0: 0.0| R1: 0.0| WTP: 0,0,0.096153846,4,0,0,0,0,0,-1089553104,539051477,12888.41022,445132593,44513259.3,2,98313,4296,679,2141,1462,679,98313,1462,2141,224.0658436,2.691358025,8.666666667,48919.11111,2316.658436,11.46502058,99006.21399,0.415406065,0.026696195,0.000133797,0.682858477,0.021777384,31,4
D:0| T0: 0.10| T1: 4.00| R0: 0.0| R1: 0.0| WTP: 0,0,0.096153846,4,0,0,0,0,0,-351017927.4,1743124675,6.041964265,350715829.2,35071582.92,1,67,6,1,1,0,1,67,0,1,1.044776119,0,0,99964.02985,3.119402985,0.014925373,99999.62687,0.999618251,3.49208E-05,3.1746E-07,0,0.015151515,9,4
D:0| T0: 0.10| T1: 4.00| R0: 0.0| R1: 0.0| WTP: 0,0,0.096153846,4,0,0,0,0,0,-1031780468,1965983789,11906.77871,436441532.9,43644153.29,2,89911,3887,827,1978,1151,827,89911,1151,1978,161.6644737,2.641447368,6.375,53309.14803,1726.088816,9.082236842,99062.48355,0.525083523,0.017715557,9.47414E-05,0.58190091,0.021999533,43,4
D:0| T0: 0.10| T1: 4.00| R0: 0.0| R1: 0.0| WTP: 0,0,0.096153846,4,0,0,0,0,0,-1002822102,516774280,11365.67168,434538517.6,43453851.76,2,87624,3853,856,1888,1032,856,87624,1032,1888,162.3817568,2.777027027,6.216216216,57713.57432,1917.472973,9.10472973,99176.63176,0.575623381,0.019415943,9.38975E-05,0.546610169,0.021546608,41,4
D:0| T0: 0.10| T1: 4.00| R0: 0.0| R1: 0.0| WTP: 0,0,0.096153846,4,0,0,0,0,0,-998389498.6,86603142,11251.91933,435793532.2,43579353.22,2,88466,3815,624,1869,1245,624,88466,1245,1869,268.4863388,3.322404372,10.08196721,36554.03825,1253.431694,13.45901639,98748.79781,0.32826279,0.013375069,0.000145509,0.666131621,0.021126999,25,4
D:0| T0: 0.10| T1: 4.00| R0: 0.0| R1: 0.0| WTP: 0,0,0.096153846,4,0,0,0,0,0,-962923037.1,1431870609,10655.65951,430140061.6,43014006.16,2,82658,3657,963,1770,807,963,82658,807,1770,124.339726,2.556164384,4.728767123,55820.70411,1569.279452,7.356164384,99119.41918,0.56017571,0.01578661,7.5335E-05,0.455932203,0.021413535,53,4
D:0| T0: 0.10| T1: 4.00| R0: 0.0| R1: 0.0| WTP: 0,0,0.096153846,4,0,0,0,0,0,-1002840821,1592383984,11282.86125,438697758.4,43869775.84,2,91657,4088,655,1874,1219,655,91657,1219,1874,219.1681034,2.711206897,7.913793103,50219.84483,1150.073276,10.76293103,99062.1681,0.496976075,0.011704399,0.000110976,0.650480256,0.020445792,33,4
D:0| T0: 0.10| T1: 4.00| R0: 0.0| R1: 0.0| WTP: 0,0,0.096153846,4,0,0,0,0,0,-985542729.8,1440183867,10946.44229,438220615.1,43822061.51,2,90168,4025,733,1818,1085,733,90168,1085,1818,205.5447154,2.861788618,7.207317073,55378.09756,1767.593496,10.19512195,99190.88211,0.554874055,0.017755142,0.000104215,0.596809681,0.020162364,36,4
D:0| T0: 0.10| T1: 4.00| R0: 0.0| R1: 0.0| WTP: 0,0,0.096153846,4,0,0,0,0,0,-1039289379,1696510588,12045.04841,437036958.1,43703695.81,2,91705,3906,688,2001,1313,688,91705,1313,2001,190.8807692,2.580769231,7.592307692,53553.73077,1659.161538,10.24615385,99073.34615,0.534834817,0.016748505,0.000104452,0.656171914,0.021819966,37,4
D:0| T0: 0.10| T1: 4.00| R0: 0.0| R1: 0.0| WTP: 0,0,0.096153846,4,0,0,0,0,0,-1084132926,895039877,12809.86104,443639873.7,44363987.37,2,98064,4198,656,2128,1472,656,98064,1472,2128,253.8104265,3.037914692,9.957345972,46466.14218,2447.957346,13.06635071,98960.59716,0.427586757,0.026354282,0.000142073,0.691729323,0.021700114,29,4
D:0| T0: 0.10| T1: 4.00| R0: 0.0| R1: 0.0| WTP: 0,0,0.096153846,4,0,0,0,0,0,-1072777947,129565953,12759.03617,434826138.2,43482613.82,2,91655,3825,896,2120,1224,896,91655,1224,2120,144.6646526,2.607250755,6.268882175,45332.54985,1949.453172,8.987915408,98827.65861,0.451628126,0.019755425,9.23611E-05,0.577358491,0.023130217,46,4
D:0| T0: 0.10| T1: 4.00| R0: 0.0| R1: 0.0| WTP: 0,0,0.096153846,4,0,0,0,0,0,-988900809.8,1902565669,11047.94097,436503761.3,43650376.13,2,88316,4054,676,1835,1159,676,88316,1159,1835,183.9739777,2.431226766,6.706319703,58912.27881,1260.72119,9.211895911,99216.24164,0.58247816,0.012910717,9.56215E-05,0.631607629,0.020777662,38,4
D:0| T0: 0.10| T1: 4.00| R0: 0.0| R1: 0.0| WTP: 0,0,0.096153846,4,0,0,0,0,0,-1004126155,1984179288,11513.91307,428430501.7,42843050.17,2,85528,3463,1021,1913,892,1021,85528,892,1913,111.7088608,2.488607595,4.716455696,54921.8557,1645.448101,7.298734177,99062.75443,0.524598422,0.017540815,7.92028E-05,0.466283325,0.022366944,54,4
D:0| T0: 0.10| T1: 4.00| R0: 0.0| R1: 0.0| WTP: 0,0,0.096153846,4,0,0,0,0,0,-1068035057,677377223,12568.35532,439617291.4,43961729.14,2,96194,4138,786,2088,1302,786,96194,1302,2088,178.8280702,2.659649123,7.164912281,41210.4386,2743.792982,9.943859649,98834.39649,0.41319974,0.027616353,0.000101542,0.623563218,0.021706136,40,4
D:0| T0: 0.10| T1: 4.00| R0: 0.0| R1: 0.0| WTP: 0,0,0.096153846,4,0,0,0,0,0,-1043150608,973583301,11969.46402,444677407.3,44467740.73,2,95935,4309,752,1988,1236,752,95935,1236,1988,218.8266129,2.939516129,7.85483871,49795.94355,3142.225806,10.89919355,99079.00403,0.494640365,0.031848798,0.000112041,0.621730382,0.020722364,36,4
D:0| T0: 0.10| T1: 4.00| R0: 0.0| R1: 0.0| WTP: 0,0,0.096153846,4,0,0,0,0,0,-956735419.3,781062938,10251.71674,444149582.2,44414958.22,2,91721,4360,696,1702,1006,696,91721,1006,1702,216.685259,2.661354582,6.609561753,52246.60159,1670.394422,9.386454183,99196.33865,0.523506099,0.016772303,9.59665E-05,0.59106933,0.018556476,36,4
D:0| T0: 0.10| T1: 4.00| R0: 0.0| R1: 0.0| WTP: 0,0,0.096153846,4,0,0,0,0,0,-1029676734,338783425,11740.62304,442645582.3,44264558.23,2,95205,4261,823,1950,1127,823,95205,1127,1950,180.1632653,2.710884354,6.513605442,51179.63605,2633,9.299319728,99104.71769,0.498952666,0.027227729,9.75694E-05,0.577948718,0.020482118,41,4
D:0| T0: 0.10| T1: 8.00| R0: 0.0| R1: 0.0| WTP: 0,0,0.096153846,8,0,0,0,0,0,-1341012040,650073325,11083.89723,786817178.6,78681717.86,2,92807,4044,743,1841,1098,743,92807,1098,1841,123.16,1.78,4.495,73747.61,1489.7075,6.365,99536.41,0.613074344,0.022096435,9.58769E-05,0.596414992,0.019836866,39,8
D:0| T0: 0.10| T1: 8.00| R0: 0.0| R1: 0.0| WTP: 0,0,0.096153846,8,0,0,0,0,0,-1406763890,2029998696,12215.97931,795964924.1,79596492.41,2,97048,4273,892,2029,1137,892,97048,1137,2029,226.120332,3.593360996,8.265560166,45923.76349,1366.004149,11.9626556,98961.04564,0.437177506,0.014325468,0.00012709,0.560374569,0.02090718,33,8
D:0| T0: 0.10| T1: 8.00| R0: 0.0| R1: 0.0| WTP: 0,0,0.096153846,8,0,0,0,0,0,-1463553018,776062361,13451.41393,790982321.5,79098232.15,2,97717,4146,821,2235,1414,821,97717,1414,2235,196.1570881,3.030651341,8.409961686,53467.3908,2336.199234,11.55555556,99056.06513,0.486170852,0.025998276,0.000130343,0.632662192,0.022872172,33,8
D:0| T0: 0.10| T1: 8.00| R0: 0.0| R1: 0.0| WTP: 0,0,0.096153846,8,0,0,0,0,0,-702493028.9,1813046880,24.0502197,701290517.9,70129051.79,2,100,3,4,4,0,4,100,0,4,0.494949495,0.02020202,0.02020202,99932.74747,5.686868687,0.060606061,99997.67677,0.99935388,5.85012E-05,8.0001E-07,0,0.04,15,8
D:0| T0: 0.10| T1: 8.00| R0: 0.0| R1: 0.0| WTP: 0,0,0.096153846,8,0,0,0,0,0,-1338176607,2032407216,11047.53843,785799685.5,78579968.55,2,87904,3947,717,1835,1118,717,87904,1118,1835,160.6270627,2.267326733,5.937293729,62058.63366,1016.178218,8.300330033,99265.34653,0.604690734,0.010675765,8.84905E-05,0.609264305,0.020875046,42,8
D:0| T0: 0.10| T1: 8.00| R0: 0.0| R1: 0.0| WTP: 0,0,0.096153846,8,0,0,0,0,0,-613612900.2,1507873352,0.019516484,613611924.4,61361192.44,1,20,3,0,0,0,0,20,0,0,0.359223301,0,0,99989.39806,1.747572816,0,100000,0.999877209,2.0814E-05,0,0,0,12,7
D:0| T0: 0.10| T1: 8.00| R0: 0.0| R1: 0.0| WTP: 0,0,0.096153846,8,0,0,0,0,0,-613940692.7,1855899401,6.032997232,613639042.8,61363904.28,1,115,5,1,1,0,1,115,0,1,0.6625,0,0,99925.2875,4.475,0.0125,99999.425,0.999253494,4.67503E-05,0.00000025,0,0.008695652,12,7
D:0| T0: 0.10| T1: 8.00| R0: 0.0| R1: 0.0| WTP: 0,0,0.096153846,8,0,0,0,0,0,-1427243889,1819459251,12813.35795,786575991.2,78657599.12,2,93236,3940,686,2129,1443,686,93236,1443,2129,199.1959184,2.669387755,8.514285714,52562.5102,1360.820408,11.33877551,99003.18367,0.526744767,0.013690718,0.000115619,0.677782997,0.022834527,35,8
D:0| T0: 0.10| T1: 8.00| R0: 0.0| R1: 0.0| WTP: 0,0,0.096153846,8,0,0,0,0,0,-350960853.1,909791748,6.024030199,350659651.6,35065965.16,1,60,2,1,1,0,1,60,0,1,0.590163934,0,0,99965.06557,2.770491803,0.016393443,99999.70492,0.999655805,3.03226E-05,3.22581E-07,0,0.016949153,9,4
D:0| T0: 0.10| T1: 8.00| R0: 0.0| R1: 0.0| WTP: 0,0,0.096153846,8,0,0,0,0,0,-1390065801,1339092841,12175.09525,781311038.3,78131103.83,2,88313,3703,721,2023,1302,721,88313,1302,2023,172.3320755,2.603773585,7.467924528,55189.31698,1200.249057,10.17735849,99044.98491,0.55344513,0.012072977,0.000104185,0.643598616,0.02290716,38,8
D:0| T0: 0.10| T1: 8.00| R0: 0.0| R1: 0.0| WTP: 0,0,0.096153846,8,0,0,0,0,0,-1427935200,1365866345,12707.27903,792571248.5,79257124.85,2,97900,4263,879,2111,1232,879,97900,1232,2111,173.0529801,2.801324503,6.860927152,50178.53642,1014.288079,9.778145695,98992.5596,0.404372278,0.012230768,0.000119335,0.583609664,0.021562819,36,8
D:0| T0: 0.10| T1: 8.00| R0: 0.0| R1: 0.0| WTP: 0,0,0.096153846,8,0,0,0,0,0,-1363056508,825453433,11427.7628,791668368.4,79166836.84,2,93836,4199,675,1898,1223,675,93836,1223,1898,207.3611111,2.55952381,7.365079365,56539.08333,1902.888889,10.03968254,99214.43254,0.566015984,0.01912323,0.000102654,0.644362487,0.020226779,36,8
D:0| T0: 0.10| T1: 8.00| R0: 0.0| R1: 0.0| WTP: 0,0,0.096153846,8,0,0,0,0,0,-1405211096,939711378,12227.29724,793846234,79384623.4,2,97638,4281,923,2031,1108,923,97638,1108,2031,202.6832061,3.43129771,7.625954198,37230.39313,1460.564885,11.13358779,98773.41985,0.373781277,0.014694035,0.000113376,0.545544067,0.020801327,38,8
D:0| T0: 0.10| T1: 8.00| R0: 0.0| R1: 0.0| WTP: 0,0,0.096153846,8,0,0,0,0,0,-1355675872,638950699,11200.92347,795629698.4,79562969.84,2,92850,4215,792,1860,1068,792,92850,1068,1860,184.0909091,2.555555556,6.107744108,54857.46801,1970.794613,8.787878788,99179.73064,0.549436417,0.019819846,8.98188E-05,0.574193548,0.02003231,43,8
D:0| T0: 0.10| T1: 8.00| R0: 0.0| R1: 0.0| WTP: 0,0,0.096153846,8,0,0,0,0,0,-1319943082,938699148,10610.35998,789425083.4,78942508.34,2,86966,4005,749,1762,1013,749,86966,1013,1762,156.4478528,2.208588957,5.300613497,64803.73313,896.2484663,7.585889571,99344.6227,0.622355318,0.009693437,8.33277E-05,0.574914869,0.020260792,44,8
D:0| T0: 0.10| T1: 8.00| R0: 0.0| R1: 0.0| WTP: 0,0,0.096153846,8,0,0,0,0,0,-1363010868,1412065496,11421.82642,791919547.3,79191954.73,2,93957,4204,640,1897,1257,640,93957,1257,1897,165.0660377,1.924528302,5.833333333,65174.8522,870.336478,7.833333333,99351.54717,0.547029903,0.011397878,0.000104507,0.662625198,0.020190087,35,8
D:0| T0: 0.10| T1: 8.00| R0: 0.0| R1: 0.0| WTP: 0,0,0.096153846,8,0,0,0,0,0,-1439751999,1331335240,12959.20819,791791590,79179159,2,97872,4238,775,2153,1378,775,97872,1378,2153,197.1026616,2.840304183,8.041825095,47903.4943,2466.980989,10.98859316,98966.4981,0.452763661,0.026114011,0.000117888,0.640037157,0.02199812,36,8
D:0| T0: 0.10| T1: 8.00| R0: 0.0| R1: 0.0| WTP: 0,0,0.096153846,8,0,0,0,0,0,-1360680244,470935411,11592.55873,781052307.9,78105230.79,2,85912,3598,863,1926,1063,863,85912,1063,1926,169.9029851,3.063432836,6.97761194,38778.04478,831.2126866,10.20895522,98696.96269,0.339418075,0.009068171,0.000113614,0.55192108,0.022418288,36,8
D:0| T0: 0.10| T1: 8.00| R0: 0.0| R1: 0.0| WTP: 0,0,0.096153846,8,0,0,0,0,0,-1393984616,823434397,12194.0903,784280101.1,78428010.11,2,91506,3848,753,2026,1273,753,91506,1273,2026,157.6013289,2.415282392,6.598006645,55926.33223,1551.770764,9.102990033,99107.53488,0.560256181,0.01561393,9.29428E-05,0.628331688,0.022140625,43,8
D:0| T0: 0.10| T1: 8.00| R0: 0.0| R1: 0.0| WTP: 0,0,0.096153846,8,0,0,0,0,0,-525966716.9,493045351,0.020043956,525965714.7,52596571.47,1,140,7,0,0,0,0,140,0,0,0.493506494,0,0,99918.5974,4.74025974,0,100000,0.999168158,5.05263E-05,0,0,0,11,6
D:0| T0: 0.10| T1: 8.00| R0: 0.0| R1: 0.0| WTP: 0,0,0.096153846,8,0,0,0,0,0,-1289696359,1700216563,10062.90348,786551185.1,78655118.51,2,88477,4064,758,1671,913,758,88477,913,1671,157.9391026,2.33974359,5.237179487,60871.04167,1539.211538,7.673076923,99324.60256,0.609598602,0.015467013,7.8246E-05,0.546379414,0.018886264,45,8
D:0| T0: 0.10| T1: 8.00| R0: 0.0| R1: 0.0| WTP: 0,0,0.096153846,8,0,0,0,0,0,-1294163479,1744119059,10152.96346,786515305.7,78651530.57,2,85927,3938,681,1686,1005,681,85927,1005,1686,186.3358491,2.456603774,6.21509434,63750.63774,893.5433962,8.777358491,99346.32453,0.638537711,0.008976259,8.97289E-05,0.596085409,0.019621306,38,8
D:0| T0: 0.10| T1: 8.00| R0: 0.0| R1: 0.0| WTP: 0,0,0.096153846,8,0,0,0,0,0,-701896219.8,2036906360,12.03909336,701294265.1,70129426.51,1,90,7,2,2,0,2,90,0,2,0.5,0,0,99953.46364,5.272727273,0.018181818,99998.94545,0.999462571,6.35494E-05,4.3011E-07,0,0.022222222,13,8
D:0| T0: 0.10| T1: 8.00| R0: 0.0| R1: 0.0| WTP: 0,0,0.096153846,8,0,0,0,0,0,-1351637872,809704121,11305.94125,786340809,78634080.9,2,91093,4007,736,1878,1142,736,91093,1142,1878,156.2779553,2.252396166,5.862619808,55485.71885,1503.210863,8.223642173,99152,0.553022318,0.015217286,8.45693E-05,0.608093717,0.020616293,44,8
D:0| T0: 0.10| T1: 8.00| R0: 0.0| R1: 0.0| WTP: 0,0,0.096153846,8,0,0,0,0,0,-1405794812,1219866412,12209.68611,795310507,79531050.7,2,98161,4344,765,2028,1263,765,98161,1263,2028,220.3658537,2.991869919,8.089430894,46734.38211,3272.146341,11.19918699,99016.34146,0.468094118,0.032906462,0.000114205,0.622781065,0.020659936,36,8
D:0| T0: 0.10| T1: 8.00| R0: 0.0| R1: 0.0| WTP: 0,0,0.096153846,8,0,0,0,0,0,-527532089.2,843498920,30.06529385,526028824.5,52602882.45,1,89,7,5,5,0,5,89,0,5,1.013333333,0,0,99943.44,5.053333333,0.08,99997.84,0.999459456,5.19746E-05,1.31582E-06,0,0.057471264,11,6
D:0| T0: 0.10| T1: 8.00| R0: 0.0| R1: 0.0| WTP: 0,0,0.096153846,8,0,0,0,0,0,-1450979064,107351963,13317.39838,785109145.3,78510914.53,2,93677,3840,819,2213,1394,819,93677,1394,2213,143.027027,2.384384384,6.51951952,54816.69069,1963.225225,8.951951952,99027.23423,0.547693017,0.019840037,9.20547E-05,0.629914144,0.023623728,48,8
D:0| T0: 0.10| T1: 8.00| R0: 0.0| R1: 0.0| WTP: 0,0,0.096153846,8,0,0,0,0,0,-1366473110,773789021,11552.98697,788823761.7,78882376.17,2,92855,4068,757,1919,1162,757,92855,1162,1919,164.6339869,2.379084967,6.130718954,58050.49673,2054.901961,8.604575163,99223.09477,0.57843885,0.020802125,8.85774E-05,0.60552371,0.020666631,44,8
D:0| T0: 0.10| T1: 8.00| R0: 0.0| R1: 0.0| WTP: 0,0,0.096153846,8,0,0,0,0,0,-1421630967,850936611,12717.0541,785778262.5,78577826.25,2,91317,3795,719,2113,1394,719,91317,1394,2113,163.8169492,2.342372881,7.037288136,57788.91525,1638.362712,9.477966102,99105.62034,0.557950473,0.017314286,0.000101481,0.659725509,0.023139175,41,8
D:0| T0: 0.10| T1: 8.00| R0: 0.0| R1: 0.0| WTP: 0,0,0.096153846,8,0,0,0,0,0,-1371451868,1701318364,11672.76551,787813592.5,78781359.25,2,91771,3986,746,1939,1193,746,91771,1193,1939,195.1568627,2.792156863,7.423529412,59729.93725,1518.141176,10.3254902,99237.4902,0.578381592,0.016010274,0.000111088,0.615265601,0.021128679,35,8
D:0| T0: 0.10| T1: 8.00| R0: 0.0| R1: 0.0| WTP: 0,0,0.096153846,8,0,0,0,0,0,-701235203.9,778708269,0.010549451,701234676.5,70123467.65,1,42,2,0,0,0,0,42,0,0,0.224719101,0,0,99973.55056,3.516853933,0,100000,0.99972908,3.7931E-05,0,0,0,13,8
D:0| T0: 0.10| T1: 8.00| R0: 0.0| R1: 0.0| WTP: 0,0,0.096153846,8,0,0,0,0,0,-1381293254,1391938506,12042.33333,779176587.5,77917658.75,2,83837,3491,805,2001,1196,805,83837,1196,2001,155.6210526,2.680701754,6.828070175,65995.47368,1055.652632,9.649122807,99256.21053,0.661314774,0.010621465,9.90852E-05,0.597701149,0.023868028,41,8
D:0| T0: 0.10| T1: 8.00| R0: 0.0| R1: 0.0| WTP: 0,0,0.096153846,8,0,0,0,0,0,-701832941.5,43418681,12.01852194,701232015.4,70123201.54,2,96,6,2,2,0,2,96,0,2,0.173913043,0,0,99939.82609,6.27173913,0.02173913,99998.92391,0.999411926,6.43017E-05,4.3011E-07,0,0.020833333,14,8
D:0| T0: 0.10| T1: 8.00| R0: 0.0| R1: 0.0| WTP: 0,0,0.096153846,8,0,0,0,0,0,-1423247256,817384966,12735.40703,786476904.8,78647690.48,2,94464,3903,1015,2116,1101,1015,94464,1101,2116,200.6721992,4.112033195,8.626556017,42327.9917,1070.59751,12.83817427,98794.97095,0.418638433,0.010907181,0.000132347,0.520321361,0.022400068,34,8
D:0| T0: 0.10| T1: 8.00| R0: 0.0| R1: 0.0| WTP: 0,0,0.096153846,8,0,0,0,0,0,-1388307509,762053968,11914.57024,792578996.8,79257899.68,2,96530,4229,857,1979,1122,857,96530,1122,1979,210.8072289,3.317269076,7.775100402,44304.2008,1212.710843,11.2248996,98942.23695,0.440029428,0.012292581,0.000115426,0.566953007,0.020501399,36,8
D:0| T0: 0.10| T1: 8.00| R0: 0.0| R1: 0.0| WTP: 0,0,0.096153846,8,0,0,0,0,0,-1334625125,1692506311,10916.42687,788803780.8,78880378.08,2,91206,4123,841,1813,972,841,91206,972,1813,150.9311377,2.404191617,5.269461078,59309.82934,1817.131737,7.778443114,99266.08982,0.574869406,0.01913209,8.36852E-05,0.536127965,0.019878078,45,8
D:0| T0: 0.10| T1: 8.00| R0: 0.0| R1: 0.0| WTP: 0,0,0.096153846,8,0,0,0,0,0,-1324523235,883828863,10753.73285,786836592,78683659.2,2,87781,3932,994,1786,792,994,87781,792,1786,139.4659091,2.727272727,4.9375,59493.99432,653.1193182,7.767045455,99227.66761,0.375075816,0.010164075,0.000123089,0.443697479,0.020334697,33,8
D:0| T0: 0.10| T1: 8.00| R0: 0.0| R1: 0.0| WTP: 0,0,0.096153846,8,0,0,0,0,0,-1320562919,301400999,10781.93717,781466060.9,78146606.09,2,83852,3718,819,1791,972,819,83852,972,1791,141.0214724,2.404907975,5.346625767,62489.57975,1067.058282,7.865030675,99264.45399,0.626273145,0.010729852,8.05306E-05,0.542713568,0.021359061,47,8
D:0| T0: 0.10| T1: 8.00| R0: 0.0| R1: 0.0| WTP: 0,0,0.096153846,8,0,0,0,0,0,-1407173136,1868336855,12304.64401,791940935.6,79194093.56,2,96956,4149,666,2044,1378,666,96956,1378,2044,223.3034188,2.722222222,8.55982906,51912.52991,1620.641026,11.41025641,99084.42735,0.519747436,0.016296828,0.000116476,0.674168297,0.021081728,34,8
D:0| T0: 0.10| T1: 8.00| R0: 0.0| R1: 0.0| WTP: 0,0,0.096153846,8,0,0,0,0,0,-1421560183,1868498144,12616.53507,790733429.4,79073342.94,2,96107,4171,716,2096,1380,716,96107,1380,2096,198.2702703,2.640926641,7.934362934,47623.50579,1546.123552,10.70656371,98949.80309,0.477177297,0.015557612,0.000109274,0.658396947,0.021809025,37,8
D:0| T0: 0.10| T1: 8.00| R0: 0.0| R1: 0.0| WTP: 0,0,0.096153846,8,0,0,0,0,0,-1293288842,2101566889,10300.5546,778261112,77826111.2,2,79803,3520,1008,1711,703,1008,79803,703,1711,113.7642487,2.515544041,4.295336788,62485.16062,1169.235751,6.914507772,99254.29016,0.626653977,0.011760812,7.08622E-05,0.410870836,0.021440297,56,8
D:0| T0: 0.10| T1: 8.00| R0: 0.0| R1: 0.0| WTP: 0,0,0.096153846,8,0,0,0,0,0,-1357610417,1665097450,11426.21928,786299453.4,78629945.34,2,90304,3872,1095,1898,803,1095,90304,803,1898,178.1801471,3.952205882,6.834558824,44866.71691,1136.742647,10.85294118,98894.71324,0.370342466,0.013117347,0.000127025,0.423076923,0.021017895,34,8
D:0| T0: 0.10| T1: 8.00| R0: 0.0| R1: 0.0| WTP: 0,0,0.096153846,8,0,0,0,0,0,-1347027566,1716179948,11062.32576,793911277.7,79391127.77,2,95675,4312,1046,1837,791,1046,95675,791,1837,225.6228814,4.360169492,7.63559322,37264.75,1394.805085,12.0720339,98887.52542,0.374535769,0.014013351,0.000122723,0.430593359,0.019200418,34,8
D:0| T0: 0.10| T1: 8.00| R0: 0.0| R1: 0.0| WTP: 0,0,0.096153846,8,0,0,0,0,0,-1352274379,1560278715,11631.28861,770709948.8,77070994.88,2,76473,3073,935,1933,998,935,76473,998,1933,97.94486216,2.260651629,4.719298246,69287.20301,659.2431078,7.065162907,99274.49624,0.679528497,0.006969549,7.59979E-05,0.516295913,0.025277226,54,8
D:0| T0: 0.10| T1: 8.00| R0: 0.0| R1: 0.0| WTP: 0,0,0.096153846,8,0,0,0,0,0,-1444799008,991019385,13037.60313,792918851.2,79291885.12,2,98112,4261,670,2166,1496,670,98112,1496,2166,224.0680851,2.719148936,9.046808511,48752.03404,2484.323404,11.88510638,98982.59574,0.488139097,0.024994913,0.000121444,0.690674054,0.02207681,34,8
D:0| T0: 0.10| T1: 8.00| R0: 0.0| R1: 0.0| WTP: 0,0,0.096153846,8,0,0,0,0,0,-1423446541,118052103,12575.77273,794657904.7,79465790.47,2,96505,4243,653,2089,1436,653,96505,1436,2089,192.4464286,2.246428571,7.335714286,55453.73571,1737.810714,9.671428571,99129.76786,0.520819782,0.01882883,0.000106152,0.687410244,0.021646547,38,8
D:0| T0: 0.10| T1: 8.00| R0: 0.0| R1: 0.0| WTP: 0,0,0.096153846,8,0,0,0,0,0,-1419447442,1209758844,12686.90109,785102387.5,78510238.75,2,93298,3828,966,2108,1142,966,93298,1142,2108,203.3717949,4.02991453,8.854700855,56130.83761,1169.923077,12.97008547,99096.20513,0.50813316,0.013232415,0.000148529,0.541745731,0.022594268,30,8
D:0| T0: 0.10| T1: 8.00| R0: 0.0| R1: 0.0| WTP: 0,0,0.096153846,8,0,0,0,0,0,-702346134.7,70671723,18.09266202,701441501.6,70144150.16,2,127,9,3,3,0,3,127,0,3,1.204918033,0,0,99909.68033,6.418032787,0.024590164,99998.28689,0.999087878,6.70596E-05,5.04207E-07,0,0.023622047,17,8
D:0| T0: 0.10| T1: 8.00| R0: 0.0| R1: 0.0| WTP: 0,0,0.096153846,8,0,0,0,0,0,-1252003267,1722612191,9471.908706,778407832,77840783.2,2,75179,3429,1070,1573,503,1070,75179,503,1573,90.3006135,2.110429448,3.112474438,62399.28016,848.5787321,5.296523517,99254.99182,0.624625639,0.008571068,5.45823E-05,0.319771138,0.020923674,69,8
D:0| T0: 0.10| T1: 8.00| R0: 0.0| R1: 0.0| WTP: 0,0,0.096153846,8,0,0,0,0,0,-1190481795,1968291596,8382.574408,771353074.2,77135307.42,2,71687,3219,949,1392,443,949,71687,443,1392,103.0102564,2.330769231,3.435897436,70331.09231,734.1128205,5.879487179,99468.18718,0.696410853,0.007585946,6.20335E-05,0.318247126,0.019417747,55,8
D:0| T0: 0.10| T1: 8.00| R0: 0.0| R1: 0.0| WTP: 0,0,0.096153846,8,0,0,0,0,0,-1438400991,1877569084,12964.86989,790157496.5,79015749.65,2,95012,4003,1132,2154,1022,1132,95012,1022,2154,202.62249,4.469879518,8.502008032,39550.5743,1216.016064,13.0562249,98719.28112,0.372698594,0.012750921,0.00013838,0.47446611,0.022670821,35,8
D:0| T0: 0.10| T1: 8.00| R0: 0.0| R1: 0.0| WTP: 0,0,0.096153846,8,0,0,0,0,0,-1394094085,1726322189,12111.53897,788517136.8,78851713.68,2,92775,4034,1100,2012,912,1100,92775,912,2012,205.1404959,4.454545455,8.152892562,40066.05372,1297.702479,12.71487603,98799.35124,0.387861574,0.013380029,0.000132618,0.453280318,0.021686877,34,8
D:0| T0: 0.10| T1: 8.00| R0: 0.0| R1: 0.0| WTP: 0,0,0.096153846,8,0,0,0,0,0,-1411232336,307848836,12388.74156,791795257.8,79179525.78,2,96030,4111,815,2058,1243,815,96030,1243,2058,224.0301724,3.392241379,8.698275862,45387.84914,1458.50431,12.18965517,98926.73707,0.455162328,0.01466598,0.000124504,0.603984451,0.021430803,34,8
D:0| T0: 0.10| T1: 8.00| R0: 0.0| R1: 0.0| WTP: 0,0,0.096153846,8,0,0,0,0,0,-1328690953,1154000220,10820.0369,787689108.6,78768910.86,2,87169,3990,936,1797,861,936,87169,861,1797,165,2.970099668,5.810631229,30012.92691,753.5548173,8.933554817,98625.30233,0.303604813,0.007575408,9.13815E-05,0.479131886,0.020615127,43,8
D:0| T0: 0.10| T1: 8.00| R0: 0.0| R1: 0.0| WTP: 0,0,0.096153846,8,0,0,0,0,0,-702533424.4,2028661055,24.06287904,701330280.4,70133028.04,2,117,6,4,4,0,4,117,0,4,0.675925926,0.018518519,0.018518519,99927.96296,5.62962963,0.055555556,99999.05556,0.99929155,5.84407E-05,7.33954E-07,0,0.026086957,16,8
D:0| T0: 0.10| T1: 8.00| R0: 0.0| R1: 0.0| WTP: 0,0,0.096153846,8,0,0,0,0,0,-1399403059,1629114640,12189.89452,789908332.4,78990833.24,2,95631,4161,752,2025,1273,752,95631,1273,2025,184.3913043,2.608695652,7.177536232,52723.41304,2150.072464,9.894927536,99101.17754,0.527916337,0.021631599,0.000101262,0.628641975,0.021175142,40,8
D:0| T0: 0.10| T1: 8.00| R0: 0.0| R1: 0.0| WTP: 0,0,0.096153846,8,0,0,0,0,0,-1434312290,1439048174,12786.2517,794999704.6,79499970.46,2,95907,4266,1076,2124,1048,1076,95907,1048,2124,232.673913,4.617391304,9.086956522,40378.26087,1779.386957,13.76086957,98776.06957,0.397960303,0.018140421,0.000141792,0.493408663,0.022146454,33,8
D:0| T0: 0.10| T1: 8.00| R0: 0.0| R1: 0.0| WTP: 0,0,0.096153846,8,0,0,0,0,0,-1335401807,865227006,11176.59618,776571997.5,77657199.75,2,83612,3494,647,1857,1210,647,83612,1210,1857,115.4037433,1.529411765,4.743315508,33558.27807,600.7433155,6.529411765,98567.06684,0.285799847,0.006532813,7.28688E-05,0.651588584,0.022210262,50,8
D:0| T0: 0.10| T1: 8.00| R0: 0.0| R1: 0.0| WTP: 0,0,0.096153846,8,0,0,0,0,0,-1423452781,890479738,12581.70578,794367492.2,79436749.22,2,97512,4300,757,2090,1333,757,97512,1333,2090,192.6654676,2.618705036,7.356115108,42842.97842,2503.859712,10.08273381,98883.85252,0.429303519,0.025197838,0.000103098,0.637799043,0.021433259,40,8
D:0| T0: 0.10| T1: 8.00| R0: 0.0| R1: 0.0| WTP: 0,0,0.096153846,8,0,0,0,0,0,-527585116.1,1017049163,30.08270044,526080981,52608098.1,1,206,7,5,5,0,5,206,0,5,1.415584416,0,0,99874.22078,8.922077922,0.077922078,99997.54545,0.998771236,9.08995E-05,1.28208E-06,0,0.024271845,11,6
D:0| T0: 0.10| T1: 8.00| R0: 0.0| R1: 0.0| WTP: 0,0,0.096153846,8,0,0,0,0,0,-525937956.2,1707305064,0.011604396,525937375.9,52593737.59,1,42,2,0,0,0,0,42,0,0,0.258823529,0,0,99976.75294,2.105882353,0,100000,0.999740263,2.59211E-05,0,0,0,11,6
D:0| T0: 0.10| T1: 8.00| R0: 0.0| R1: 0.0| WTP: 0,0,0.096153846,8,0,0,0,0,0,-1345482937,400145663,11303.97131,780284371.7,78028437.17,2,83824,3616,714,1878,1164,714,83824,1164,1878,132.8621701,1.935483871,5.328445748,29338.54252,658.4252199,7.416422287,98471.60411,0.297454985,0.006624804,7.65575E-05,0.619808307,0.022404085,49,8
D:0| T0: 0.10| T1: 8.00| R0: 0.0| R1: 0.0| WTP: 0,0,0.096153846,8,0,0,0,0,0,-525941393.5,1662654181,0.012131868,525940786.9,52594078.69,1,82,5,0,0,0,0,82,0,0,0.319444444,0,0,99949.04167,4.236111111,0,100000,0.999493151,4.41096E-05,0,0,0,11,6
D:0| T0: 0.10| T1: 8.00| R0: 0.0| R1: 0.0| WTP: 0,0,0.096153846,8,0,0,0,0,0,-1384728738,182136456,11813.0558,794075947.9,79407594.79,2,96007,4274,1055,1962,907,1055,96007,907,1962,218.9176955,4.24691358,7.897119342,40305.79012,1369.049383,12.24691358,98864.48971,0.392655201,0.014053142,0.000127421,0.462283384,0.02043601,34,8
D:0| T0: 0.10| T1: 8.00| R0: 0.0| R1: 0.0| WTP: 0,0,0.096153846,8,0,0,0,0,0,-526250066.5,979575387,6.020337891,525949049.6,52594904.96,1,39,2,1,1,0,1,39,0,1,0.397260274,0,0,99973.34247,3.178082192,0.01369863,99999.63014,0.999739188,3.32433E-05,2.7027E-07,0,0.025641026,11,6
D:0| T0: 0.10| T1: 8.00| R0: 0.0| R1: 0.0| WTP: 0,0,0.096153846,8,0,0,0,0,0,-1437582409,2142525414,12964.39796,789362511,78936251.1,2,97592,4112,694,2154,1460,694,97592,1460,2154,211.0376569,2.79916318,8.870292887,50916.7364,1599.728033,11.77405858,99019.16318,0.481716772,0.017015572,0.000126771,0.677808728,0.022071481,33,8
D:0| T0: 0.10| T1: 8.00| R0: 0.0| R1: 0.0| WTP: 0,0,0.096153846,8,0,0,0,0,0,-1387903527,1464057597,11949.82616,790412219.4,79041221.94,2,94698,4081,655,1985,1330,655,94698,1330,1985,203.1936759,2.4743083,7.679841897,52589.40711,1400.185771,10.27667984,99095.94466,0.524781933,0.014134558,0.000105376,0.670025189,0.020961372,36,8
D:0| T0: 0.10| T1: 8.00| R0: 0.0| R1: 0.0| WTP: 0,0,0.096153846,8,0,0,0,0,0,-1392487613,364562610,11986.89568,793142829.1,79314282.91,2,93302,4126,969,1991,1022,969,93302,1022,1991,246.3738318,4.41588785,9.121495327,50407.01402,1472.602804,13.64018692,99041.94393,0.493860062,0.015150619,0.000142279,0.513567839,0.021328589,30,8
D:0| T0: 0.10| T1: 8.00| R0: 0.0| R1: 0.0| WTP: 0,0,0.096153846,8,0,0,0,0,0,-1417273401,40350784,12573.82143,788582329.7,78858232.97,2,95838,3994,730,2089,1359,730,95838,1359,2089,237.2132701,3.312796209,9.701421801,52261.36493,1750.578199,13.15165877,99071.89573,0.523455244,0.017593777,0.000134313,0.650550503,0.021797199,31,8
D:0| T0: 0.10| T1: 8.00| R0: 0.0| R1: 0.0| WTP: 0,0,0.096153846,8,0,0,0,0,0,-1349282483,804064356,11074.68995,795547985.2,79554798.52,2,96123,4336,618,1839,1221,618,96123,1221,1839,228.3583333,2.45,7.491666667,54113.29167,1158.741667,10.06666667,99194.73333,0.515634942,0.012303784,0.000108714,0.663947798,0.019131737,33,8
D:0| T0: 0.10| T1: 8.00| R0: 0.0| R1: 0.0| WTP: 0,0,0.096153846,8,0,0,0,0,0,-1406077725,2125493986,12481.58442,781998503.6,78199850.36,2,89079,3681,678,2074,1396,678,89079,1396,2074,174.5984848,2.439393939,7.696969697,60840.19318,1070.125,10.24242424,99158.85606,0.608040161,0.01080759,0.0001053,0.673095468,0.023282704,38,8
D:0| T0: 0.10| T1: 8.00| R0: 0.0| R1: 0.0| WTP: 0,0,0.096153846,8,0,0,0,0,0,-1330921624,23154253,10743.84663,793729292.2,79372929.22,2,91064,4216,706,1784,1078,706,91064,1078,1784,189.6784452,2.374558304,6.151943463,48040.36749,861.6219081,8.667844523,99043.01413,0.464914365,0.008943462,9.13215E-05,0.60426009,0.019590618,40,8
D:0| T0: 0.10| T1: 8.00| R0: 0.0| R1: 0.0| WTP: 0,0,0.096153846,8,0,0,0,0,0,-1285822223,1391367689,10250.82676,773280885.6,77328088.56,2,75575,3353,868,1703,835,868,75575,835,1703,114.8487395,2.336134454,4.62464986,67252.09524,713.8487395,7.058823529,99310.79272,0.665037079,0.007384721,7.45052E-05,0.490311216,0.022533907,50,8
D:0| T0: 0.10| T1: 8.00| R0: 0.0| R1: 0.0| WTP: 0,0,0.096153846,8,0,0,0,0,0,-1348237626,574142276,11216.22078,787426587.2,78742658.72,2,90896,3935,683,1863,1180,683,90896,1180,1863,170.7972509,2.261168385,6.271477663,55605.75258,1436.199313,8.604810997,99158.38488,0.550912902,0.014640801,8.92196E-05,0.63338701,0.020495951,41,8
D:0| T0: 0.10| T1: 8.00| R0: 0.0| R1: 0.0| WTP: 0,0,0.096153846,8,0,0,0,0,0,-1238724285,898736779,9337.637336,771842417.9,77184241.79,2,73677,3237,1088,1551,463,1088,73677,463,1551,86.62419006,2.246220302,3.220302376,67501.38877,1180.265659,5.576673866,99362.9892,0.665402687,0.012291301,5.9364E-05,0.298517086,0.021051917,64,8
D:0| T0: 0.10| T1: 8.00| R0: 0.0| R1: 0.0| WTP: 0,0,0.096153846,8,0,0,0,0,0,-1321650612,346473503,10451.26521,799087351.7,79908735.17,2,97506,4569,607,1735,1128,607,97506,1128,1735,167.9529412,1.708823529,4.994117647,58759.99412,1626.402941,6.773529412,99331.52353,0.477337076,0.020720109,8.78122E-05,0.650144092,0.017793777,39,8
D:0| T0: 0.10| T1: 8.00| R0: 0.0| R1: 0.0| WTP: 0,0,0.096153846,8,0,0,0,0,0,-1403891225,445552282,12256.34087,791074181.7,79107418.17,2,94696,4117,729,2036,1307,729,94696,1307,2036,162.4559748,2.191823899,6.257861635,63789.17296,1698.056604,8.544025157,99299.89308,0.566103648,0.020495007,0.000105004,0.64194499,0.02150038,37,8
D:0| T0: 0.10| T1: 8.00| R0: 0.0| R1: 0.0| WTP: 0,0,0.096153846,8,0,0,0,0,0,-1315584774,911758476,10579.43633,786612957.3,78661295.73,2,86727,3918,854,1757,903,854,86727,903,1757,160.7254902,2.633986928,5.555555556,37094.30392,792.3431373,8.359477124,98781.96732,0.313540771,0.008732755,9.41324E-05,0.513944223,0.020259908,40,8
D:0| T0: 0.10| T1: 8.00| R0: 0.0| R1: 0.0| WTP: 0,0,0.096153846,8,0,0,0,0,0,-1392824088,1464197940,11916.07847,797020164.3,79702016.43,2,97165,4365,966,1979,1013,966,97165,1013,1979,233.470339,3.995762712,8.241525424,40317.80508,2399.737288,12.33474576,98880.92797,0.40461838,0.024128216,0.000125425,0.511874684,0.020367416,34,8
D:0| T0: 0.10| T1: 8.00| R0: 0.0| R1: 0.0| WTP: 0,0,0.096153846,8,0,0,0,0,0,-1378157404,500405854,11893.57776,783478516.4,78347851.64,2,88097,3768,788,1976,1188,788,88097,1188,1976,160.4368601,2.566552901,6.583617747,63461.51877,1224.819113,9.279863481,99254.43003,0.62009929,0.012847412,9.89743E-05,0.601214575,0.022429822,41,8
D:0| T0: 0.10| T1: 8.00| R0: 0.0| R1: 0.0| WTP: 0,0,0.096153846,8,0,0,0,0,0,-1433432942,772037341,12833.07406,791779239,79177923.9,2,96150,4200,717,2132,1415,717,96150,1415,2132,229.8495575,3.039823009,9.265486726,50958.98673,1393.747788,12.43362832,98995.76991,0.510690003,0.014016726,0.000126775,0.66369606,0.022173687,33,8
D:0| T0: 0.10| T1: 8.00| R0: 0.0| R1: 0.0| WTP: 0,0,0.096153846,8,0,0,0,0,0,-614302229.6,1543158763,12.0575549,613699351.8,61369935.18,1,88,7,2,2,0,2,88,0,2,0.957446809,0,0,99948.54255,4.223404255,0.021276596,99999.11702,0.999429028,4.89161E-05,4.8193E-07,0,0.022988506,12,7
D:0| T0: 0.10| T1: 8.00| R0: 0.0| R1: 0.0| WTP: 0,0,0.096153846,8,0,0,0,0,0,-1446926212,1604932531,13138.95233,789978595.3,78997859.53,2,94529,3957,1088,2183,1095,1088,94529,1095,2183,221.938326,4.691629956,9.431718062,45198.05727,1228.665198,14.20704846,98823.96916,0.413322904,0.013298252,0.000155988,0.501603298,0.023093442,31,8
D:0| T0: 0.10| T1: 8.00| R0: 0.0| R1: 0.0| WTP: 0,0,0.096153846,8,0,0,0,0,0,-1421783152,539051477,12592.98532,792133886,79213388.6,2,98083,4228,755,2092,1337,755,98083,1337,2092,197.6856061,2.734848485,7.768939394,53743.19697,2140.481061,10.65151515,99115.77273,0.476627314,0.024395561,0.000122905,0.639101338,0.021328875,34,8
D:0| T0: 0.10| T1: 8.00| R0: 0.0| R1: 0.0| WTP: 0,0,0.096153846,8,0,0,0,0,0,-351017927.4,1743124675,6.041964265,350715829.2,35071582.92,1,67,6,1,1,0,1,67,0,1,1.044776119,0,0,99964.02985,3.119402985,0.014925373,99999.62687,0.999618251,3.49208E-05,3.1746E-07,0,0.015151515,9,4
D:0| T0: 0.10| T1: 8.00| R0: 0.0| R1: 0.0| WTP: 0,0,0.096153846,8,0,0,0,0,0,-1391610950,1965983789,12087.02053,787259923.4,78725992.34,2,89689,3887,848,2008,1160,848,89689,1160,2008,155.2618297,2.596214511,6.208201893,58801.67508,1649.432177,8.864353312,99165.59937,0.581190294,0.016920386,9.24593E-05,0.577689243,0.022388476,45,8
D:0| T0: 0.10| T1: 8.00| R0: 0.0| R1: 0.0| WTP: 0,0,0.096153846,8,0,0,0,0,0,-1332061522,516774280,10945.19083,784801980,78480198,2,87027,3802,850,1818,968,850,87027,968,1818,139.4651163,2.377906977,5.136627907,62271.55233,1623.351744,7.60755814,99284.15988,0.621612072,0.016422798,7.84931E-05,0.532453245,0.020890309,48,8
D:0| T0: 0.10| T1: 8.00| R0: 0.0| R1: 0.0| WTP: 0,0,0.096153846,8,0,0,0,0,0,-1306194288,86603142,10493.61535,781513521,78151352.1,2,83064,3579,515,1743,1228,515,83064,1228,1743,229.9306931,2.455445545,8.504950495,37292.29208,1066.920792,11.04950495,98757.9604,0.340566859,0.011316743,0.000118645,0.704936854,0.020971781,28,8
D:0| T0: 0.10| T1: 8.00| R0: 0.0| R1: 0.0| WTP: 0,0,0.096153846,8,0,0,0,0,0,-1305837039,1431870609,10499.55331,780859373.2,78085937.32,2,82736,3676,986,1744,758,986,82736,758,1744,105.2939815,2.189814815,3.900462963,57351.41435,1326.905093,6.189814815,99159.91435,0.575302263,0.013349144,6.35952E-05,0.434633028,0.021079095,62,8
D:0| T0: 0.10| T1: 8.00| R0: 0.0| R1: 0.0| WTP: 0,0,0.096153846,8,0,0,0,0,0,-1381172291,1592383984,11817.67784,790288399,79028839.9,2,91675,4042,671,1963,1292,671,91675,1292,1963,199.8638132,2.478599222,7.463035019,55226.59144,1042.44358,10.08560311,99111.79377,0.548051728,0.010608322,0.000104296,0.658176261,0.021412599,37,8
D:0| T0: 0.10| T1: 8.00| R0: 0.0| R1: 0.0| WTP: 0,0,0.096153846,8,0,0,0,0,0,-1331518101,1440183867,10868.13625,788111288.5,78811128.85,2,90173,4037,739,1805,1066,739,90173,1066,1805,163.7908497,2.316993464,5.758169935,57316.42484,1429.761438,8.183006536,99214.4281,0.574148461,0.0143742,8.3613E-05,0.590581717,0.020017078,44,8
D:0| T0: 0.10| T1: 8.00| R0: 0.0| R1: 0.0| WTP: 0,0,0.096153846,8,0,0,0,0,0,-1385371868,1696510588,12014.04107,784669814.1,78466981.41,2,91408,3849,710,1996,1286,710,91408,1286,1996,141.3579882,2.014792899,5.792899408,52787.78994,1264.017751,7.905325444,99036.98521,0.527586786,0.012759862,8.08578E-05,0.644288577,0.021836163,49,8
D:0| T0: 0.10| T1: 8.00| R0: 0.0| R1: 0.0| WTP: 0,0,0.096153846,8,0,0,0,0,0,-1445757770,895039877,13049.80799,793267371.1,79326737.11,2,97656,4171,802,2168,1366,802,97656,1366,2168,196.0594796,2.884758364,7.925650558,46235.68401,1898.858736,10.90334572,98909.02602,0.43389235,0.020156832,0.000117224,0.630073801,0.022200377,37,8
D:0| T0: 0.10| T1: 8.00| R0: 0.0| R1: 0.0| WTP: 0,0,0.096153846,8,0,0,0,0,0,-1403461896,129565953,12327.20553,787101619.1,78710161.91,2,91372,3905,934,2048,1114,934,91372,1114,2048,163.2433333,3,6.66,61566.99667,2140.55,9.786666667,99238.04667,0.613951918,0.021690941,0.000100752,0.543945313,0.022413869,42,8
D:0| T0: 0.10| T1: 8.00| R0: 0.0| R1: 0.0| WTP: 0,0,0.096153846,8,0,0,0,0,0,-614205817.2,1902565669,12.02590655,613604521.8,61360452.18,1,159,7,2,2,0,2,159,0,2,0.337078652,0,0,99909.01124,6.584269663,0.02247191,99999.30337,0.999048342,7.11768E-05,4.70591E-07,0,0.012578616,12,7
D:0| T0: 0.10| T1: 8.00| R0: 0.0| R1: 0.0| WTP: 0,0,0.096153846,8,0,0,0,0,0,-1339937930,1984179288,11201.87536,779844162,77984416.2,2,85522,3526,997,1861,864,997,85522,864,1861,107.5288462,2.290865385,4.331730769,60767.49279,1562.0625,6.723557692,99213.29808,0.587290762,0.016599604,7.30286E-05,0.464266523,0.021760483,57,8
D:0| T0: 0.10| T1: 8.00| R0: 0.0| R1: 0.0| WTP: 0,0,0.096153846,8,0,0,0,0,0,-1414263338,677377223,12490.13578,789756549,78975654.9,2,96043,4130,800,2075,1275,800,96043,1275,2075,189.1268657,2.865671642,7.559701493,51691.30597,2912.261194,10.55223881,99074.78731,0.517617434,0.029300988,0.000107981,0.614457831,0.021604906,38,8
D:0| T0: 0.10| T1: 8.00| R0: 0.0| R1: 0.0| WTP: 0,0,0.096153846,8,0,0,0,0,0,-1396271696,973583301,12041.18947,794212222.5,79421222.25,2,95873,4279,768,2000,1232,768,95873,1232,2000,195.4817518,2.722627737,7.178832117,54257.65328,2844.259124,9.96350365,99156.06934,0.539767223,0.028818901,0.000102409,0.616,0.020860931,39,8
D:0| T0: 0.10| T1: 8.00| R0: 0.0| R1: 0.0| WTP: 0,0,0.096153846,8,0,0,0,0,0,-1315560952,781062938,10378.47123,796637390.1,79663739.01,2,91852,4380,741,1723,982,741,91852,982,1723,200.3537906,2.555956679,6.061371841,59172.12996,1530.595668,8.740072202,99311.01444,0.59239886,0.015375881,8.93901E-05,0.569936158,0.018758846,40,8
D:0| T0: 0.10| T1: 8.00| R0: 0.0| R1: 0.0| WTP: 0,0,0.096153846,8,0,0,0,0,0,-1371738428,338783425,11578.32883,792821986.8,79282198.68,2,95219,4244,805,1923,1118,805,95219,1118,1923,153.4069767,2.264534884,5.468023256,52382.77907,2253.97093,7.808139535,99126.53779,0.513196263,0.023222514,8.17327E-05,0.581383255,0.020195549,48,8
D:0| T0: 0.10| T1: 12.00| R0: 0.0| R1: 0.0| WTP: 0,0,0.096153846,12,0,0,0,0,0,-1712313534,650073325,11386.01845,1143012611,114301261.1,2,92944,4159,753,1891,1138,753,92944,1138,1891,118.3505618,1.633707865,4.166292135,74650.45843,1338.238202,5.862921348,99536.73708,0.643464356,0.018952906,8.41949E-05,0.60179799,0.020345584,46,12
D:0| T0: 0.10| T1: 12.00| R0: 0.0| R1: 0.0| WTP: 0,0,0.096153846,12,0,0,0,0,0,-1769496645,2029998696,12497.64027,1144614631,114461463.1,2,96151,4258,1047,2076,1029,1047,96151,1029,2076,188.0638298,3.585106383,7.205673759,47754.72695,1154.819149,10.91489362,98954.94326,0.46000352,0.012048,0.000115483,0.49566474,0.021591039,39,12
D:0| T0: 0.10| T1: 12.00| R0: 0.0| R1: 0.0| WTP: 0,0,0.096153846,12,0,0,0,0,0,-1834188978,776062361,13865.66287,1140905835,114090583.5,2,96778,4073,1048,2304,1256,1048,96778,1256,2304,171.5612245,3.452380952,7.676870748,54106.68707,2051.401361,11.23469388,99016.02041,0.499545922,0.022587586,0.000125505,0.545138889,0.023807064,38,12
D:0| T0: 0.10| T1: 12.00| R0: 0.0| R1: 0.0| WTP: 0,0,0.096153846,12,0,0,0,0,0,-790143259.7,1813046880,24.0502197,788940748.7,78894074.87,1,100,3,4,4,0,4,100,0,4,0.505154639,0.020618557,0.020618557,99933.56701,5.783505155,0.06185567,99997.71134,0.999361715,5.9491E-05,8.16337E-07,0,0.04,14,9
D:0| T0: 0.10| T1: 12.00| R0: 0.0| R1: 0.0| WTP: 0,0,0.096153846,12,0,0,0,0,0,-969116302.8,2032407216,84.31581289,964900512.2,96490051.22,1,779,40,14,14,0,14,779,0,14,3.552845528,0.056910569,0.056910569,99539.73171,21.43902439,0.162601626,99992.72358,0.994948703,0.000239204,2.52268E-06,0,0.018018018,16,11
D:0| T0: 0.10| T1: 12.00| R0: 0.0| R1: 0.0| WTP: 0,0,0.096153846,12,0,0,0,0,0,-613612900.2,1507873352,0.019516484,613611924.4,61361192.44,1,20,3,0,0,0,0,20,0,0,0.359223301,0,0,99989.39806,1.747572816,0,100000,0.999877209,2.0814E-05,0,0,0,12,7
D:0| T0: 0.10| T1: 12.00| R0: 0.0| R1: 0.0| WTP: 0,0,0.096153846,12,0,0,0,0,0,-613940692.7,1855899401,6.032997232,613639042.8,61363904.28,1,115,5,1,1,0,1,115,0,1,0.6625,0,0,99925.2875,4.475,0.0125,99999.425,0.999253494,4.67503E-05,0.00000025,0,0.008695652,12,7
D:0| T0: 0.10| T1: 12.00| R0: 0.0| R1: 0.0| WTP: 0,0,0.096153846,12,0,0,0,0,0,-1760004281,1819459251,12441.27761,1137940401,113794040.1,2,93178,3984,721,2067,1346,721,93178,1346,2067,188.2938931,2.591603053,7.694656489,59941.37786,1269.454198,10.46946565,99187.0916,0.600236391,0.012772883,0.000107071,0.651185293,0.022183348,38,12
D:0| T0: 0.10| T1: 12.00| R0: 0.0| R1: 0.0| WTP: 0,0,0.096153846,12,0,0,0,0,0,-350960853.1,909791748,6.024030199,350659651.6,35065965.16,1,60,2,1,1,0,1,60,0,1,0.590163934,0,0,99965.06557,2.770491803,0.016393443,99999.70492,0.999655805,3.03226E-05,3.22581E-07,0,0.016949153,9,4
D:0| T0: 0.10| T1: 12.00| R0: 0.0| R1: 0.0| WTP: 0,0,0.096153846,12,0,0,0,0,0,-1749253498,1339092841,12361.03045,1131201975,113120197.5,2,87898,3659,737,2054,1317,737,87898,1317,2054,161.9964158,2.487455197,7.172043011,62475.83154,1128.541219,9.806451613,99189.48387,0.625982038,0.011357034,0.000100682,0.641187926,0.023367995,40,12
D:0| T0: 0.10| T1: 12.00| R0: 0.0| R1: 0.0| WTP: 0,0,0.096153846,12,0,0,0,0,0,-1782051370,1365866345,12779.36191,1143083275,114308327.5,2,97728,4216,991,2123,1132,991,97728,1132,2123,176.579661,3.227118644,7.027118644,59560.10847,1034.888136,10.38644068,99189.08136,0.514560488,0.012538147,0.000127826,0.533207725,0.021723559,35,12
D:0| T0: 0.10| T1: 12.00| R0: 0.0| R1: 0.0| WTP: 0,0,0.096153846,12,0,0,0,0,0,-1691298016,825453433,10995.15631,1141540201,114154020.1,2,94018,4107,694,1826,1132,694,94018,1132,1826,178.4020619,2.268041237,6.116838488,59062.15808,1650.333333,8.498281787,99283.82818,0.591109858,0.016589766,8.70822E-05,0.619934283,0.019421813,42,12
D:0| T0: 0.10| T1: 12.00| R0: 0.0| R1: 0.0| WTP: 0,0,0.096153846,12,0,0,0,0,0,-1745982084,939711378,12011.48048,1145408060,114540806,2,96784,4297,1085,1995,910,1085,96784,910,1995,225.1302521,4.420168067,8.201680672,49712.21429,1598.802521,12.7605042,99050.13445,0.498772445,0.016076389,0.000130062,0.456140351,0.020612911,34,12
D:0| T0: 0.10| T1: 12.00| R0: 0.0| R1: 0.0| WTP: 0,0,0.096153846,12,0,0,0,0,0,-1708721589,638950699,11266.70402,1145386388,114538638.8,2,92911,4245,815,1871,1056,815,92911,1056,1871,157.6851312,2.285714286,5.314868805,57816.66472,1711.941691,7.693877551,99224.50437,0.578889159,0.017226203,7.88103E-05,0.564404062,0.020137551,49,12
D:0| T0: 0.10| T1: 12.00| R0: 0.0| R1: 0.0| WTP: 0,0,0.096153846,12,0,0,0,0,0,-1054188230,938699148,42.12651908,1052081905,105208190.5,2,448,21,7,7,0,7,448,0,7,1.104895105,0.027972028,0.027972028,99750.46154,10.41958042,0.083916084,99996.03497,0.997085929,0.000124468,1.15705E-06,0,0.015625,18,12
D:0| T0: 0.10| T1: 12.00| R0: 0.0| R1: 0.0| WTP: 0,0,0.096153846,12,0,0,0,0,0,-1707205634,1412065496,11277.94652,1143308308,114330830.8,2,93631,4295,655,1873,1218,655,93631,1218,1873,146.7423823,1.731301939,5.066481994,67132.4626,757.0692521,6.88365651,99393.55679,0.587343701,0.009570463,8.85766E-05,0.650293647,0.020004058,41,12
D:0| T0: 0.10| T1: 12.00| R0: 0.0| R1: 0.0| WTP: 0,0,0.096153846,12,0,0,0,0,0,-1781474380,1331335240,12779.14697,1142517032,114251703.2,2,97484,4145,894,2123,1229,894,97484,1229,2123,195.754717,3.237735849,7.81509434,55158.81132,2434.996226,11.19622642,99132.58491,0.529186372,0.025764518,0.000120466,0.578897786,0.021777933,36,12
D:0| T0: 0.10| T1: 12.00| R0: 0.0| R1: 0.0| WTP: 0,0,0.096153846,12,0,0,0,0,0,-1692567502,470935411,11267.42086,1129196459,112919645.9,2,81933,3478,809,1872,1063,809,81933,1063,1872,93.52219873,1.553911205,3.77167019,32056.34672,448.94926,5.477801268,98496.28118,0.293070121,0.004731398,5.97695E-05,0.56784188,0.022848773,65,12
D:0| T0: 0.10| T1: 12.00| R0: 0.0| R1: 0.0| WTP: 0,0,0.096153846,12,0,0,0,0,0,-1761372679,823434397,12489.01296,1136922030,113692203,2,91426,3886,722,2075,1353,722,91426,1353,2075,146.6415663,2.096385542,6.126506024,60119.79217,1407.746988,8.310240964,99166.73795,0.602013422,0.014177379,8.48656E-05,0.652048193,0.022695951,48,12
D:0| T0: 0.10| T1: 12.00| R0: 0.0| R1: 0.0| WTP: 0,0,0.096153846,12,0,0,0,0,0,-525966716.9,493045351,0.020043956,525965714.7,52596571.47,1,140,7,0,0,0,0,140,0,0,0.493506494,0,0,99918.5974,4.74025974,0,100000,0.999168158,5.05263E-05,0,0,0,11,6
D:0| T0: 0.10| T1: 12.00| R0: 0.0| R1: 0.0| WTP: 0,0,0.096153846,12,0,0,0,0,0,-1659672992,1700216563,10441.40024,1137602980,113760298,2,88181,4025,768,1734,966,768,88181,966,1734,146.4053254,2.189349112,5,65307.69527,1401.991124,7.286982249,99382.05325,0.653783485,0.014095544,7.4449E-05,0.557093426,0.0196641,49,12
D:0| T0: 0.10| T1: 12.00| R0: 0.0| R1: 0.0| WTP: 0,0,0.096153846,12,0,0,0,0,0,-1062480482,1744119059,180.6954829,1053445708,105344570.8,2,1555,78,30,30,0,30,1555,0,30,6.927536232,0.137681159,0.137681159,98907.02899,29.65217391,0.34057971,99980.17391,0.989289112,0.000296518,4.31714E-06,0,0.019292605,20,12
D:0| T0: 0.10| T1: 12.00| R0: 0.0| R1: 0.0| WTP: 0,0,0.096153846,12,0,0,0,0,0,-701896219.8,2036906360,12.03909336,701294265.1,70129426.51,1,90,7,2,2,0,2,90,0,2,0.5,0,0,99953.46364,5.272727273,0.018181818,99998.94545,0.999462571,6.35494E-05,4.3011E-07,0,0.022222222,13,8
D:0| T0: 0.10| T1: 12.00| R0: 0.0| R1: 0.0| WTP: 0,0,0.096153846,12,0,0,0,0,0,-1681237274,809704121,10820.56856,1140208846,114020884.6,2,91009,4150,749,1797,1048,749,91009,1048,1797,150.5486726,2.097345133,5.162241888,62992.65192,1385.427729,7.386430678,99328.9823,0.628382008,0.014019089,7.60007E-05,0.583194213,0.0197453,48,12
D:0| T0: 0.10| T1: 12.00| R0: 0.0| R1: 0.0| WTP: 0,0,0.096153846,12,0,0,0,0,0,-1769296711,1219866412,12462.00936,1146196244,114619624.4,2,97910,4463,853,2070,1217,853,97910,1217,2070,200.0073801,3.011070111,7.453874539,51386.29151,2959.693727,10.61623616,99084.25461,0.514583018,0.029778852,0.000108539,0.587922705,0.021141865,39,12
D:0| T0: 0.10| T1: 12.00| R0: 0.0| R1: 0.0| WTP: 0,0,0.096153846,12,0,0,0,0,0,-527532089.2,843498920,30.06529385,526028824.5,52602882.45,1,89,7,5,5,0,5,89,0,5,1.013333333,0,0,99943.44,5.053333333,0.08,99997.84,0.999459456,5.19746E-05,1.31582E-06,0,0.057471264,11,6
D:0| T0: 0.10| T1: 12.00| R0: 0.0| R1: 0.0| WTP: 0,0,0.096153846,12,0,0,0,0,0,-1056001584,107351963,78.1609805,1052093535,105209353.5,1,429,18,13,13,0,13,429,0,13,1.387931034,0.043103448,0.043103448,99715.08621,23.24137931,0.155172414,99993.66379,0.997198116,0.000234582,2.24151E-06,0,0.03030303,17,12
D:0| T0: 0.10| T1: 12.00| R0: 0.0| R1: 0.0| WTP: 0,0,0.096153846,12,0,0,0,0,0,-1741623057,773789021,12004.06155,1141419980,114141998,2,93123,4106,792,1994,1202,792,93123,1202,1994,145.4265537,2.152542373,5.511299435,59852.01412,1779.081921,7.754237288,99217.75989,0.596867066,0.018012631,7.97115E-05,0.602808425,0.02141254,51,12
D:0| T0: 0.10| T1: 12.00| R0: 0.0| R1: 0.0| WTP: 0,0,0.096153846,12,0,0,0,0,0,-1771160734,850936611,12758.05812,1133257828,113325782.8,2,91468,3783,744,2120,1376,744,91468,1376,2120,150.9022801,2.315960912,6.768729642,64403.12378,1576.149837,9.19218241,99252.27362,0.627746105,0.016630658,9.84458E-05,0.649056604,0.023177505,42,12
D:0| T0: 0.10| T1: 12.00| R0: 0.0| R1: 0.0| WTP: 0,0,0.096153846,12,0,0,0,0,0,-1721727561,1701318364,11637.21372,1139866874,113986687.4,2,92047,3983,746,1933,1187,746,92047,1187,1933,155.5337423,2.174846626,5.766871166,58250.16258,1194.368098,8.04601227,99188.14724,0.567575232,0.012476691,8.58527E-05,0.614071392,0.021000141,45,12
D:0| T0: 0.10| T1: 12.00| R0: 0.0| R1: 0.0| WTP: 0,0,0.096153846,12,0,0,0,0,0,-701235203.9,778708269,0.010549451,701234676.5,70123467.65,1,42,2,0,0,0,0,42,0,0,0.224719101,0,0,99973.55056,3.516853933,0,100000,0.99972908,3.7931E-05,0,0,0,13,8
D:0| T0: 0.10| T1: 12.00| R0: 0.0| R1: 0.0| WTP: 0,0,0.096153846,12,0,0,0,0,0,-1061421774,1391938506,174.4410021,1052699724,105269972.4,2,765,35,29,29,0,29,765,0,29,4.184,0.072,0.072,99465.488,22.664,0.328,99983.104,0.994835265,0.000227169,4.60381E-06,0,0.037908497,18,12
D:0| T0: 0.10| T1: 12.00| R0: 0.0| R1: 0.0| WTP: 0,0,0.096153846,12,0,0,0,0,0,-789483172.3,43418681,12.01852194,788882246.2,78888224.62,1,96,6,2,2,0,2,96,0,2,0.173913043,0,0,99939.82609,6.27173913,0.02173913,99998.92391,0.999412034,6.43017E-05,4.3011E-07,0,0.020833333,14,9
D:0| T0: 0.10| T1: 12.00| R0: 0.0| R1: 0.0| WTP: 0,0,0.096153846,12,0,0,0,0,0,-1788687471,817384966,13029.70292,1137202325,113720232.5,2,94416,3972,1046,2165,1119,1046,94416,1119,2165,183.0492424,3.852272727,8.022727273,48234.64015,975.155303,11.98484848,98902.45076,0.47930071,0.009929954,0.000123844,0.516859122,0.022930436,38,12
D:0| T0: 0.10| T1: 12.00| R0: 0.0| R1: 0.0| WTP: 0,0,0.096153846,12,0,0,0,0,0,-1743669546,762053968,11975.22559,1144908267,114490826.7,2,96352,4138,888,1989,1101,888,96352,1101,1989,196.2783883,3.113553114,7.102564103,50819.3663,1104.611722,10.34432234,99067.06593,0.506067675,0.011192393,0.000106762,0.553544495,0.020643059,39,12
D:0| T0: 0.10| T1: 12.00| R0: 0.0| R1: 0.0| WTP: 0,0,0.096153846,12,0,0,0,0,0,-1676963000,1692506311,10730.60561,1140432719,114043271.9,2,91144,4123,851,1782,931,851,91144,931,1782,134.4684211,2.131578947,4.544736842,64205.47632,1587.631579,6.786842105,99358.17368,0.628043854,0.016630965,7.2578E-05,0.522446689,0.019551479,52,12
D:0| T0: 0.10| T1: 12.00| R0: 0.0| R1: 0.0| WTP: 0,0,0.096153846,12,0,0,0,0,0,-1642638392,883828863,10187.828,1133246992,113324699.2,2,83227,3691,912,1692,780,912,83227,780,1692,86.83116883,1.59554731,3.016697588,47298.79777,403.961039,4.701298701,98956.95918,0.317555619,0.005287231,6.33093E-05,0.460992908,0.020329941,60,12
D:0| T0: 0.10| T1: 12.00| R0: 0.0| R1: 0.0| WTP: 0,0,0.096153846,12,0,0,0,0,0,-879289142.1,301400999,48.16217016,876881033.6,87688103.36,1,430,19,8,8,0,8,430,0,8,2.203883495,0.009708738,0.009708738,99719.3301,17.98058252,0.077669903,99996.08738,0.997240136,0.000180391,1.53851E-06,0,0.01627907,15,10
D:0| T0: 0.10| T1: 12.00| R0: 0.0| R1: 0.0| WTP: 0,0,0.096153846,12,0,0,0,0,0,-1775809041,1868336855,12605.90118,1145513982,114551398.2,2,96804,4252,719,2094,1375,719,96804,1375,2094,205.9961832,2.610687023,7.824427481,56376.08397,1447.343511,10.5648855,99144.62977,0.564306359,0.014565983,0.000108052,0.656638013,0.021631338,38,12
D:0| T0: 0.10| T1: 12.00| R0: 0.0| R1: 0.0| WTP: 0,0,0.096153846,12,0,0,0,0,0,-1764991008,1868498144,12431.08086,1143436965,114343696.5,2,95925,4179,765,2065,1300,765,95925,1300,2065,192.978022,2.655677656,7.377289377,54705.70696,1460.102564,10.19413919,99108.0696,0.547818993,0.014692896,0.000104322,0.629539952,0.021527235,39,12
D:0| T0: 0.10| T1: 12.00| R0: 0.0| R1: 0.0| WTP: 0,0,0.096153846,12,0,0,0,0,0,-1632446198,2101566889,10054.58193,1129717101,112971710.1,2,79976,3528,931,1670,739,931,79976,739,1670,100.9276018,2.013574661,3.647058824,65485.81448,1029.945701,5.757918552,99330.90724,0.656355387,0.010359642,5.92035E-05,0.44251497,0.020881264,64,12
D:0| T0: 0.10| T1: 12.00| R0: 0.0| R1: 0.0| WTP: 0,0,0.096153846,12,0,0,0,0,0,-1698026116,1665097450,11340.23866,1131014183,113101418.3,2,87046,3649,1175,1884,709,1175,87046,709,1884,134.9337349,3.406626506,5.5,43848.4759,896.6566265,9.045180723,98832.43072,0.376045786,0.010084916,0.000103698,0.376326964,0.021643729,43,12
D:0| T0: 0.10| T1: 12.00| R0: 0.0| R1: 0.0| WTP: 0,0,0.096153846,12,0,0,0,0,0,-1669854475,1716179948,10503.99255,1144654848,114465484.8,2,92543,4270,1334,1744,410,1334,92543,410,1744,213.5060241,5.240963855,6.815261044,42578.64659,1279.080321,12.17269076,99002.27309,0.428242903,0.012849908,0.000124202,0.235091743,0.018845497,36,12
D:0| T0: 0.10| T1: 12.00| R0: 0.0| R1: 0.0| WTP: 0,0,0.096153846,12,0,0,0,0,0,-968211161.5,1560278715,72.20920854,964600701.1,96460070.11,1,378,20,12,12,0,12,378,0,12,1.911111111,0.044444444,0.044444444,99801.24444,9.266666667,0.140740741,99995.45926,0.997746913,0.000108893,2.05139E-06,0,0.031830239,16,11
D:0| T0: 0.10| T1: 12.00| R0: 0.0| R1: 0.0| WTP: 0,0,0.096153846,12,0,0,0,0,0,-1778768302,991019385,12713.21903,1143107350,114310735,2,97909,4200,758,2112,1354,758,97909,1354,2112,194.802974,2.680297398,7.676579926,52251.98513,2165.066914,10.49070632,99069.03346,0.523128333,0.021787024,0.000107383,0.641098485,0.021571051,39,12
D:0| T0: 0.10| T1: 12.00| R0: 0.0| R1: 0.0| WTP: 0,0,0.096153846,12,0,0,0,0,0,-1773256424,118052103,12616.86231,1142413309,114241330.9,2,96678,4177,636,2096,1460,636,96678,1460,2096,179.1477663,2.082474227,7.068728522,60550.02405,1678.591065,9.274914089,99233.63918,0.576679983,0.018139668,0.000101493,0.696564885,0.021680217,39,12
D:0| T0: 0.10| T1: 12.00| R0: 0.0| R1: 0.0| WTP: 0,0,0.096153846,12,0,0,0,0,0,-1782365302,1209758844,12968.69304,1133930650,113393065,2,91322,3720,1241,2155,914,1241,91322,914,2155,153.7566667,4.04,7.043333333,52666.32333,891.5466667,11.16,98958.93333,0.484098375,0.00982841,0.000124732,0.42412993,0.023597819,40,12
D:0| T0: 0.10| T1: 12.00| R0: 0.0| R1: 0.0| WTP: 0,0,0.096153846,12,0,0,0,0,0,-1052947058,70671723,18.09266202,1052042425,105204242.5,1,127,9,3,3,0,3,127,0,3,1.204918033,0,0,99909.68033,6.418032787,0.024590164,99998.28689,0.999087878,6.70596E-05,5.04207E-07,0,0.023622047,17,12
D:0| T0: 0.10| T1: 12.00| R0: 0.0| R1: 0.0| WTP: 0,0,0.096153846,12,0,0,0,0,0,-1052433031,1722612191,12.01904941,1051832078,105183207.8,1,52,2,2,2,0,2,52,0,2,0.137096774,0,0,99968.91129,2.266129032,0.016129032,99999.69355,0.999688942,2.43903E-05,3.25205E-07,0,0.019230769,17,12
D:0| T0: 0.10| T1: 12.00| R0: 0.0| R1: 0.0| WTP: 0,0,0.096153846,12,0,0,0,0,0,-1052630290,1968291596,12.08340106,1052026120,105202612,2,74,4,2,2,0,2,74,0,2,0.939189189,0,0,99953.10135,2.054054054,0.013513514,99999.31757,0.999506154,2.30435E-05,2.89857E-07,0,0.027027027,20,12
D:0| T0: 0.10| T1: 12.00| R0: 0.0| R1: 0.0| WTP: 0,0,0.096153846,12,0,0,0,0,0,-1782712862,1877569084,12880.22592,1138701566,113870156.6,2,93315,3869,1369,2140,771,1369,93315,771,2140,158.9577922,4.353896104,6.795454545,39154.02273,970.7564935,11.23051948,98682.63961,0.374151418,0.010106415,0.000118633,0.360280374,0.022933076,43,12
D:0| T0: 0.10| T1: 12.00| R0: 0.0| R1: 0.0| WTP: 0,0,0.096153846,12,0,0,0,0,0,-1704062754,1726322189,11389.53744,1134585882,113458588.2,2,87636,3790,1379,1892,513,1379,87636,513,1892,150.7451613,4.329032258,5.941935484,39537.09355,958.9935484,10.40322581,98767.36129,0.386688603,0.009838439,0.000108302,0.271141649,0.021589301,44,12
D:0| T0: 0.10| T1: 12.00| R0: 0.0| R1: 0.0| WTP: 0,0,0.096153846,12,0,0,0,0,0,-1744149316,307848836,12064.05438,1140946597,114094659.7,2,94804,4071,1017,2004,987,1017,94804,987,2004,183.8303249,3.545126354,7.064981949,46938.55957,1201.238267,10.73646209,98964.59567,0.470955421,0.012083399,0.00010968,0.49251497,0.021138349,40,12
D:0| T0: 0.10| T1: 12.00| R0: 0.0| R1: 0.0| WTP: 0,0,0.096153846,12,0,0,0,0,0,-1661908755,1154000220,10536.68267,1135074622,113507462.2,2,85131,3892,891,1750,859,891,85131,859,1750,113.4075829,1.936018957,3.957345972,30402.74408,523.5995261,6.071090047,98620.83886,0.307844693,0.005268098,6.30277E-05,0.490857143,0.020556554,61,12
D:0| T0: 0.10| T1: 12.00| R0: 0.0| R1: 0.0| WTP: 0,0,0.096153846,12,0,0,0,0,0,-1052833485,2028661055,18.05783785,1051930593,105193059.3,1,112,6,3,3,0,3,112,0,3,0.629310345,0.017241379,0.017241379,99925.72414,5.24137931,0.043103448,99998.93103,0.999270844,5.44448E-05,5.12824E-07,0,0.026785714,17,12
D:0| T0: 0.10| T1: 12.00| R0: 0.0| R1: 0.0| WTP: 0,0,0.096153846,12,0,0,0,0,0,-1747740426,1629114640,12118.26816,1141827018,114182701.8,2,95486,4176,764,2013,1249,764,95486,1249,2013,165.8044872,2.333333333,6.298076923,56149.16026,1902.695513,8.737179487,99166.28205,0.562040747,0.019147694,8.96114E-05,0.620466965,0.021081625,45,12
D:0| T0: 0.10| T1: 12.00| R0: 0.0| R1: 0.0| WTP: 0,0,0.096153846,12,0,0,0,0,0,-1767342262,1439048174,12520.74799,1141304863,114130486.3,2,92976,4035,1393,2080,687,1393,92976,687,2080,169.7986577,4.570469799,6.822147651,38773.81544,1328.657718,11.51006711,98705.76174,0.384285281,0.013516506,0.000118551,0.33044733,0.022360609,43,12
D:0| T0: 0.10| T1: 12.00| R0: 0.0| R1: 0.0| WTP: 0,0,0.096153846,12,0,0,0,0,0,-1677982585,865227006,11055.84032,1125190569,112519056.9,2,82081,3417,627,1837,1210,627,82081,1210,1837,66.31121643,0.881516588,2.780410742,28931.29858,348.0252765,3.774091627,98434.48815,0.260459622,0.00366823,4.10527E-05,0.658682635,0.022380332,87,12
D:0| T0: 0.10| T1: 12.00| R0: 0.0| R1: 0.0| WTP: 0,0,0.096153846,12,0,0,0,0,0,-1756666389,890479738,12262.98437,1143517170,114351717,2,97296,4229,847,2037,1190,847,97296,1190,2037,193.5588235,2.981617647,7.308823529,51432.86397,2559.841912,10.4375,99093.45956,0.515009274,0.025754054,0.000106695,0.584479371,0.020925835,39,12
D:0| T0: 0.10| T1: 12.00| R0: 0.0| R1: 0.0| WTP: 0,0,0.096153846,12,0,0,0,0,0,-527585116.1,1017049163,30.08270044,526080981,52608098.1,1,206,7,5,5,0,5,206,0,5,1.415584416,0,0,99874.22078,8.922077922,0.077922078,99997.54545,0.998771236,9.08995E-05,1.28208E-06,0,0.024271845,11,6
D:0| T0: 0.10| T1: 12.00| R0: 0.0| R1: 0.0| WTP: 0,0,0.096153846,12,0,0,0,0,0,-525937956.2,1707305064,0.011604396,525937375.9,52593737.59,1,42,2,0,0,0,0,42,0,0,0.258823529,0,0,99976.75294,2.105882353,0,100000,0.999740263,2.59211E-05,0,0,0,11,6
D:0| T0: 0.10| T1: 12.00| R0: 0.0| R1: 0.0| WTP: 0,0,0.096153846,12,0,0,0,0,0,-1613555102,400145663,9835.646633,1121772770,112177277,2,73635,3191,470,1634,1164,470,73635,1164,1634,270.0738255,3.080536913,10.84563758,44825.28188,1325.919463,14.00671141,98868.81879,0.452691906,0.013271801,0.000141437,0.712362301,0.022190534,22,12
D:0| T0: 0.10| T1: 12.00| R0: 0.0| R1: 0.0| WTP: 0,0,0.096153846,12,0,0,0,0,0,-525941393.5,1662654181,0.012131868,525940786.9,52594078.69,1,82,5,0,0,0,0,82,0,0,0.319444444,0,0,99949.04167,4.236111111,0,100000,0.999493151,4.41096E-05,0,0,0,11,6
D:0| T0: 0.10| T1: 12.00| R0: 0.0| R1: 0.0| WTP: 0,0,0.096153846,12,0,0,0,0,0,-1726696325,182136456,11668.50688,1143270981,114327098.1,2,95501,4196,1154,1938,784,1154,95501,784,1938,195.0447761,4.182835821,7.041044776,44920.93284,1238.664179,11.32462687,98956.86567,0.441199223,0.012695803,0.000118222,0.404540764,0.020292981,38,12
D:0| T0: 0.10| T1: 12.00| R0: 0.0| R1: 0.0| WTP: 0,0,0.096153846,12,0,0,0,0,0,-526250066.5,979575387,6.020337891,525949049.6,52594904.96,1,39,2,1,1,0,1,39,0,1,0.397260274,0,0,99973.34247,3.178082192,0.01369863,99999.63014,0.999739188,3.32433E-05,2.7027E-07,0,0.025641026,11,6
D:0| T0: 0.10| T1: 12.00| R0: 0.0| R1: 0.0| WTP: 0,0,0.096153846,12,0,0,0,0,0,-1771745294,2142525414,12610.55599,1141217494,114121749.4,2,97005,4160,871,2095,1224,871,97005,1224,2095,195.0458015,3.194656489,7.832061069,54780.64122,1459.549618,11.13740458,99114.44275,0.525071363,0.015451187,0.000119813,0.58424821,0.021596825,36,12
D:0| T0: 0.10| T1: 12.00| R0: 0.0| R1: 0.0| WTP: 0,0,0.096153846,12,0,0,0,0,0,-1741964707,1464057597,12015.939,1141167757,114116775.7,2,94518,4127,695,1996,1301,695,94518,1301,1996,188.4139194,2.417582418,7.139194139,57620.48718,1298.505495,9.688644689,99187.43956,0.575244803,0.013110887,9.95438E-05,0.651803607,0.021117671,39,12
D:0| T0: 0.10| T1: 12.00| R0: 0.0| R1: 0.0| WTP: 0,0,0.096153846,12,0,0,0,0,0,-1729431789,364562610,11834.89534,1137687022,113768702.2,2,89943,3961,1284,1966,682,1284,89943,682,1966,186.3448276,4.789272031,7.337164751,50796.25287,1158.927203,12.27203065,99012.55172,0.500708099,0.011882073,0.000127645,0.346897253,0.021858288,37,12
D:0| T0: 0.10| T1: 12.00| R0: 0.0| R1: 0.0| WTP: 0,0,0.096153846,12,0,0,0,0,0,-1762069075,40350784,12447.9272,1139672716,113967271.6,2,94675,4074,919,2068,1149,919,94675,1149,2068,178.4768683,3.12455516,7.185053381,47985.31673,1300.13879,10.46263345,98949.24911,0.481189217,0.013082858,0.000106953,0.555609284,0.021843148,41,12
D:0| T0: 0.10| T1: 12.00| R0: 0.0| R1: 0.0| WTP: 0,0,0.096153846,12,0,0,0,0,0,-1687134681,804064356,10840.13583,1145127889,114512788.9,2,95942,4347,621,1800,1179,621,95942,1179,1800,186.9448276,2.024137931,6.055172414,55628.09655,958.4586207,8.193103448,99228.97241,0.536221604,0.01008266,8.78384E-05,0.655,0.018761335,40,12
D:0| T0: 0.10| T1: 12.00| R0: 0.0| R1: 0.0| WTP: 0,0,0.096153846,12,0,0,0,0,0,-1736551620,2125493986,12031.9371,1134954765,113495476.5,2,88945,3824,672,1999,1327,672,88945,1327,1999,154.171521,2.067961165,6.333333333,64720.98706,910.6731392,8.504854369,99262.80583,0.646981311,0.00919538,8.72928E-05,0.663831916,0.022474563,44,12
D:0| T0: 0.10| T1: 12.00| R0: 0.0| R1: 0.0| WTP: 0,0,0.096153846,12,0,0,0,0,0,-1655477267,23154253,10250.98385,1142928075,114292807.5,2,90284,4155,806,1702,896,806,90284,896,1702,183.4409722,2.645833333,5.725694444,56029.33333,837.6458333,8.510416667,99234.11111,0.547445712,0.008686148,9.03033E-05,0.526439483,0.018851624,40,12
D:0| T0: 0.10| T1: 12.00| R0: 0.0| R1: 0.0| WTP: 0,0,0.096153846,12,0,0,0,0,0,-1054974410,1391367689,54.19516739,1052264651,105226465.1,2,338,17,9,9,0,9,338,0,9,2.105263158,0.007518797,0.007518797,99792.92481,9.503759398,0.067669173,99995.5188,0.997817279,0.000103714,1.45167E-06,0,0.026627219,18,12
D:0| T0: 0.10| T1: 12.00| R0: 0.0| R1: 0.0| WTP: 0,0,0.096153846,12,0,0,0,0,0,-1718289176,574142276,11624.2464,1137076856,113707685.6,2,90988,4031,682,1931,1249,682,90988,1249,1931,168.8793103,2.255172414,6.524137931,65386.69655,1443.003448,8.875862069,99338.33103,0.649558004,0.014714545,9.19206E-05,0.646815122,0.021222579,41,12
D:0| T0: 0.10| T1: 12.00| R0: 0.0| R1: 0.0| WTP: 0,0,0.096153846,12,0,0,0,0,0,-789165407.6,898736779,6.008733495,788864970.9,78886497.09,1,24,2,1,1,0,1,24,0,1,0.061946903,0,0,99986.50442,1.566371681,0.017699115,99999.30088,0.999855611,1.85716E-05,2.04082E-07,0,0.041666667,14,9
D:0| T0: 0.10| T1: 12.00| R0: 0.0| R1: 0.0| WTP: 0,0,0.096153846,12,0,0,0,0,0,-1645907425,346473503,9887.372902,1151538780,115153878,2,97572,4574,602,1641,1039,602,97572,1039,1641,164.0898876,1.606741573,4.5,63870.35393,1565.191011,6.196629213,99452.93258,0.547347434,0.019696718,7.93419E-05,0.633150518,0.01681835,41,12
D:0| T0: 0.10| T1: 12.00| R0: 0.0| R1: 0.0| WTP: 0,0,0.096153846,12,0,0,0,0,0,-1742323094,445552282,12069.23532,1138861328,113886132.8,2,94705,4054,702,2005,1303,702,94705,1303,2005,144.4653179,1.927745665,5.658959538,67230.95954,1560.67052,7.670520231,99374.71676,0.613477428,0.018542261,9.29869E-05,0.649875312,0.021171005,41,12
D:0| T0: 0.10| T1: 12.00| R0: 0.0| R1: 0.0| WTP: 0,0,0.096153846,12,0,0,0,0,0,-1658780353,911758476,10435.22643,1137019031,113701903.1,2,85631,3860,830,1733,903,830,85631,903,1733,115.1873536,1.786885246,3.880562061,33347.57377,561.7096019,5.829039813,98688.08431,0.292110392,0.006032337,6.45103E-05,0.521061743,0.020237998,58,12
D:0| T0: 0.10| T1: 12.00| R0: 0.0| R1: 0.0| WTP: 0,0,0.096153846,12,0,0,0,0,0,-1708509577,1464197940,11237.28155,1146645500,114664550,2,94733,4266,1261,1866,605,1261,94733,605,1866,205.844697,4.659090909,6.897727273,43371.01515,2091.344697,11.66666667,98958.18561,0.435674144,0.021032086,0.000119061,0.324222937,0.019697466,38,12
D:0| T0: 0.10| T1: 12.00| R0: 0.0| R1: 0.0| WTP: 0,0,0.096153846,12,0,0,0,0,0,-1725201997,500405854,11856.95635,1132354179,113235417.9,2,88194,3743,752,1970,1218,752,88194,1218,1970,141.9290123,2.203703704,5.919753086,68560.58333,1109.216049,8.25,99360.81173,0.674288834,0.011594134,8.7817E-05,0.618274112,0.022337374,45,12
D:0| T0: 0.10| T1: 12.00| R0: 0.0| R1: 0.0| WTP: 0,0,0.096153846,12,0,0,0,0,0,-1804842355,772037341,13300.66002,1139809354,113980935.4,2,96025,4078,735,2210,1475,735,96025,1475,2210,201.815261,2.807228916,8.690763052,57562.08434,1268.863454,11.64257028,99097.60643,0.57664537,0.01277531,0.000119026,0.667420814,0.02301484,36,12
D:0| T0: 0.10| T1: 12.00| R0: 0.0| R1: 0.0| WTP: 0,0,0.096153846,12,0,0,0,0,0,-614302229.6,1543158763,12.0575549,613699351.8,61369935.18,1,88,7,2,2,0,2,88,0,2,0.957446809,0,0,99948.54255,4.223404255,0.021276596,99999.11702,0.999429028,4.89161E-05,4.8193E-07,0,0.022988506,12,7
D:0| T0: 0.10| T1: 12.00| R0: 0.0| R1: 0.0| WTP: 0,0,0.096153846,12,0,0,0,0,0,-1786681538,1604932531,12975.94366,1137884356,113788435.6,2,93511,3920,1177,2156,979,1177,93511,979,2156,164.8881356,3.871186441,7.138983051,42689.14576,930.8779661,11.12881356,98745.20678,0.397364957,0.009913091,0.000120342,0.454081633,0.023056111,40,12
D:0| T0: 0.10| T1: 12.00| R0: 0.0| R1: 0.0| WTP: 0,0,0.096153846,12,0,0,0,0,0,-1779679105,539051477,12749.00098,1142229056,114222905.6,2,97586,4265,893,2118,1225,893,97586,1225,2118,178.7716263,2.958477509,7.166089965,56848.84083,1929.276817,10.25605536,99159.56747,0.517465357,0.021750789,0.000117436,0.578375826,0.021703933,37,12
D:0| T0: 0.10| T1: 12.00| R0: 0.0| R1: 0.0| WTP: 0,0,0.096153846,12,0,0,0,0,0,-351017927.4,1743124675,6.041964265,350715829.2,35071582.92,1,67,6,1,1,0,1,67,0,1,1.044776119,0,0,99964.02985,3.119402985,0.014925373,99999.62687,0.999618251,3.49208E-05,3.1746E-07,0,0.015151515,9,4
D:0| T0: 0.10| T1: 12.00| R0: 0.0| R1: 0.0| WTP: 0,0,0.096153846,12,0,0,0,0,0,-1731339695,1965983789,11864.8948,1138094955,113809495.5,2,89764,3886,841,1971,1130,841,89764,1130,1971,139.6412429,2.293785311,5.449152542,61649.75424,1472.336158,7.822033898,99233.49718,0.610826943,0.015077284,8.13652E-05,0.573313039,0.021957578,50,12
D:0| T0: 0.10| T1: 12.00| R0: 0.0| R1: 0.0| WTP: 0,0,0.096153846,12,0,0,0,0,0,-1697496801,516774280,11263.15129,1134339236,113433923.6,2,87392,3736,893,1871,978,893,87392,978,1871,118.3082707,2.15037594,4.56641604,63882.45363,1416.81203,6.802005013,99284.48622,0.638058464,0.014336461,7.00911E-05,0.522715126,0.021409527,56,12
D:0| T0: 0.10| T1: 12.00| R0: 0.0| R1: 0.0| WTP: 0,0,0.096153846,12,0,0,0,0,0,-1653217756,86603142,10427.47235,1131844139,113184413.9,2,82665,3563,504,1732,1228,504,82665,1228,1732,229.1683168,2.440594059,8.49009901,37433.5396,1061.920792,10.98514851,98761.22277,0.342083009,0.011262466,0.000117479,0.709006928,0.020952035,28,12
D:0| T0: 0.10| T1: 12.00| R0: 0.0| R1: 0.0| WTP: 0,0,0.096153846,12,0,0,0,0,0,-1052438462,1431870609,12.02063183,1051837430,105183743,1,103,3,2,2,0,2,103,0,2,0.175438596,0,0,99929.74561,5.99122807,0.01754386,99998.69298,0.999313467,6.16529E-05,3.47828E-07,0,0.019417476,17,12
D:0| T0: 0.10| T1: 12.00| R0: 0.0| R1: 0.0| WTP: 0,0,0.096153846,12,0,0,0,0,0,-1720349117,1592383984,11636.7302,1138512607,113851260.7,2,91652,4013,681,1933,1252,681,91652,1252,1933,169.1898305,2.176271186,6.389830508,58055.05085,909.3355932,8.698305085,99179.13898,0.577152304,0.009241354,9.00663E-05,0.647697879,0.021090647,42,12
D:0| T0: 0.10| T1: 12.00| R0: 0.0| R1: 0.0| WTP: 0,0,0.096153846,12,0,0,0,0,0,-1668389673,1440183867,10562.35144,1140272101,114027210.1,2,90098,4147,708,1754,1046,708,90098,1046,1754,149.1690962,1.982507289,5.002915452,66027.69096,1269.994169,7.058309038,99392.29738,0.660837502,0.012773322,7.21917E-05,0.596351197,0.019467691,49,12
D:0| T0: 0.10| T1: 12.00| R0: 0.0| R1: 0.0| WTP: 0,0,0.096153846,12,0,0,0,0,0,-1730905453,1696510588,11876.50332,1137080287,113708028.7,2,91364,3920,693,1973,1280,693,91364,1280,1973,148.7568389,2.030395137,5.890577508,61906.07295,1292.844985,7.990881459,99243.5076,0.618569888,0.013051482,8.18259E-05,0.648758236,0.021594939,47,12
D:0| T0: 0.10| T1: 12.00| R0: 0.0| R1: 0.0| WTP: 0,0,0.096153846,12,0,0,0,0,0,-1788898488,895039877,12899.7124,1143912868,114391286.8,2,97426,4214,896,2143,1247,896,97426,1247,2143,187.5088968,3.067615658,7.473309609,53034.33096,1826.174377,10.65124555,99065.07473,0.506730115,0.019343455,0.000114548,0.58189454,0.021996182,39,12
D:0| T0: 0.10| T1: 12.00| R0: 0.0| R1: 0.0| WTP: 0,0,0.096153846,12,0,0,0,0,0,-1751049172,129565953,12278.95226,1137101559,113710155.9,2,91278,3857,885,2040,1155,885,91278,1155,2040,125.7855297,2.201550388,5.144702842,57512.64341,1660.374677,7.408268734,99129.95607,0.573935603,0.016809309,7.65522E-05,0.566176471,0.022349307,54,12
D:0| T0: 0.10| T1: 12.00| R0: 0.0| R1: 0.0| WTP: 0,0,0.096153846,12,0,0,0,0,0,-614205817.2,1902565669,12.02590655,613604521.8,61360452.18,1,159,7,2,2,0,2,159,0,2,0.337078652,0,0,99909.01124,6.584269663,0.02247191,99999.30337,0.999048342,7.11768E-05,4.70591E-07,0,0.012578616,12,7
D:0| T0: 0.10| T1: 12.00| R0: 0.0| R1: 0.0| WTP: 0,0,0.096153846,12,0,0,0,0,0,-1708167411,1984179288,11526.59519,1131837652,113183765.2,2,85121,3753,1004,1915,911,1004,85121,911,1915,105.3851508,2.252900232,4.324825986,67086.83527,1493.663573,6.64037123,99324.19258,0.654388099,0.015849517,7.18806E-05,0.475718016,0.022497386,59,12
D:0| T0: 0.10| T1: 12.00| R0: 0.0| R1: 0.0| WTP: 0,0,0.096153846,12,0,0,0,0,0,-1760058782,677377223,12346.79644,1142718960,114271896,2,95892,4218,858,2051,1193,858,95892,1193,2051,172.589404,2.715231788,6.612582781,53693.88411,2577.139073,9.463576159,99111.93377,0.537638831,0.025940122,9.69808E-05,0.581667479,0.021388646,43,12
D:0| T0: 0.10| T1: 12.00| R0: 0.0| R1: 0.0| WTP: 0,0,0.096153846,12,0,0,0,0,0,-1734149797,973583301,11777.08919,1145295337,114529533.7,2,95876,4330,753,1956,1203,753,95876,1203,1956,183.4897959,2.459183673,6.506802721,58576.2585,2643.391156,9.074829932,99252.28231,0.58329073,0.026774727,9.33634E-05,0.615030675,0.020401352,42,12
D:0| T0: 0.10| T1: 12.00| R0: 0.0| R1: 0.0| WTP: 0,0,0.096153846,12,0,0,0,0,0,-1661421472,781062938,10306.02473,1146120235,114612023.5,2,91725,4378,715,1711,996,715,91725,996,1711,169.2469136,2.108024691,5.151234568,61734.4537,1299.453704,7.354938272,99348.01852,0.617916913,0.013062591,7.52787E-05,0.582115722,0.018653584,47,12
D:0| T0: 0.10| T1: 12.00| R0: 0.0| R1: 0.0| WTP: 0,0,0.096153846,12,0,0,0,0,0,-1733304253,338783425,11812.29376,1142689565,114268956.5,2,95317,4248,818,1962,1144,818,95317,1144,1962,152.3236152,2.29154519,5.588921283,58737.59475,2274.113703,7.988338192,99240.85423,0.577977377,0.023435657,8.35521E-05,0.583078491,0.020583946,48,12
D:0| T0: 0.10| T1: 16.00| R0: 0.0| R1: 0.0| WTP: 0,0,0.096153846,16,0,0,0,0,0,-2044646241,650073325,11096.49593,1489821444,148982144.4,2,92864,4142,749,1843,1094,749,92864,1094,1843,103.1721311,1.477459016,3.698770492,73977.54508,1220.243852,5.237704918,99531.52869,0.646693933,0.01668146,7.26581E-05,0.593597396,0.019846227,52,16
D:0| T0: 0.10| T1: 16.00| R0: 0.0| R1: 0.0| WTP: 0,0,0.096153846,16,0,0,0,0,0,-2122325536,2029998696,12498.41586,1497404743,149740474.3,2,95469,4269,1178,2076,898,1178,95469,898,2076,185.8732877,3.886986301,6.928082192,53726.81849,1107.493151,10.95890411,99079.61986,0.522758853,0.011542587,0.000116084,0.43256262,0.021745279,41,16
D:0| T0: 0.10| T1: 16.00| R0: 0.0| R1: 0.0| WTP: 0,0,0.096153846,16,0,0,0,0,0,-2152020776,776062361,13252.55163,1489393194,148939319.4,2,94654,3935,1342,2202,860,1342,94654,860,2202,146.6047904,3.895209581,6.413173653,53478.86228,1759.197605,10.42215569,99006.84731,0.498860018,0.019161654,0.000115529,0.390554042,0.023263676,44,16
D:0| T0: 0.10| T1: 16.00| R0: 0.0| R1: 0.0| WTP: 0,0,0.096153846,16,0,0,0,0,0,-790143259.7,1813046880,24.0502197,788940748.7,78894074.87,1,100,3,4,4,0,4,100,0,4,0.505154639,0.020618557,0.020618557,99933.56701,5.783505155,0.06185567,99997.71134,0.999361715,5.9491E-05,8.16337E-07,0,0.04,14,9
D:0| T0: 0.10| T1: 16.00| R0: 0.0| R1: 0.0| WTP: 0,0,0.096153846,16,0,0,0,0,0,-969116302.8,2032407216,84.31581289,964900512.2,96490051.22,1,779,40,14,14,0,14,779,0,14,3.552845528,0.056910569,0.056910569,99539.73171,21.43902439,0.162601626,99992.72358,0.994948703,0.000239204,2.52268E-06,0,0.018018018,16,11
D:0| T0: 0.10| T1: 16.00| R0: 0.0| R1: 0.0| WTP: 0,0,0.096153846,16,0,0,0,0,0,-613612900.2,1507873352,0.019516484,613611924.4,61361192.44,1,20,3,0,0,0,0,20,0,0,0.359223301,0,0,99989.39806,1.747572816,0,100000,0.999877209,2.0814E-05,0,0,0,12,7
D:0| T0: 0.10| T1: 16.00| R0: 0.0| R1: 0.0| WTP: 0,0,0.096153846,16,0,0,0,0,0,-613940692.7,1855899401,6.032997232,613639042.8,61363904.28,1,115,5,1,1,0,1,115,0,1,0.6625,0,0,99925.2875,4.475,0.0125,99999.425,0.999253494,4.67503E-05,0.00000025,0,0.008695652,12,7
D:0| T0: 0.10| T1: 16.00| R0: 0.0| R1: 0.0| WTP: 0,0,0.096153846,16,0,0,0,0,0,-2119913071,1819459251,12603.81924,1489722109,148972210.9,2,93061,3994,746,2094,1348,746,93061,1348,2094,148.875,2.077380952,6.0625,56480.44048,992.547619,8.297619048,99077.83631,0.565887438,0.009997778,8.51233E-05,0.643744031,0.02250137,48,16
D:0| T0: 0.10| T1: 16.00| R0: 0.0| R1: 0.0| WTP: 0,0,0.096153846,16,0,0,0,0,0,-350960853.1,909791748,6.024030199,350659651.6,35065965.16,1,60,2,1,1,0,1,60,0,1,0.590163934,0,0,99965.06557,2.770491803,0.016393443,99999.70492,0.999655805,3.03226E-05,3.22581E-07,0,0.016949153,9,4
D:0| T0: 0.10| T1: 16.00| R0: 0.0| R1: 0.0| WTP: 0,0,0.096153846,16,0,0,0,0,0,-2102520992,1339092841,12426.90011,1481175987,148117598.7,2,87956,3625,786,2065,1279,786,87956,1279,2065,146.2647059,2.401960784,6.549019608,66870.22222,1031.539216,9.111111111,99284.98039,0.669741651,0.010384777,9.38085E-05,0.61937046,0.023477648,44,16
D:0| T0: 0.10| T1: 16.00| R0: 0.0| R1: 0.0| WTP: 0,0,0.096153846,16,0,0,0,0,0,-2118886257,1365866345,12479.51183,1494910665,149491066.5,2,97365,4239,1036,2073,1037,1036,97365,1037,2073,153.7412791,2.875,5.869186047,58743.7907,882.255814,8.89244186,99171,0.519029462,0.01039251,0.000106397,0.500241196,0.021291018,42,16
D:0| T0: 0.10| T1: 16.00| R0: 0.0| R1: 0.0| WTP: 0,0,0.096153846,16,0,0,0,0,0,-2050610215,825453433,11127.91441,1494214494,149421449.4,2,93897,4325,684,1848,1164,684,93897,1164,1848,167.081761,2.031446541,5.657232704,63078.10692,1505.562893,7.805031447,99346.59119,0.631136275,0.015140603,8.01029E-05,0.62987013,0.01968114,46,16
D:0| T0: 0.10| T1: 16.00| R0: 0.0| R1: 0.0| WTP: 0,0,0.096153846,16,0,0,0,0,0,-2095697546,939711378,12028.96204,1494249444,149424944.4,2,96046,4247,1198,1998,800,1198,96046,800,1998,179.9312715,3.972508591,6.711340206,48440.29897,1294.467354,10.82474227,98995.90722,0.486465951,0.01302897,0.000110465,0.4004004,0.020802532,42,16
D:0| T0: 0.10| T1: 16.00| R0: 0.0| R1: 0.0| WTP: 0,0,0.096153846,16,0,0,0,0,0,-2060542371,638950699,11284.80995,1496301873,149630187.3,2,92882,4253,788,1874,1086,788,92882,1086,1874,124.8643678,1.731034483,4.195402299,54599.29425,1345.533333,6.025287356,99139.65517,0.546837004,0.013549095,6.16217E-05,0.579509072,0.020176137,63,16
D:0| T0: 0.10| T1: 16.00| R0: 0.0| R1: 0.0| WTP: 0,0,0.096153846,16,0,0,0,0,0,-1141838461,938699148,42.12651908,1139732135,113973213.5,1,448,21,7,7,0,7,448,0,7,1.104895105,0.027972028,0.027972028,99750.46154,10.41958042,0.083916084,99996.03497,0.997085929,0.000124468,1.15705E-06,0,0.015625,18,13
D:0| T0: 0.10| T1: 16.00| R0: 0.0| R1: 0.0| WTP: 0,0,0.096153846,16,0,0,0,0,0,-2071373548,1412065496,11483.22873,1497212112,149721211.2,2,93758,4277,648,1907,1259,648,93758,1259,1907,143.3333333,1.596354167,4.846354167,71534.74219,717.65625,6.526041667,99467.84375,0.647966609,0.008939666,8.29167E-05,0.660199266,0.020339598,45,16
D:0| T0: 0.10| T1: 16.00| R0: 0.0| R1: 0.0| WTP: 0,0,0.096153846,16,0,0,0,0,0,-2099942571,1331335240,12113.01231,1494291955,149429195.5,2,96456,4207,1089,2012,923,1089,96456,923,2012,153.1049563,3.064139942,5.717201166,49161.85714,1854.661808,8.897959184,99014.92128,0.472808881,0.019411413,9.45756E-05,0.458747515,0.020859252,48,16
D:0| T0: 0.10| T1: 16.00| R0: 0.0| R1: 0.0| WTP: 0,0,0.096153846,16,0,0,0,0,0,-2040742010,470935411,11260.71331,1477706344,147770634.4,2,81351,3437,808,1871,1063,808,81351,1063,1871,65.68807339,1.102446483,2.706422018,29580.25688,321.9464832,3.940366972,98423.73547,0.276567167,0.003352327,4.26738E-05,0.568145377,0.022999103,91,16
D:0| T0: 0.10| T1: 16.00| R0: 0.0| R1: 0.0| WTP: 0,0,0.096153846,16,0,0,0,0,0,-2154169242,823434397,13312.1151,1488563487,148856348.7,2,91573,3854,757,2212,1455,757,91573,1455,2212,130.3076923,1.936339523,5.75596817,62508.41379,1241.228117,7.769230769,99165.33952,0.625839629,0.012511712,7.94137E-05,0.657775769,0.024155592,54,16
D:0| T0: 0.10| T1: 16.00| R0: 0.0| R1: 0.0| WTP: 0,0,0.096153846,16,0,0,0,0,0,-525966716.9,493045351,0.020043956,525965714.7,52596571.47,1,140,7,0,0,0,0,140,0,0,0.493506494,0,0,99918.5974,4.74025974,0,100000,0.999168158,5.05263E-05,0,0,0,11,6
D:0| T0: 0.10| T1: 16.00| R0: 0.0| R1: 0.0| WTP: 0,0,0.096153846,16,0,0,0,0,0,-1996678849,1700216563,10171.1397,1488121863,148812186.3,2,88308,4021,783,1689,906,783,88308,906,1689,123.6925,1.8875,4.1175,68659.5325,1187.135,6.075,99454.71,0.687134821,0.011936847,6.21626E-05,0.536412078,0.01912624,58,16
D:0| T0: 0.10| T1: 16.00| R0: 0.0| R1: 0.0| WTP: 0,0,0.096153846,16,0,0,0,0,0,-1325431175,1744119059,180.6954829,1316396400,131639640,1,1555,78,30,30,0,30,1555,0,30,6.927536232,0.137681159,0.137681159,98907.02899,29.65217391,0.34057971,99980.17391,0.989289112,0.000296518,4.31714E-06,0,0.019292605,20,15
D:0| T0: 0.10| T1: 16.00| R0: 0.0| R1: 0.0| WTP: 0,0,0.096153846,16,0,0,0,0,0,-701896219.8,2036906360,12.03909336,701294265.1,70129426.51,1,90,7,2,2,0,2,90,0,2,0.5,0,0,99953.46364,5.272727273,0.018181818,99998.94545,0.999462571,6.35494E-05,4.3011E-07,0,0.022222222,13,8
D:0| T0: 0.10| T1: 16.00| R0: 0.0| R1: 0.0| WTP: 0,0,0.096153846,16,0,0,0,0,0,-2065603823,809704121,11499.1531,1490646167,149064616.7,2,90963,4061,780,1910,1130,780,90963,1130,1910,131.8623377,1.94025974,4.838961039,63558.6961,1213.402597,6.864935065,99293.34545,0.634371867,0.01227851,7.07185E-05,0.591623037,0.020997548,54,16
D:0| T0: 0.10| T1: 16.00| R0: 0.0| R1: 0.0| WTP: 0,0,0.096153846,16,0,0,0,0,0,-2124141640,1219866412,12593.41526,1494470877,149447087.7,2,97693,4321,950,2092,1142,950,97693,1142,2092,180.9278351,3.120274914,6.996563574,55766.86254,2751.137457,10.25085911,99158.14089,0.55843734,0.027694213,0.000105226,0.545889101,0.021414021,42,16
D:0| T0: 0.10| T1: 16.00| R0: 0.0| R1: 0.0| WTP: 0,0,0.096153846,16,0,0,0,0,0,-527532089.2,843498920,30.06529385,526028824.5,52602882.45,1,89,7,5,5,0,5,89,0,5,1.013333333,0,0,99943.44,5.053333333,0.08,99997.84,0.999459456,5.19746E-05,1.31582E-06,0,0.057471264,11,6
D:0| T0: 0.10| T1: 16.00| R0: 0.0| R1: 0.0| WTP: 0,0,0.096153846,16,0,0,0,0,0,-1056001584,107351963,78.1609805,1052093535,105209353.5,1,429,18,13,13,0,13,429,0,13,1.387931034,0.043103448,0.043103448,99715.08621,23.24137931,0.155172414,99993.66379,0.997198116,0.000234582,2.24151E-06,0,0.03030303,17,12
D:0| T0: 0.10| T1: 16.00| R0: 0.0| R1: 0.0| WTP: 0,0,0.096153846,16,0,0,0,0,0,-1229355149,773789021,42.0817004,1227251064,122725106.4,1,333,12,7,7,0,7,333,0,7,0.622222222,0.007407407,0.007407407,99783.48148,16.42222222,0.059259259,99996.36296,0.997845037,0.000167467,1.04481E-06,0,0.021021021,19,14
D:0| T0: 0.10| T1: 16.00| R0: 0.0| R1: 0.0| WTP: 0,0,0.096153846,16,0,0,0,0,0,-2122513002,850936611,12734.66201,1485779901,148577990.1,2,91321,3820,736,2116,1380,736,91321,1380,2116,126.137931,1.856763926,5.482758621,61654.32891,1284.742706,7.445623342,99179.95491,0.602611029,0.013440623,7.91746E-05,0.652173913,0.023171012,52,16
D:0| T0: 0.10| T1: 16.00| R0: 0.0| R1: 0.0| WTP: 0,0,0.096153846,16,0,0,0,0,0,-2081498747,1701318364,11823.33296,1490332099,149033209.9,2,91955,4014,762,1964,1202,762,91955,1202,1964,146.0982659,2.080924855,5.523121387,65641.80636,1124.618497,7.710982659,99333.93064,0.644810953,0.011724517,8.21571E-05,0.612016293,0.021358273,48,16
D:0| T0: 0.10| T1: 16.00| R0: 0.0| R1: 0.0| WTP: 0,0,0.096153846,16,0,0,0,0,0,-701235203.9,778708269,0.010549451,701234676.5,70123467.65,1,42,2,0,0,0,0,42,0,0,0.224719101,0,0,99973.55056,3.516853933,0,100000,0.99972908,3.7931E-05,0,0,0,13,8
D:0| T0: 0.10| T1: 16.00| R0: 0.0| R1: 0.0| WTP: 0,0,0.096153846,16,0,0,0,0,0,-1149072005,1391938506,174.4410021,1140349954,114034995.4,1,765,35,29,29,0,29,765,0,29,4.184,0.072,0.072,99465.488,22.664,0.328,99983.104,0.994835265,0.000227169,4.60381E-06,0,0.037908497,18,13
D:0| T0: 0.10| T1: 16.00| R0: 0.0| R1: 0.0| WTP: 0,0,0.096153846,16,0,0,0,0,0,-789483172.3,43418681,12.01852194,788882246.2,78888224.62,1,96,6,2,2,0,2,96,0,2,0.173913043,0,0,99939.82609,6.27173913,0.02173913,99998.92391,0.999412034,6.43017E-05,4.3011E-07,0,0.020833333,14,9
D:0| T0: 0.10| T1: 16.00| R0: 0.0| R1: 0.0| WTP: 0,0,0.096153846,16,0,0,0,0,0,-2154208468,817384966,13282.67044,1490074946,149007494.6,2,94329,4021,1050,2207,1157,1050,94329,1157,2207,158.7795527,3.236421725,6.875399361,50534.39297,822.0383387,10.23961661,98932.85304,0.503724572,0.008361593,0.000105847,0.524241051,0.023396834,45,16
D:0| T0: 0.10| T1: 16.00| R0: 0.0| R1: 0.0| WTP: 0,0,0.096153846,16,0,0,0,0,0,-2089081179,762053968,11873.0856,1495426899,149542689.9,2,96207,4246,897,1972,1075,897,96207,1075,1972,171.5096154,2.737179487,6.153846154,53925.07372,964.7403846,9.025641026,99124.41026,0.537870011,0.009771362,9.3103E-05,0.545131846,0.020497469,45,16
D:0| T0: 0.10| T1: 16.00| R0: 0.0| R1: 0.0| WTP: 0,0,0.096153846,16,0,0,0,0,0,-1408558710,1692506311,114.241332,1402846643,140284664.3,2,546,20,19,19,0,19,546,0,19,1.392265193,0.033149171,0.033149171,99672.09945,20.20994475,0.138121547,99990.44751,0.996536091,0.000220797,2.27565E-06,0,0.034926471,23,16
D:0| T0: 0.10| T1: 16.00| R0: 0.0| R1: 0.0| WTP: 0,0,0.096153846,16,0,0,0,0,0,-1991591532,883828863,10175.45094,1482818985,148281898.5,2,82243,3693,910,1690,780,910,82243,780,1690,68.35207101,1.235207101,2.368343195,42951.59911,318.1346154,3.713017751,98857.98077,0.303899453,0.003926294,4.7523E-05,0.461538462,0.020549111,79,16
D:0| T0: 0.10| T1: 16.00| R0: 0.0| R1: 0.0| WTP: 0,0,0.096153846,16,0,0,0,0,0,-879289142.1,301400999,48.16217016,876881033.6,87688103.36,1,430,19,8,8,0,8,430,0,8,2.203883495,0.009708738,0.009708738,99719.3301,17.98058252,0.077669903,99996.08738,0.997240136,0.000180391,1.53851E-06,0,0.01627907,15,10
D:0| T0: 0.10| T1: 16.00| R0: 0.0| R1: 0.0| WTP: 0,0,0.096153846,16,0,0,0,0,0,-2134668623,1868336855,12791.72873,1495082187,149508218.7,2,96571,4237,743,2125,1382,743,96571,1382,2125,168.5696203,2.21835443,6.560126582,54998.60443,1194.867089,8.89556962,99081.91139,0.55071016,0.012034198,9.1399E-05,0.650352941,0.022004536,46,16
D:0| T0: 0.10| T1: 16.00| R0: 0.0| R1: 0.0| WTP: 0,0,0.096153846,16,0,0,0,0,0,-2165255444,1868498144,13481.10692,1491200099,149120009.9,2,95842,4085,820,2240,1420,820,95842,1420,2240,160.7396825,2.447619048,6.926984127,55755.83492,1273.177778,9.542857143,99048.09524,0.558428296,0.012827253,9.7885E-05,0.633928571,0.023371799,45,16
D:0| T0: 0.10| T1: 16.00| R0: 0.0| R1: 0.0| WTP: 0,0,0.096153846,16,0,0,0,0,0,-1316208864,2101566889,24.10086805,1315003820,131500382,1,197,10,4,4,0,4,197,0,4,1.092857143,0,0,99871.20714,8.478571429,0.028571429,99998.49286,0.998730896,8.63841E-05,5.67384E-07,0,0.020304569,20,15
D:0| T0: 0.10| T1: 16.00| R0: 0.0| R1: 0.0| WTP: 0,0,0.096153846,16,0,0,0,0,0,-2047007512,1665097450,11280.60669,1482977177,148297717.7,2,86663,3701,1166,1874,708,1166,86663,708,1874,114.8417085,2.773869347,4.510050251,41966.02261,748.0603015,7.447236181,98786.03518,0.367657095,0.008257386,8.43636E-05,0.377801494,0.021624491,52,16
D:0| T0: 0.10| T1: 16.00| R0: 0.0| R1: 0.0| WTP: 0,0,0.096153846,16,0,0,0,0,0,-2009607663,1716179948,10364.62222,1491376552,149137655.2,2,90477,4111,1417,1721,304,1417,90477,304,1721,153.7848485,4.133333333,5.018181818,39022.67576,945.3545455,9.3,98904.73939,0.39313279,0.009506529,9.56425E-05,0.176641488,0.019021409,48,16
D:0| T0: 0.10| T1: 16.00| R0: 0.0| R1: 0.0| WTP: 0,0,0.096153846,16,0,0,0,0,0,-968211161.5,1560278715,72.20920854,964600701.1,96460070.11,1,378,20,12,12,0,12,378,0,12,1.911111111,0.044444444,0.044444444,99801.24444,9.266666667,0.140740741,99995.45926,0.997746913,0.000108893,2.05139E-06,0,0.031830239,16,11
D:0| T0: 0.10| T1: 16.00| R0: 0.0| R1: 0.0| WTP: 0,0,0.096153846,16,0,0,0,0,0,-2155559872,991019385,13235.74002,1493772871,149377287.1,2,97653,4154,837,2199,1362,837,97653,1362,2199,177.1762712,2.681355932,7.257627119,56055.32542,1962.301695,10.09830508,99103.85763,0.561229203,0.019764851,0.000103648,0.619372442,0.022518509,43,16
D:0| T0: 0.10| T1: 16.00| R0: 0.0| R1: 0.0| WTP: 0,0,0.096153846,16,0,0,0,0,0,-2132065790,118052103,12802.69767,1491930907,149193090.7,2,96281,4122,693,2127,1434,693,96281,1434,2127,163.0666667,2.095238095,6.60952381,63372.19683,1532.492063,8.828571429,99273.24444,0.609163873,0.01647627,9.62709E-05,0.674188999,0.022091586,43,16
D:0| T0: 0.10| T1: 16.00| R0: 0.0| R1: 0.0| WTP: 0,0,0.096153846,16,0,0,0,0,0,-2127465869,1209758844,12831.11361,1485910189,148591018.9,2,89392,3690,1459,2132,673,1459,89392,673,2132,149.0859873,4.506369427,6.611464968,57335.73248,834.7802548,11.24840764,99060.98408,0.537584829,0.009165285,0.000125506,0.315666041,0.023850009,42,16
D:0| T0: 0.10| T1: 16.00| R0: 0.0| R1: 0.0| WTP: 0,0,0.096153846,16,0,0,0,0,0,-1052947058,70671723,18.09266202,1052042425,105204242.5,1,127,9,3,3,0,3,127,0,3,1.204918033,0,0,99909.68033,6.418032787,0.024590164,99998.28689,0.999087878,6.70596E-05,5.04207E-07,0,0.023622047,17,12
D:0| T0: 0.10| T1: 16.00| R0: 0.0| R1: 0.0| WTP: 0,0,0.096153846,16,0,0,0,0,0,-1052433031,1722612191,12.01904941,1051832078,105183207.8,1,52,2,2,2,0,2,52,0,2,0.137096774,0,0,99968.91129,2.266129032,0.016129032,99999.69355,0.999688942,2.43903E-05,3.25205E-07,0,0.019230769,17,12
D:0| T0: 0.10| T1: 16.00| R0: 0.0| R1: 0.0| WTP: 0,0,0.096153846,16,0,0,0,0,0,-1315580982,1968291596,12.08340106,1314976812,131497681.2,1,74,4,2,2,0,2,74,0,2,0.939189189,0,0,99953.10135,2.054054054,0.013513514,99999.31757,0.999506154,2.30435E-05,2.89857E-07,0,0.027027027,20,15
D:0| T0: 0.10| T1: 16.00| R0: 0.0| R1: 0.0| WTP: 0,0,0.096153846,16,0,0,0,0,0,-2138171465,1877569084,12970.42279,1489650326,148965032.6,2,92563,3878,1409,2155,746,1409,92563,746,2155,153.565625,4.265625,6.540625,43266.78438,926.80625,10.9375,98767.62813,0.417836298,0.009637732,0.000115856,0.346332405,0.023270637,45,16
D:0| T0: 0.10| T1: 16.00| R0: 0.0| R1: 0.0| WTP: 0,0,0.096153846,16,0,0,0,0,0,-2038891059,1726322189,11118.55602,1482963258,148296325.8,2,85347,3681,1384,1847,463,1384,85347,463,1847,112.8387097,3.287841191,4.397022333,37476.20596,717.8635236,7.841191067,98706.43176,0.368968921,0.007335324,8.19684E-05,0.250676773,0.021641065,57,16
D:0| T0: 0.10| T1: 16.00| R0: 0.0| R1: 0.0| WTP: 0,0,0.096153846,16,0,0,0,0,0,-2094495153,307848836,12123.12744,1488338781,148833878.1,2,93782,3954,1190,2014,824,1190,93782,824,2014,159.245098,3.748366013,6.411764706,50150.95425,1078.519608,10.30065359,99012.46732,0.503380463,0.010855555,0.000105341,0.409136048,0.021475336,44,16
D:0| T0: 0.10| T1: 16.00| R0: 0.0| R1: 0.0| WTP: 0,0,0.096153846,16,0,0,0,0,0,-1902103993,1154000220,8622.134929,1470997247,147099724.7,2,70493,3203,573,1432,859,573,70493,859,1432,213.7567568,2.978378378,7.589189189,45278.82162,991.427027,10.7027027,98967.50811,0.457113026,0.009926297,0.000108592,0.599860335,0.020314074,27,16
D:0| T0: 0.10| T1: 16.00| R0: 0.0| R1: 0.0| WTP: 0,0,0.096153846,16,0,0,0,0,0,-1052833485,2028661055,18.05783785,1051930593,105193059.3,1,112,6,3,3,0,3,112,0,3,0.629310345,0.017241379,0.017241379,99925.72414,5.24137931,0.043103448,99998.93103,0.999270844,5.44448E-05,5.12824E-07,0,0.026785714,17,12
D:0| T0: 0.10| T1: 16.00| R0: 0.0| R1: 0.0| WTP: 0,0,0.096153846,16,0,0,0,0,0,-2085431989,1629114640,11865.94003,1492134988,149213498.8,2,95595,4157,763,1971,1208,763,95595,1208,1971,152.7573964,2.127218935,5.659763314,61258.49112,1763.754438,7.923076923,99279.29882,0.612959248,0.017753186,8.14339E-05,0.612886859,0.020618233,49,16
D:0| T0: 0.10| T1: 16.00| R0: 0.0| R1: 0.0| WTP: 0,0,0.096153846,16,0,0,0,0,0,-2114230694,1439048174,12490.0678,1489727304,148972730.4,2,90819,3972,1570,2075,505,1570,90819,505,2075,147.3603604,4.582582583,6.045045045,41037.35435,1156.159159,10.75975976,98727.74474,0.408366254,0.011752899,0.000111295,0.243373494,0.022847642,48,16
D:0| T0: 0.10| T1: 16.00| R0: 0.0| R1: 0.0| WTP: 0,0,0.096153846,16,0,0,0,0,0,-1991207206,865227006,10387.96343,1471809035,147180903.5,2,77049,3206,516,1726,1210,516,77049,1210,1726,192.7427184,2.432038835,8.266990291,47539.26699,1004.548544,10.77669903,98903.93689,0.397248879,0.011652111,0.000126356,0.701042874,0.022401329,26,16
D:0| T0: 0.10| T1: 16.00| R0: 0.0| R1: 0.0| WTP: 0,0,0.096153846,16,0,0,0,0,0,-2102797974,890479738,12161.13579,1494741184,149474118.4,2,96553,4277,965,2020,1055,965,96553,1055,2020,178.777027,3.114864865,6.64527027,54402.875,2329.266892,9.915540541,99145.20608,0.544855975,0.023442215,0.000101477,0.522277228,0.020921152,43,16
D:0| T0: 0.10| T1: 16.00| R0: 0.0| R1: 0.0| WTP: 0,0,0.096153846,16,0,0,0,0,0,-527585116.1,1017049163,30.08270044,526080981,52608098.1,1,206,7,5,5,0,5,206,0,5,1.415584416,0,0,99874.22078,8.922077922,0.077922078,99997.54545,0.998771236,9.08995E-05,1.28208E-06,0,0.024271845,11,6
D:0| T0: 0.10| T1: 16.00| R0: 0.0| R1: 0.0| WTP: 0,0,0.096153846,16,0,0,0,0,0,-525937956.2,1707305064,0.011604396,525937375.9,52593737.59,1,42,2,0,0,0,0,42,0,0,0.258823529,0,0,99976.75294,2.105882353,0,100000,0.999740263,2.59211E-05,0,0,0,11,6
D:0| T0: 0.10| T1: 16.00| R0: 0.0| R1: 0.0| WTP: 0,0,0.096153846,16,0,0,0,0,0,-1964218693,400145663,9835.667205,1472435333,147243533.3,2,73632,3191,470,1634,1164,470,73632,1164,1634,251.75,2.86875,10.1,43556.6625,1234.725,13.04375,98834.25,0.440080531,0.01236459,0.000131774,0.712362301,0.022191439,23,16
D:0| T0: 0.10| T1: 16.00| R0: 0.0| R1: 0.0| WTP: 0,0,0.096153846,16,0,0,0,0,0,-525941393.5,1662654181,0.012131868,525940786.9,52594078.69,1,82,5,0,0,0,0,82,0,0,0.319444444,0,0,99949.04167,4.236111111,0,100000,0.999493151,4.41096E-05,0,0,0,11,6
D:0| T0: 0.10| T1: 16.00| R0: 0.0| R1: 0.0| WTP: 0,0,0.096153846,16,0,0,0,0,0,-2075730560,182136456,11650.27811,1493216654,149321665.4,2,95035,4184,1170,1935,765,1170,95035,765,1935,155.7207207,3.399399399,5.651651652,43312.12012,989.6186186,9.153153153,98906.43243,0.427168566,0.010113202,9.52614E-05,0.395348837,0.02036092,47,16
D:0| T0: 0.10| T1: 16.00| R0: 0.0| R1: 0.0| WTP: 0,0,0.096153846,16,0,0,0,0,0,-526250066.5,979575387,6.020337891,525949049.6,52594904.96,1,39,2,1,1,0,1,39,0,1,0.397260274,0,0,99973.34247,3.178082192,0.01369863,99999.63014,0.999739188,3.32433E-05,2.7027E-07,0,0.025641026,11,6
D:0| T0: 0.10| T1: 16.00| R0: 0.0| R1: 0.0| WTP: 0,0,0.096153846,16,0,0,0,0,0,-2119839533,2142525414,12556.6909,1492004988,149200498.8,2,95658,4062,1119,2086,967,1119,95658,967,2086,168.2475248,3.574257426,6.729372937,54676.06601,1230.871287,10.39933993,99086.24752,0.527764907,0.012950099,0.00011121,0.463566635,0.021806854,42,16
D:0| T0: 0.10| T1: 16.00| R0: 0.0| R1: 0.0| WTP: 0,0,0.096153846,16,0,0,0,0,0,-2084416343,1464057597,11877.42161,1490545262,149054526.2,2,94206,4128,736,1973,1237,736,94206,1237,1973,161.3121019,2.219745223,6.127388535,57932.58917,1124.570064,8.461783439,99192.48726,0.578646351,0.01135122,8.71042E-05,0.626964014,0.020943464,45,16
D:0| T0: 0.10| T1: 16.00| R0: 0.0| R1: 0.0| WTP: 0,0,0.096153846,16,0,0,0,0,0,-2059037838,364562610,11455.97031,1486239323,148623932.3,2,88018,3845,1488,1903,415,1488,88018,415,1903,147.678125,4.496875,5.75,49349.64375,929.146875,10.39375,98970.85,0.48835394,0.009498894,0.000108304,0.218076721,0.021620578,45,16
D:0| T0: 0.10| T1: 16.00| R0: 0.0| R1: 0.0| WTP: 0,0,0.096153846,16,0,0,0,0,0,-2111128891,40350784,12465.25649,1487866066,148786606.6,2,93119,3974,1164,2071,907,1164,93119,907,2071,172.1814947,3.978647687,7.167259786,55047.59431,1276.647687,11.30604982,99088.05338,0.552039781,0.012849843,0.000115828,0.43795268,0.022240359,41,16
D:0| T0: 0.10| T1: 16.00| R0: 0.0| R1: 0.0| WTP: 0,0,0.096153846,16,0,0,0,0,0,-2023781525,804064356,10563.84548,1495589251,149558925.1,2,96092,4358,643,1754,1111,643,96092,1111,1754,181.7751678,2.023489933,5.728187919,63577.9094,934.2416107,7.872483221,99392.49329,0.619684408,0.009815271,8.45164E-05,0.63340935,0.018253341,41,16
D:0| T0: 0.10| T1: 16.00| R0: 0.0| R1: 0.0| WTP: 0,0,0.096153846,16,0,0,0,0,0,-1416151809,2125493986,246.6796997,1403817824,140381782.4,2,1628,65,41,41,0,41,1628,0,41,4.825301205,0.144578313,0.144578313,98768.95783,30.54216867,0.379518072,99971.30723,0.987926102,0.000308011,4.94072E-06,0,0.025199754,24,16
D:0| T0: 0.10| T1: 16.00| R0: 0.0| R1: 0.0| WTP: 0,0,0.096153846,16,0,0,0,0,0,-1989397881,23154253,9973.831473,1490706307,149070630.7,2,89413,4100,881,1656,775,881,89413,775,1656,171.3221477,2.791946309,5.352348993,62351.13423,799.590604,8.298657718,99357.23826,0.613047544,0.008284397,8.81716E-05,0.467995169,0.018520797,42,16
D:0| T0: 0.10| T1: 16.00| R0: 0.0| R1: 0.0| WTP: 0,0,0.096153846,16,0,0,0,0,0,-1142623034,1391367689,54.19463992,1139913302,113991330.2,1,338,17,9,9,0,9,338,0,9,2.113636364,0.007575758,0.007575758,99793.95455,9.575757576,0.068181818,99995.55303,0.99782669,0.000104557,1.46347E-06,0,0.026627219,18,13
D:0| T0: 0.10| T1: 16.00| R0: 0.0| R1: 0.0| WTP: 0,0,0.096153846,16,0,0,0,0,0,-2080882395,574142276,11787.65838,1491499476,149149947.6,2,90861,4074,694,1958,1264,694,90861,1264,1958,156.0303951,2.018237082,5.811550152,66791.66869,1264.079027,7.939209726,99348.79939,0.664346125,0.012876265,8.214E-05,0.645556691,0.0215494,47,16
D:0| T0: 0.10| T1: 16.00| R0: 0.0| R1: 0.0| WTP: 0,0,0.096153846,16,0,0,0,0,0,-789165407.6,898736779,6.008733495,788864970.9,78886497.09,1,24,2,1,1,0,1,24,0,1,0.061946903,0,0,99986.50442,1.566371681,0.017699115,99999.30088,0.999855611,1.85716E-05,2.04082E-07,0,0.041666667,14,9
D:0| T0: 0.10| T1: 16.00| R0: 0.0| R1: 0.0| WTP: 0,0,0.096153846,16,0,0,0,0,0,-2020199234,346473503,10361.77778,1502110345,150211034.5,2,97451,4623,625,1720,1095,625,97451,1095,1720,140.0504808,1.411057692,4.016826923,61480.33173,1330.401442,5.528846154,99372.54087,0.534523776,0.016171577,6.85487E-05,0.636627907,0.017649896,50,16
D:0| T0: 0.10| T1: 16.00| R0: 0.0| R1: 0.0| WTP: 0,0,0.096153846,16,0,0,0,0,0,-2090923863,445552282,11944.50404,1493698661,149369866.1,2,94689,4261,735,1984,1249,735,94689,1249,1984,143.6748634,1.898907104,5.281420765,71374.43989,1467.663934,7.284153005,99461.94536,0.665535904,0.017270115,8.74441E-05,0.62953629,0.020952803,44,16
D:0| T0: 0.10| T1: 16.00| R0: 0.0| R1: 0.0| WTP: 0,0,0.096153846,16,0,0,0,0,0,-2008203919,911758476,10423.02021,1487052908,148705290.8,2,85234,3831,828,1731,903,828,85234,903,1731,87.89388489,1.347122302,2.955035971,31769.64748,429.4604317,4.447841727,98644.76978,0.286615221,0.00454405,4.87319E-05,0.521663778,0.020308797,76,16
D:0| T0: 0.10| T1: 16.00| R0: 0.0| R1: 0.0| WTP: 0,0,0.096153846,16,0,0,0,0,0,-2043306573,1464197940,10990.03,1493805073,149380507.3,2,91532,4115,1507,1825,318,1507,91532,318,1825,151.2354651,4.238372093,5.122093023,40188.2064,1549.784884,9.502906977,98863.36919,0.404469209,0.015597048,9.7462E-05,0.174246575,0.019938382,50,16
D:0| T0: 0.10| T1: 16.00| R0: 0.0| R1: 0.0| WTP: 0,0,0.096153846,16,0,0,0,0,0,-2079306625,500405854,11905.36372,1484038439,148403843.9,2,88061,3776,767,1978,1211,767,88061,1211,1978,124.6550802,1.957219251,5.160427807,67857.89037,957.6390374,7.205882353,99336.98396,0.668756464,0.009961719,7.63652E-05,0.61223458,0.022461703,52,16
D:0| T0: 0.10| T1: 16.00| R0: 0.0| R1: 0.0| WTP: 0,0,0.096153846,16,0,0,0,0,0,-2170112784,772037341,13547.64143,1492730713,149273071.3,2,96156,4155,762,2251,1489,762,96156,1489,2251,164.9233227,2.290734824,7.015974441,55363.623,1010.15016,9.447284345,99017.35144,0.554836548,0.010179242,9.69668E-05,0.661483785,0.023409876,45,16
D:0| T0: 0.10| T1: 16.00| R0: 0.0| R1: 0.0| WTP: 0,0,0.096153846,16,0,0,0,0,0,-614302229.6,1543158763,12.0575549,613699351.8,61369935.18,1,88,7,2,2,0,2,88,0,2,0.957446809,0,0,99948.54255,4.223404255,0.021276596,99999.11702,0.999429028,4.89161E-05,4.8193E-07,0,0.022988506,12,7
D:0| T0: 0.10| T1: 16.00| R0: 0.0| R1: 0.0| WTP: 0,0,0.096153846,16,0,0,0,0,0,-2127715837,1604932531,12783.79825,1488525924,148852592.4,2,93431,3858,1196,2124,928,1196,93431,928,2124,148.5731707,3.512195122,6.298780488,44731.79268,839.4481707,9.929878049,98794.10671,0.422641706,0.008891262,0.000107224,0.436911488,0.022733354,45,16
D:0| T0: 0.10| T1: 16.00| R0: 0.0| R1: 0.0| WTP: 0,0,0.096153846,16,0,0,0,0,0,-2114815443,539051477,12377.75317,1495927785,149592778.5,2,96885,4304,1057,2056,999,1057,96885,999,2056,154.6878613,2.916184971,5.774566474,54013.91618,1598.534682,8.826589595,99102.66474,0.496052788,0.017679533,9.94642E-05,0.485894942,0.021221035,45,16
D:0| T0: 0.10| T1: 16.00| R0: 0.0| R1: 0.0| WTP: 0,0,0.096153846,16,0,0,0,0,0,-351017927.4,1743124675,6.041964265,350715829.2,35071582.92,1,67,6,1,1,0,1,67,0,1,1.044776119,0,0,99964.02985,3.119402985,0.014925373,99999.62687,0.999618251,3.49208E-05,3.1746E-07,0,0.015151515,9,4
D:0| T0: 0.10| T1: 16.00| R0: 0.0| R1: 0.0| WTP: 0,0,0.096153846,16,0,0,0,0,0,-2076977261,1965983789,11774.66464,1488244029,148824402.9,2,89974,3908,849,1956,1107,849,89974,1107,1956,133.1815718,2.233062331,5.189701897,64794.7832,1424.720867,7.485094851,99308.95122,0.642863026,0.014577366,7.78123E-05,0.56595092,0.021739855,52,16
D:0| T0: 0.10| T1: 16.00| R0: 0.0| R1: 0.0| WTP: 0,0,0.096153846,16,0,0,0,0,0,-1317483978,516774280,48.14581302,1315076687,131507668.7,1,422,13,8,8,0,8,422,0,8,1.315068493,0.01369863,0.01369863,99708.17123,17.60273973,0.054794521,99995.21918,0.997096431,0.000179454,1.10349E-06,0,0.018957346,20,15
D:0| T0: 0.10| T1: 16.00| R0: 0.0| R1: 0.0| WTP: 0,0,0.096153846,16,0,0,0,0,0,-2003596930,86603142,10427.39956,1482226953,148222695.3,2,82662,3563,504,1732,1228,504,82662,1228,1732,273.1005917,2.917159763,10.14792899,41358.82249,1269.260355,13.13017751,98857.53254,0.376476684,0.013599575,0.000141862,0.709006928,0.020952796,23,16
D:0| T0: 0.10| T1: 16.00| R0: 0.0| R1: 0.0| WTP: 0,0,0.096153846,16,0,0,0,0,0,-1052438462,1431870609,12.02063183,1051837430,105183743,1,103,3,2,2,0,2,103,0,2,0.175438596,0,0,99929.74561,5.99122807,0.01754386,99998.69298,0.999313467,6.16529E-05,3.47828E-07,0,0.019417476,17,12
D:0| T0: 0.10| T1: 16.00| R0: 0.0| R1: 0.0| WTP: 0,0,0.096153846,16,0,0,0,0,0,-2056236181,1592383984,11318.81502,1490295430,149029543,2,91347,4109,688,1880,1192,688,91347,1192,1880,140.85,1.786111111,5.055555556,55896.96389,742.5166667,6.969444444,99145.5,0.556295091,0.007532676,7.23909E-05,0.634042553,0.020580862,51,16
D:0| T0: 0.10| T1: 16.00| R0: 0.0| R1: 0.0| WTP: 0,0,0.096153846,16,0,0,0,0,0,-2027434114,1440183867,10748.2491,1490021659,149002165.9,2,90075,4122,733,1785,1052,733,90075,1052,1785,137.3994565,1.91576087,4.747282609,65236.11413,1186.559783,6.72826087,99364.48098,0.652977602,0.011936901,6.88454E-05,0.589355742,0.019816819,53,16
D:0| T0: 0.10| T1: 16.00| R0: 0.0| R1: 0.0| WTP: 0,0,0.096153846,16,0,0,0,0,0,-1228510203,1696510588,24.08557134,1227305925,122730592.5,1,185,7,4,4,0,4,185,0,4,0.939393939,0,0,99886.80303,6.424242424,0.03030303,99998.94697,0.998873696,6.65158E-05,6.0607E-07,0,0.016304348,19,14
D:0| T0: 0.10| T1: 16.00| R0: 0.0| R1: 0.0| WTP: 0,0,0.096153846,16,0,0,0,0,0,-2162701440,895039877,13350.37857,1495182511,149518251.1,2,97159,4193,1000,2218,1218,1000,97159,1218,2218,172.3420195,3.120521173,7.061889251,56428.37459,1665.801303,10.32899023,99104.54072,0.544614889,0.017577266,0.000110599,0.549143372,0.022828794,42,16
D:0| T0: 0.10| T1: 16.00| R0: 0.0| R1: 0.0| WTP: 0,0,0.096153846,16,0,0,0,0,0,-2117762455,129565953,12573.66743,1489079083,148907908.3,2,91803,3968,920,2089,1169,920,91803,1169,2089,122.5682382,2.203473945,5.064516129,64854.31514,1615.009926,7.344913151,99278.51861,0.6474717,0.016353753,7.56326E-05,0.559597894,0.022755248,57,16
D:0| T0: 0.10| T1: 16.00| R0: 0.0| R1: 0.0| WTP: 0,0,0.096153846,16,0,0,0,0,0,-614205817.2,1902565669,12.02590655,613604521.8,61360452.18,1,159,7,2,2,0,2,159,0,2,0.337078652,0,0,99909.01124,6.584269663,0.02247191,99999.30337,0.999048342,7.11768E-05,4.70591E-07,0,0.012578616,12,7
D:0| T0: 0.10| T1: 16.00| R0: 0.0| R1: 0.0| WTP: 0,0,0.096153846,16,0,0,0,0,0,-1403848070,1984179288,24.09664827,1402643238,140264323.8,2,236,13,4,4,0,4,236,0,4,0.852941176,0,0,99849.63529,10.67058824,0.023529412,99997.91176,0.998309948,0.000121613,5.36921E-07,0,0.016949153,22,16
D:0| T0: 0.10| T1: 16.00| R0: 0.0| R1: 0.0| WTP: 0,0,0.096153846,16,0,0,0,0,0,-2112185485,677377223,12370.97154,1493636908,149363690.8,2,95704,4074,924,2055,1131,924,95704,1131,2055,164.5157233,2.745283019,6.270440252,58423.71069,2444.616352,9.20754717,99200.92767,0.584902329,0.024615462,9.43232E-05,0.550364964,0.021472457,45,16
D:0| T0: 0.10| T1: 16.00| R0: 0.0| R1: 0.0| WTP: 0,0,0.096153846,16,0,0,0,0,0,-2072558816,973583301,11513.18501,1496899565,149689956.5,2,95856,4360,767,1912,1145,767,95856,1145,1912,165.0151057,2.217522659,5.637462236,58860.61934,2350.009063,7.96978852,99264.40181,0.586474089,0.023788493,8.19536E-05,0.598849372,0.019946587,47,16
D:0| T0: 0.10| T1: 16.00| R0: 0.0| R1: 0.0| WTP: 0,0,0.096153846,16,0,0,0,0,0,-1987191139,781062938,9890.343639,1492673957,149267395.7,2,91761,4168,719,1642,923,719,91761,923,1642,153.8357771,2.002932551,4.674486804,68460.34604,1241.190616,6.782991202,99493.6217,0.684863165,0.012473251,6.95967E-05,0.562119367,0.017894312,49,16
D:0| T0: 0.10| T1: 16.00| R0: 0.0| R1: 0.0| WTP: 0,0,0.096153846,16,0,0,0,0,0,-2079789145,338783425,11692.80748,1495148772,149514877.2,2,95293,4257,821,1942,1121,821,95293,1121,1942,148.4444444,2.197222222,5.272222222,64179.94722,2163.041667,7.536111111,99353.38333,0.633914406,0.022270593,7.9035E-05,0.577239959,0.020379251,51,16
D:0| T0: 0.10| T1: 20.00| R0: 0.0| R1: 0.0| WTP: 0,0,0.096153846,20,0,0,0,0,0,-2411186873,650073325,11391.12956,1841630394,184163039.4,2,92728,4211,717,1892,1175,717,92728,1175,1892,98.77562863,1.324951644,3.574468085,74859.4971,1148.84913,4.969052224,99534.0619,0.665394001,0.015402536,6.77013E-05,0.621035941,0.020403762,56,20
D:0| T0: 0.10| T1: 20.00| R0: 0.0| R1: 0.0| WTP: 0,0,0.096153846,20,0,0,0,0,0,-2447699447,2029998696,12070.77474,1844160710,184416071,2,94939,4194,1215,2005,790,1215,94939,790,2005,158.3658537,3.545731707,5.926829268,54770.25305,977.9237805,9.615853659,99117.55793,0.535634042,0.010153674,0.000101877,0.394014963,0.021118824,46,20
D:0| T0: 0.10| T1: 20.00| R0: 0.0| R1: 0.0| WTP: 0,0,0.096153846,20,0,0,0,0,0,-2463179229,776062361,12501.38359,1838110049,183811004.9,2,91322,3848,1634,2077,443,1634,91322,443,2077,110.5638051,3.663573086,4.665893271,47352.00928,1314.183295,8.452436195,98864.25986,0.44353471,0.014063433,9.21189E-05,0.213288397,0.022743698,57,20
D:0| T0: 0.10| T1: 20.00| R0: 0.0| R1: 0.0| WTP: 0,0,0.096153846,20,0,0,0,0,0,-790143259.7,1813046880,24.0502197,788940748.7,78894074.87,1,100,3,4,4,0,4,100,0,4,0.505154639,0.020618557,0.020618557,99933.56701,5.783505155,0.06185567,99997.71134,0.999361715,5.9491E-05,8.16337E-07,0,0.04,14,9
D:0| T0: 0.10| T1: 20.00| R0: 0.0| R1: 0.0| WTP: 0,0,0.096153846,20,0,0,0,0,0,-969116302.8,2032407216,84.31581289,964900512.2,96490051.22,1,779,40,14,14,0,14,779,0,14,3.552845528,0.056910569,0.056910569,99539.73171,21.43902439,0.162601626,99992.72358,0.994948703,0.000239204,2.52268E-06,0,0.018018018,16,11
D:0| T0: 0.10| T1: 20.00| R0: 0.0| R1: 0.0| WTP: 0,0,0.096153846,20,0,0,0,0,0,-613612900.2,1507873352,0.019516484,613611924.4,61361192.44,1,20,3,0,0,0,0,20,0,0,0.359223301,0,0,99989.39806,1.747572816,0,100000,0.999877209,2.0814E-05,0,0,0,12,7
D:0| T0: 0.10| T1: 20.00| R0: 0.0| R1: 0.0| WTP: 0,0,0.096153846,20,0,0,0,0,0,-613940692.7,1855899401,6.032997232,613639042.8,61363904.28,1,115,5,1,1,0,1,115,0,1,0.6625,0,0,99925.2875,4.475,0.0125,99999.425,0.999253494,4.67503E-05,0.00000025,0,0.008695652,12,7
D:0| T0: 0.10| T1: 20.00| R0: 0.0| R1: 0.0| WTP: 0,0,0.096153846,20,0,0,0,0,0,-2464672016,1819459251,12513.31745,1839006144,183900614.4,2,92786,3910,766,2079,1313,766,92786,1313,2079,138.6873239,2.008450704,5.667605634,61250.45634,929.4929577,7.833802817,99187.79437,0.613488335,0.009362243,8.07164E-05,0.631553632,0.022406398,51,20
D:0| T0: 0.10| T1: 20.00| R0: 0.0| R1: 0.0| WTP: 0,0,0.096153846,20,0,0,0,0,0,-350960853.1,909791748,6.024030199,350659651.6,35065965.16,1,60,2,1,1,0,1,60,0,1,0.590163934,0,0,99965.06557,2.770491803,0.016393443,99999.70492,0.999655805,3.03226E-05,3.22581E-07,0,0.016949153,9,4
D:0| T0: 0.10| T1: 20.00| R0: 0.0| R1: 0.0| WTP: 0,0,0.096153846,20,0,0,0,0,0,-2430365832,1339092841,11976.39839,1831545913,183154591.3,2,87353,3638,765,1990,1225,765,87353,1225,1990,131.6470588,2.070588235,5.635294118,70211.93235,918.0058824,7.908823529,99371.03529,0.703059277,0.009242997,8.15725E-05,0.615577889,0.022781129,49,20
D:0| T0: 0.10| T1: 20.00| R0: 0.0| R1: 0.0| WTP: 0,0,0.096153846,20,0,0,0,0,0,-2474829166,1365866345,12605.29539,1844564396,184456439.6,2,97246,4268,1044,2094,1050,1044,97246,1050,2094,138.6259947,2.615384615,5.381962865,60188.78249,804.3421751,8.159151194,99185.30239,0.542956021,0.009341256,9.65908E-05,0.501432665,0.021533019,47,20
D:0| T0: 0.10| T1: 20.00| R0: 0.0| R1: 0.0| WTP: 0,0,0.096153846,20,0,0,0,0,0,-2405941217,825453433,11241.72424,1843855005,184385500.5,2,93767,4196,688,1867,1179,688,93767,1179,1867,152.7383721,1.889534884,5.287790698,67255.35756,1392.552326,7.281976744,99418.71221,0.672796475,0.014008522,7.47415E-05,0.631494376,0.019911056,50,20
D:0| T0: 0.10| T1: 20.00| R0: 0.0| R1: 0.0| WTP: 0,0,0.096153846,20,0,0,0,0,0,-2431505578,939711378,11734.68081,1844771537,184477153.7,2,95897,4246,1256,1949,693,1256,95897,693,1949,149.991404,3.432664756,5.401146132,46772.93983,1083.289398,9.017191977,98969.9255,0.470032721,0.010907697,9.24054E-05,0.355566957,0.020323889,50,20
D:0| T0: 0.10| T1: 20.00| R0: 0.0| R1: 0.0| WTP: 0,0,0.096153846,20,0,0,0,0,0,-2407243570,638950699,11248.10928,1844838106,184483810.6,2,92999,4170,801,1868,1067,801,92999,1067,1868,137.7636364,1.981818182,4.722077922,67869.37922,1530.807792,6.797402597,99419.30649,0.679019865,0.015409158,6.97898E-05,0.571199143,0.020086237,55,20
D:0| T0: 0.10| T1: 20.00| R0: 0.0| R1: 0.0| WTP: 0,0,0.096153846,20,0,0,0,0,0,-1141838461,938699148,42.12651908,1139732135,113973213.5,1,448,21,7,7,0,7,448,0,7,1.104895105,0.027972028,0.027972028,99750.46154,10.41958042,0.083916084,99996.03497,0.997085929,0.000124468,1.15705E-06,0,0.015625,18,13
D:0| T0: 0.10| T1: 20.00| R0: 0.0| R1: 0.0| WTP: 0,0,0.096153846,20,0,0,0,0,0,-1608662468,1412065496,524.0343361,1582460751,158246075.1,1,4166,192,87,87,0,87,4166,0,87,11.96566524,0.296137339,0.296137339,97987.71245,52.7167382,0.665236052,99961.07725,0.971141792,0.000765818,1.08795E-05,0,0.020888355,23,18
D:0| T0: 0.10| T1: 20.00| R0: 0.0| R1: 0.0| WTP: 0,0,0.096153846,20,0,0,0,0,0,-2431074650,1331335240,11728.69232,1844640034,184464003.4,2,94871,4195,1361,1948,587,1361,94871,587,1948,159.4587156,4.012232416,5.77675841,57131.27829,1913.370031,9.932721713,99196.61774,0.555042026,0.020057236,0.000106022,0.301334702,0.020533145,45,20
D:0| T0: 0.10| T1: 20.00| R0: 0.0| R1: 0.0| WTP: 0,0,0.096153846,20,0,0,0,0,0,-2256898098,470935411,10400.72688,1736861754,173686175.4,1,76553,3241,665,1728,1063,665,76553,1063,1728,218.4385027,3.470588235,9.080213904,51483.99465,1060.395722,12.61497326,98995.65241,0.457515785,0.011972692,0.000144568,0.615162037,0.022572892,24,19
D:0| T0: 0.10| T1: 20.00| R0: 0.0| R1: 0.0| WTP: 0,0,0.096153846,20,0,0,0,0,0,-1580920072,823434397,60.11843935,1577914150,157791415,1,521,14,10,10,0,10,521,0,10,0.73125,0.01875,0.01875,99655.375,15.425,0.075,99994.88125,0.996611501,0.00015603,1.24229E-06,0,0.019230769,23,18
D:0| T0: 0.10| T1: 20.00| R0: 0.0| R1: 0.0| WTP: 0,0,0.096153846,20,0,0,0,0,0,-525966716.9,493045351,0.020043956,525965714.7,52596571.47,1,140,7,0,0,0,0,140,0,0,0.493506494,0,0,99918.5974,4.74025974,0,100000,0.999168158,5.05263E-05,0,0,0,11,6
D:0| T0: 0.10| T1: 20.00| R0: 0.0| R1: 0.0| WTP: 0,0,0.096153846,20,0,0,0,0,0,-1666457118,1700216563,18.07842027,1665553197,166555319.7,1,285,12,3,3,0,3,285,0,3,0.727272727,0,0,99812.71515,8.690909091,0.018181818,99998.15152,0.998150074,8.88566E-05,3.61449E-07,0,0.01056338,24,19
D:0| T0: 0.10| T1: 20.00| R0: 0.0| R1: 0.0| WTP: 0,0,0.096153846,20,0,0,0,0,0,-1325431175,1744119059,180.6954829,1316396400,131639640,1,1555,78,30,30,0,30,1555,0,30,6.927536232,0.137681159,0.137681159,98907.02899,29.65217391,0.34057971,99980.17391,0.989289112,0.000296518,4.31714E-06,0,0.019292605,20,15
D:0| T0: 0.10| T1: 20.00| R0: 0.0| R1: 0.0| WTP: 0,0,0.096153846,20,0,0,0,0,0,-701896219.8,2036906360,12.03909336,701294265.1,70129426.51,1,90,7,2,2,0,2,90,0,2,0.5,0,0,99953.46364,5.272727273,0.018181818,99998.94545,0.999462571,6.35494E-05,4.3011E-07,0,0.022222222,13,8
D:0| T0: 0.10| T1: 20.00| R0: 0.0| R1: 0.0| WTP: 0,0,0.096153846,20,0,0,0,0,0,-2405721248,809704121,11312.59132,1840091682,184009168.2,2,91088,4080,769,1879,1110,769,91088,1110,1879,121.8686131,1.788321168,4.452554745,66830.18735,1141.114355,6.335766423,99365.41119,0.66722588,0.011547351,6.51888E-05,0.590739755,0.020628403,58,20
D:0| T0: 0.10| T1: 20.00| R0: 0.0| R1: 0.0| WTP: 0,0,0.096153846,20,0,0,0,0,0,-2441101111,1219866412,11885.40076,1846831073,184683107.3,2,97300,4305,1027,1974,947,1027,97300,947,1974,165.190184,2.996932515,5.877300613,57073.22086,2453.705521,9.015337423,99211.18405,0.571697801,0.024700055,9.2629E-05,0.479736575,0.02028777,47,20
D:0| T0: 0.10| T1: 20.00| R0: 0.0| R1: 0.0| WTP: 0,0,0.096153846,20,0,0,0,0,0,-527532089.2,843498920,30.06529385,526028824.5,52602882.45,1,89,7,5,5,0,5,89,0,5,1.013333333,0,0,99943.44,5.053333333,0.08,99997.84,0.999459456,5.19746E-05,1.31582E-06,0,0.057471264,11,6
D:0| T0: 0.10| T1: 20.00| R0: 0.0| R1: 0.0| WTP: 0,0,0.096153846,20,0,0,0,0,0,-1056001584,107351963,78.1609805,1052093535,105209353.5,1,429,18,13,13,0,13,429,0,13,1.387931034,0.043103448,0.043103448,99715.08621,23.24137931,0.155172414,99993.66379,0.997198116,0.000234582,2.24151E-06,0,0.03030303,17,12
D:0| T0: 0.10| T1: 20.00| R0: 0.0| R1: 0.0| WTP: 0,0,0.096153846,20,0,0,0,0,0,-1229355149,773789021,42.0817004,1227251064,122725106.4,1,333,12,7,7,0,7,333,0,7,0.622222222,0.007407407,0.007407407,99783.48148,16.42222222,0.059259259,99996.36296,0.997845037,0.000167467,1.04481E-06,0,0.021021021,19,14
D:0| T0: 0.10| T1: 20.00| R0: 0.0| R1: 0.0| WTP: 0,0,0.096153846,20,0,0,0,0,0,-2456498936,850936611,12427.97353,1835100260,183510026,2,91340,3802,754,2065,1311,754,91340,1311,2065,109.0862471,1.671328671,4.706293706,62147.90909,1127.400932,6.473193473,99205.29604,0.609518262,0.011740381,6.84656E-05,0.634866828,0.022607839,60,20
D:0| T0: 0.10| T1: 20.00| R0: 0.0| R1: 0.0| WTP: 0,0,0.096153846,20,0,0,0,0,0,-2427462777,1701318364,11780.4801,1838438772,183843877.2,2,91813,3931,775,1957,1182,775,91813,1182,1957,132.4594595,1.967567568,5.12972973,70072.92162,1045.408108,7.22972973,99425.48108,0.691289219,0.010875894,7.68321E-05,0.603985692,0.021315064,52,20
D:0| T0: 0.10| T1: 20.00| R0: 0.0| R1: 0.0| WTP: 0,0,0.096153846,20,0,0,0,0,0,-701235203.9,778708269,0.010549451,701234676.5,70123467.65,1,42,2,0,0,0,0,42,0,0,0.224719101,0,0,99973.55056,3.516853933,0,100000,0.99972908,3.7931E-05,0,0,0,13,8
D:0| T0: 0.10| T1: 20.00| R0: 0.0| R1: 0.0| WTP: 0,0,0.096153846,20,0,0,0,0,0,-1149072005,1391938506,174.4410021,1140349954,114034995.4,1,765,35,29,29,0,29,765,0,29,4.184,0.072,0.072,99465.488,22.664,0.328,99983.104,0.994835265,0.000227169,4.60381E-06,0,0.037908497,18,13
D:0| T0: 0.10| T1: 20.00| R0: 0.0| R1: 0.0| WTP: 0,0,0.096153846,20,0,0,0,0,0,-789483172.3,43418681,12.01852194,788882246.2,78888224.62,1,96,6,2,2,0,2,96,0,2,0.173913043,0,0,99939.82609,6.27173913,0.02173913,99998.92391,0.999412034,6.43017E-05,4.3011E-07,0,0.020833333,14,9
D:0| T0: 0.10| T1: 20.00| R0: 0.0| R1: 0.0| WTP: 0,0,0.096153846,20,0,0,0,0,0,-1933022618,817384966,4700.967959,1697974220,169797422,1,35075,1454,502,781,279,502,35075,279,781,109.7559524,2.880952381,4.5,74182.78571,570.8452381,7.494047619,99474.94048,0.741220086,0.005799161,7.75974E-05,0.357234315,0.022266572,24,19
D:0| T0: 0.10| T1: 20.00| R0: 0.0| R1: 0.0| WTP: 0,0,0.096153846,20,0,0,0,0,0,-2444328431,762053968,11992.74279,1844691292,184469129.2,2,96128,4243,901,1992,1091,901,96128,1091,1992,153.9415205,2.494152047,5.649122807,59219.94737,877.3684211,8.274853801,99220.81871,0.591467655,0.008884552,8.56303E-05,0.547690763,0.02072237,49,20
D:0| T0: 0.10| T1: 20.00| R0: 0.0| R1: 0.0| WTP: 0,0,0.096153846,20,0,0,0,0,0,-1759159633,1692506311,114.241332,1753447566,175344756.6,2,555,20,19,19,0,19,555,0,19,1.177570093,0.028037383,0.028037383,99637.25234,17.42523364,0.11682243,99988.99065,0.996224819,0.000188116,1.90017E-06,0,0.034234234,28,20
D:0| T0: 0.10| T1: 20.00| R0: 0.0| R1: 0.0| WTP: 0,0,0.096153846,20,0,0,0,0,0,-2344680801,883828863,10235.3373,1832913936,183291393.6,2,82406,3664,920,1700,780,920,82406,780,1700,68.6991018,1.251497006,2.398203593,43971.84281,322.3038922,3.778443114,98879.27246,0.314630333,0.003988467,4.85958E-05,0.458823529,0.020630317,78,20
D:0| T0: 0.10| T1: 20.00| R0: 0.0| R1: 0.0| WTP: 0,0,0.096153846,20,0,0,0,0,0,-879289142.1,301400999,48.16217016,876881033.6,87688103.36,1,430,19,8,8,0,8,430,0,8,2.203883495,0.009708738,0.009708738,99719.3301,17.98058252,0.077669903,99996.08738,0.997240136,0.000180391,1.53851E-06,0,0.01627907,15,10
D:0| T0: 0.10| T1: 20.00| R0: 0.0| R1: 0.0| WTP: 0,0,0.096153846,20,0,0,0,0,0,-2471671755,1868336855,12497.82835,1846780337,184678033.7,2,96462,4285,773,2076,1303,773,96462,1303,2076,148.7355372,1.994490358,5.556473829,55108.68595,1036.347107,7.67768595,99091.97796,0.551910688,0.01044096,7.90486E-05,0.627649326,0.021521428,52,20
D:0| T0: 0.10| T1: 20.00| R0: 0.0| R1: 0.0| WTP: 0,0,0.096153846,20,0,0,0,0,0,-2486966280,1868498144,12851.39965,1844396297,184439629.7,2,95401,4158,850,2135,1285,850,95401,1285,2135,160.1681957,2.425076453,6.324159021,61726.77064,1210.400612,8.944954128,99214.55046,0.618087223,0.012192148,9.19384E-05,0.601873536,0.02237922,47,20
D:0| T0: 0.10| T1: 20.00| R0: 0.0| R1: 0.0| WTP: 0,0,0.096153846,20,0,0,0,0,0,-1316208864,2101566889,24.10086805,1315003820,131500382,1,197,10,4,4,0,4,197,0,4,1.092857143,0,0,99871.20714,8.478571429,0.028571429,99998.49286,0.998730896,8.63841E-05,5.67384E-07,0,0.020304569,20,15
D:0| T0: 0.10| T1: 20.00| R0: 0.0| R1: 0.0| WTP: 0,0,0.096153846,20,0,0,0,0,0,-2400837662,1665097450,11376.19146,1832028088,183202808.8,2,85951,3636,1184,1890,706,1184,85951,706,1890,94.9447983,2.367303609,3.838641189,40730.59873,624.881104,6.350318471,98741.69851,0.363892014,0.006799508,7.10637E-05,0.373544974,0.021989273,63,20
D:0| T0: 0.10| T1: 20.00| R0: 0.0| R1: 0.0| WTP: 0,0,0.096153846,20,0,0,0,0,0,-2358300965,1716179948,10298.9952,1843351205,184335120.5,2,90003,4166,1409,1710,301,1409,90003,301,1710,124.15625,3.233173077,3.920673077,36136.44231,744.1850962,7.317307692,98836.2524,0.364429218,0.00748836,7.54541E-05,0.176023392,0.018999367,60,20
D:0| T0: 0.10| T1: 20.00| R0: 0.0| R1: 0.0| WTP: 0,0,0.096153846,20,0,0,0,0,0,-968211161.5,1560278715,72.20920854,964600701.1,96460070.11,1,378,20,12,12,0,12,378,0,12,1.911111111,0.044444444,0.044444444,99801.24444,9.266666667,0.140740741,99995.45926,0.997746913,0.000108893,2.05139E-06,0,0.031830239,16,11
D:0| T0: 0.10| T1: 20.00| R0: 0.0| R1: 0.0| WTP: 0,0,0.096153846,20,0,0,0,0,0,-2493056762,991019385,12959.73653,1845069935,184506993.5,2,97409,4184,898,2153,1255,898,97409,1255,2153,163.6832298,2.621118012,6.47515528,58894.13975,1797.363354,9.260869565,99172.51242,0.589719301,0.01810604,9.54183E-05,0.582907571,0.02210268,46,20
D:0| T0: 0.10| T1: 20.00| R0: 0.0| R1: 0.0| WTP: 0,0,0.096153846,20,0,0,0,0,0,-2482984859,118052103,12808.73053,1842548332,184254833.2,2,96212,4106,752,2128,1376,752,96212,1376,2128,147.0630372,2.037249284,5.954154728,63921.19198,1394.037249,8.123209169,99281.50716,0.61760321,0.014890904,8.81806E-05,0.646616541,0.022117823,47,20
D:0| T0: 0.10| T1: 20.00| R0: 0.0| R1: 0.0| WTP: 0,0,0.096153846,20,0,0,0,0,0,-2465265453,1209758844,12602.50045,1835140431,183514043.1,2,88256,3635,1556,2094,538,1556,88256,538,2094,111.7080292,3.669099757,4.948905109,51528.95377,627.026764,8.712895377,98907.89538,0.485771066,0.006746223,9.55004E-05,0.256924546,0.023726432,55,20
D:0| T0: 0.10| T1: 20.00| R0: 0.0| R1: 0.0| WTP: 0,0,0.096153846,20,0,0,0,0,0,-1052947058,70671723,18.09266202,1052042425,105204242.5,1,127,9,3,3,0,3,127,0,3,1.204918033,0,0,99909.68033,6.418032787,0.024590164,99998.28689,0.999087878,6.70596E-05,5.04207E-07,0,0.023622047,17,12
D:0| T0: 0.10| T1: 20.00| R0: 0.0| R1: 0.0| WTP: 0,0,0.096153846,20,0,0,0,0,0,-1052433031,1722612191,12.01904941,1051832078,105183207.8,1,52,2,2,2,0,2,52,0,2,0.137096774,0,0,99968.91129,2.266129032,0.016129032,99999.69355,0.999688942,2.43903E-05,3.25205E-07,0,0.019230769,17,12
D:0| T0: 0.10| T1: 20.00| R0: 0.0| R1: 0.0| WTP: 0,0,0.096153846,20,0,0,0,0,0,-1315580982,1968291596,12.08340106,1314976812,131497681.2,1,74,4,2,2,0,2,74,0,2,0.939189189,0,0,99953.10135,2.054054054,0.013513514,99999.31757,0.999506154,2.30435E-05,2.89857E-07,0,0.027027027,20,15
D:0| T0: 0.10| T1: 20.00| R0: 0.0| R1: 0.0| WTP: 0,0,0.096153846,20,0,0,0,0,0,-2464633107,1877569084,12472.22512,1841021851,184102185.1,2,92240,3891,1404,2072,668,1404,92240,668,2072,137.4502762,3.737569061,5.541436464,43596.83702,816.3618785,9.395027624,98790.38398,0.42366426,0.008459919,9.95172E-05,0.322393822,0.02246314,51,20
D:0| T0: 0.10| T1: 20.00| R0: 0.0| R1: 0.0| WTP: 0,0,0.096153846,20,0,0,0,0,0,-2377152004,1726322189,10872.29583,1833537213,183353721.3,2,84684,3681,1344,1806,462,1344,84684,462,1806,91.74245473,2.55331992,3.452716298,36443.00402,578.3360161,6.152917505,98682.88129,0.360531158,0.005895908,6.46311E-05,0.255813953,0.021326343,71,20
D:0| T0: 0.10| T1: 20.00| R0: 0.0| R1: 0.0| WTP: 0,0,0.096153846,20,0,0,0,0,0,-2428144007,307848836,11792.7246,1838507777,183850777.7,2,92999,3918,1271,1959,688,1271,92999,688,1959,150.9688474,3.803738318,5.92834891,54421.01246,1017.623053,9.869158879,99117.71028,0.546310098,0.010241848,0.000101225,0.351199592,0.021064743,46,20
D:0| T0: 0.10| T1: 20.00| R0: 0.0| R1: 0.0| WTP: 0,0,0.096153846,20,0,0,0,0,0,-2252704916,1154000220,8622.134929,1821598170,182159817,2,70493,3203,573,1432,859,573,70493,859,1432,213.7567568,2.978378378,7.589189189,45278.82162,991.427027,10.7027027,98967.50811,0.457113026,0.009926297,0.000108592,0.599860335,0.020314074,27,20
D:0| T0: 0.10| T1: 20.00| R0: 0.0| R1: 0.0| WTP: 0,0,0.096153846,20,0,0,0,0,0,-1052833485,2028661055,18.05783785,1051930593,105193059.3,1,112,6,3,3,0,3,112,0,3,0.629310345,0.017241379,0.017241379,99925.72414,5.24137931,0.043103448,99998.93103,0.999270844,5.44448E-05,5.12824E-07,0,0.026785714,17,12
D:0| T0: 0.10| T1: 20.00| R0: 0.0| R1: 0.0| WTP: 0,0,0.096153846,20,0,0,0,0,0,-2431526988,1629114640,11728.58948,1845097513,184509751.3,2,95596,4251,767,1948,1181,767,95596,1181,1948,145.5150685,1.980821918,5.189041096,64279.78082,1616.953425,7.293150685,99343.91781,0.643088357,0.016277603,7.49008E-05,0.606262834,0.020377422,53,20
D:0| T0: 0.10| T1: 20.00| R0: 0.0| R1: 0.0| WTP: 0,0,0.096153846,20,0,0,0,0,0,-2440753276,1439048174,12015.52163,1839977195,183997719.5,2,89925,3928,1550,1996,446,1550,89925,446,1996,131.7580645,4.02688172,5.185483871,42105.65054,1025.38172,9.330645161,98766.64785,0.420029412,0.010414718,9.68274E-05,0.223446894,0.022196275,53,20
D:0| T0: 0.10| T1: 20.00| R0: 0.0| R1: 0.0| WTP: 0,0,0.096153846,20,0,0,0,0,0,-2341808129,865227006,10387.96343,1822409958,182240995.8,2,77049,3206,516,1726,1210,516,77049,1210,1726,192.7427184,2.432038835,8.266990291,47539.26699,1004.548544,10.77669903,98903.93689,0.397248879,0.011652111,0.000126356,0.701042874,0.022401329,26,20
D:0| T0: 0.10| T1: 20.00| R0: 0.0| R1: 0.0| WTP: 0,0,0.096153846,20,0,0,0,0,0,-2455079379,890479738,12179.49629,1846104564,184610456.4,2,95505,4312,1201,2023,822,1201,95505,822,2023,163.3969231,3.553846154,6.058461538,55880.42769,2110.710769,9.744615385,99163.06154,0.55994008,0.02124893,9.98464E-05,0.406327237,0.021182137,47,20
D:0| T0: 0.10| T1: 20.00| R0: 0.0| R1: 0.0| WTP: 0,0,0.096153846,20,0,0,0,0,0,-527585116.1,1017049163,30.08270044,526080981,52608098.1,1,206,7,5,5,0,5,206,0,5,1.415584416,0,0,99874.22078,8.922077922,0.077922078,99997.54545,0.998771236,9.08995E-05,1.28208E-06,0,0.024271845,11,6
D:0| T0: 0.10| T1: 20.00| R0: 0.0| R1: 0.0| WTP: 0,0,0.096153846,20,0,0,0,0,0,-525937956.2,1707305064,0.011604396,525937375.9,52593737.59,1,42,2,0,0,0,0,42,0,0,0.258823529,0,0,99976.75294,2.105882353,0,100000,0.999740263,2.59211E-05,0,0,0,11,6
D:0| T0: 0.10| T1: 20.00| R0: 0.0| R1: 0.0| WTP: 0,0,0.096153846,20,0,0,0,0,0,-2139519155,400145663,9835.667205,1647735795,164773579.5,1,73632,3191,470,1634,1164,470,73632,1164,1634,251.75,2.86875,10.1,43556.6625,1234.725,13.04375,98834.25,0.440080531,0.01236459,0.000131774,0.712362301,0.022191439,23,18
D:0| T0: 0.10| T1: 20.00| R0: 0.0| R1: 0.0| WTP: 0,0,0.096153846,20,0,0,0,0,0,-525941393.5,1662654181,0.012131868,525940786.9,52594078.69,1,82,5,0,0,0,0,82,0,0,0.319444444,0,0,99949.04167,4.236111111,0,100000,0.999493151,4.41096E-05,0,0,0,11,6
D:0| T0: 0.10| T1: 20.00| R0: 0.0| R1: 0.0| WTP: 0,0,0.096153846,20,0,0,0,0,0,-2406169017,182136456,11277.44197,1842296919,184229691.9,2,94899,4141,1172,1873,701,1172,94899,701,1873,147.8434783,3.272463768,5.255072464,47344.51884,950.9768116,8.637681159,99008.9971,0.468590294,0.009711702,9.01101E-05,0.374265884,0.019736773,49,20
D:0| T0: 0.10| T1: 20.00| R0: 0.0| R1: 0.0| WTP: 0,0,0.096153846,20,0,0,0,0,0,-526250066.5,979575387,6.020337891,525949049.6,52594904.96,1,39,2,1,1,0,1,39,0,1,0.397260274,0,0,99973.34247,3.178082192,0.01369863,99999.63014,0.999739188,3.32433E-05,2.7027E-07,0,0.025641026,11,6
D:0| T0: 0.10| T1: 20.00| R0: 0.0| R1: 0.0| WTP: 0,0,0.096153846,20,0,0,0,0,0,-2482912068,2142525414,12832.59612,1841282262,184128226.2,2,94094,3989,1353,2132,779,1353,94094,779,2132,151.0757576,3.945454545,6.281818182,56570.88788,1114.075758,10.37575758,99092.49091,0.549691663,0.011683316,0.000110683,0.365384615,0.022658434,46,20
D:0| T0: 0.10| T1: 20.00| R0: 0.0| R1: 0.0| WTP: 0,0,0.096153846,20,0,0,0,0,0,-2456846281,1464057597,12351.2741,1839282576,183928257.6,2,93828,3975,817,2052,1235,817,93828,1235,2052,158.1987179,2.448717949,6.368589744,65370.28526,1123.769231,8.993589744,99321.82051,0.653108961,0.011349271,9.28763E-05,0.601851852,0.021870037,45,20
D:0| T0: 0.10| T1: 20.00| R0: 0.0| R1: 0.0| WTP: 0,0,0.096153846,20,0,0,0,0,0,-2399488597,364562610,11228.19806,1838078694,183807869.4,2,86357,3844,1559,1865,306,1559,86357,306,1865,127.0793651,3.96031746,4.735449735,48930.74339,767.9920635,8.857142857,98946.27249,0.485780468,0.007835976,9.23929E-05,0.164075067,0.021596396,54,20
D:0| T0: 0.10| T1: 20.00| R0: 0.0| R1: 0.0| WTP: 0,0,0.096153846,20,0,0,0,0,0,-2437042483,40350784,11961.08372,1838988297,183898829.7,2,90778,3922,1395,1987,592,1395,90778,592,1987,142.4662757,3.941348974,5.651026393,52569.58944,1026.234604,9.741935484,99031.88563,0.527847924,0.010333245,9.98134E-05,0.297936588,0.021888563,49,20
D:0| T0: 0.10| T1: 20.00| R0: 0.0| R1: 0.0| WTP: 0,0,0.096153846,20,0,0,0,0,0,-2384750830,804064356,10773.98545,1846051557,184605155.7,2,95937,4345,654,1789,1135,654,95937,1135,1789,152.6666667,1.714689266,4.889830508,62325.70904,783.6440678,6.737288136,99347.80791,0.609555098,0.008180621,7.20447E-05,0.634432644,0.018647654,49,20
D:0| T0: 0.10| T1: 20.00| R0: 0.0| R1: 0.0| WTP: 0,0,0.096153846,20,0,0,0,0,0,-1591445843,2125493986,246.6775898,1579111963,157911196.3,1,1624,65,41,41,0,41,1624,0,41,4.919753086,0.148148148,0.148148148,98779.08642,31.29012346,0.388888889,99971.61111,0.988023329,0.000315492,5.06271E-06,0,0.025246305,23,18
D:0| T0: 0.10| T1: 20.00| R0: 0.0| R1: 0.0| WTP: 0,0,0.096153846,20,0,0,0,0,0,-2353049325,23154253,10173.03261,1844397695,184439769.5,2,89111,4156,910,1689,779,910,89111,779,1689,153.8546512,2.476744186,4.709302326,62311.73837,692.630814,7.345930233,99339.74128,0.614432119,0.007149655,7.79686E-05,0.461219657,0.018953889,48,20
D:0| T0: 0.10| T1: 20.00| R0: 0.0| R1: 0.0| WTP: 0,0,0.096153846,20,0,0,0,0,0,-1142623034,1391367689,54.19463992,1139913302,113991330.2,1,338,17,9,9,0,9,338,0,9,2.113636364,0.007575758,0.007575758,99793.95455,9.575757576,0.068181818,99995.55303,0.99782669,0.000104557,1.46347E-06,0,0.026627219,18,13
D:0| T0: 0.10| T1: 20.00| R0: 0.0| R1: 0.0| WTP: 0,0,0.096153846,20,0,0,0,0,0,-2432635563,574142276,11858.93977,1839688574,183968857.4,2,90917,3961,706,1970,1264,706,90917,1264,1970,133.6058981,1.793565684,5.142091153,69078.36729,1121.892761,7.045576408,99386.93834,0.687880765,0.01141742,7.30321E-05,0.641624365,0.021668115,53,20
D:0| T0: 0.10| T1: 20.00| R0: 0.0| R1: 0.0| WTP: 0,0,0.096153846,20,0,0,0,0,0,-789165407.6,898736779,6.008733495,788864970.9,78886497.09,1,24,2,1,1,0,1,24,0,1,0.061946903,0,0,99986.50442,1.566371681,0.017699115,99999.30088,0.999855611,1.85716E-05,2.04082E-07,0,0.041666667,14,9
D:0| T0: 0.10| T1: 20.00| R0: 0.0| R1: 0.0| WTP: 0,0,0.096153846,20,0,0,0,0,0,-2371103261,346473503,10373.68128,1852419197,185241919.7,2,97323,4693,636,1722,1086,636,97323,1086,1722,141.5439024,1.46097561,4.07804878,69009.0439,1350.12439,5.626829268,99505.92195,0.624168571,0.016459468,7.01445E-05,0.630662021,0.017693659,49,20
D:0| T0: 0.10| T1: 20.00| R0: 0.0| R1: 0.0| WTP: 0,0,0.096153846,20,0,0,0,0,0,-2438405479,445552282,11890.30895,1843890032,184389003.2,2,94825,4264,717,1975,1258,717,94825,1258,1975,126.4806763,1.632850242,4.640096618,71076.68116,1314.905797,6.367149758,99451.67633,0.668583771,0.015180849,7.5095E-05,0.636962025,0.020827841,51,20
D:0| T0: 0.10| T1: 20.00| R0: 0.0| R1: 0.0| WTP: 0,0,0.096153846,20,0,0,0,0,0,-2011827938,911758476,8977.866356,1562934620,156293462,1,73322,3308,588,1491,903,588,73322,903,1491,232.6961326,3.132596685,8.071823204,54995.9779,1135.596685,11.35359116,99165.98895,0.475027389,0.013352622,0.000135158,0.605633803,0.020334961,22,17
D:0| T0: 0.10| T1: 20.00| R0: 0.0| R1: 0.0| WTP: 0,0,0.096153846,20,0,0,0,0,0,-2392177604,1464197940,10995.41348,1842406930,184240693,2,89816,4034,1610,1826,216,1610,89816,216,1826,136.2930108,4.147849462,4.704301075,42275.39516,1406.814516,9.040322581,98881.56452,0.425775826,0.014161402,9.29752E-05,0.118291347,0.020330453,54,20
D:0| T0: 0.10| T1: 20.00| R0: 0.0| R1: 0.0| WTP: 0,0,0.096153846,20,0,0,0,0,0,-1758533051,500405854,96.31062054,1753717520,175371752,2,816,37,16,16,0,16,816,0,16,2.163265306,0.015306122,0.015306122,99426.65306,17.65816327,0.102040816,99990.05612,0.994010781,0.000188878,1.72986E-06,0,0.019607843,27,20
D:0| T0: 0.10| T1: 20.00| R0: 0.0| R1: 0.0| WTP: 0,0,0.096153846,20,0,0,0,0,0,-2507286095,772037341,13318.79274,1841346458,184134645.8,2,96023,4067,762,2213,1451,762,96023,1451,2213,151.5105105,2.147147147,6.483483483,61074.90691,942.1741742,8.774774775,99159.86787,0.611900875,0.009493455,8.99951E-05,0.655671035,0.023046562,48,20
D:0| T0: 0.10| T1: 20.00| R0: 0.0| R1: 0.0| WTP: 0,0,0.096153846,20,0,0,0,0,0,-614302229.6,1543158763,12.0575549,613699351.8,61369935.18,1,88,7,2,2,0,2,88,0,2,0.957446809,0,0,99948.54255,4.223404255,0.021276596,99999.11702,0.999429028,4.89161E-05,4.8193E-07,0,0.022988506,12,7
D:0| T0: 0.10| T1: 20.00| R0: 0.0| R1: 0.0| WTP: 0,0,0.096153846,20,0,0,0,0,0,-2477025091,1604932531,12724.2859,1840810796,184081079.6,2,93562,3950,1189,2114,925,1189,93562,925,2114,132.0477454,3.039787798,5.456233422,43840.80902,731.5941645,8.607427056,98767.07692,0.417322346,0.007701195,9.22275E-05,0.43755913,0.022594643,52,20
D:0| T0: 0.10| T1: 20.00| R0: 0.0| R1: 0.0| WTP: 0,0,0.096153846,20,0,0,0,0,0,-2462532558,539051477,12311.92506,1846936305,184693630.5,2,95966,4246,1266,2045,779,1266,95966,779,2045,149.2367688,3.38718663,5.515320334,57685.19499,1528.169916,9.038997214,99176.02507,0.53829515,0.016843238,0.000101604,0.380929095,0.02130963,47,20
D:0| T0: 0.10| T1: 20.00| R0: 0.0| R1: 0.0| WTP: 0,0,0.096153846,20,0,0,0,0,0,-351017927.4,1743124675,6.041964265,350715829.2,35071582.92,1,67,6,1,1,0,1,67,0,1,1.044776119,0,0,99964.02985,3.119402985,0.014925373,99999.62687,0.999618251,3.49208E-05,3.1746E-07,0,0.015151515,9,4
D:0| T0: 0.10| T1: 20.00| R0: 0.0| R1: 0.0| WTP: 0,0,0.096153846,20,0,0,0,0,0,-2441163403,1965983789,12050.83263,1838621771,183862177.1,2,89817,3891,853,2002,1149,853,89817,1149,2002,119.7139364,1.997555012,4.772616137,66677.04401,1284.347188,6.865525672,99323.8044,0.662510942,0.013129224,7.13753E-05,0.573926074,0.022289767,58,20
D:0| T0: 0.10| T1: 20.00| R0: 0.0| R1: 0.0| WTP: 0,0,0.096153846,20,0,0,0,0,0,-1317483978,516774280,48.14581302,1315076687,131507668.7,1,422,13,8,8,0,8,422,0,8,1.315068493,0.01369863,0.01369863,99708.17123,17.60273973,0.054794521,99995.21918,0.997096431,0.000179454,1.10349E-06,0,0.018957346,20,15
D:0| T0: 0.10| T1: 20.00| R0: 0.0| R1: 0.0| WTP: 0,0,0.096153846,20,0,0,0,0,0,-2178897392,86603142,10427.39956,1657527414,165752741.4,1,82662,3563,504,1732,1228,504,82662,1228,1732,273.1005917,2.917159763,10.14792899,41358.82249,1269.260355,13.13017751,98857.53254,0.376476684,0.013599575,0.000141862,0.709006928,0.020952796,23,18
D:0| T0: 0.10| T1: 20.00| R0: 0.0| R1: 0.0| WTP: 0,0,0.096153846,20,0,0,0,0,0,-1052438462,1431870609,12.02063183,1051837430,105183743,1,103,3,2,2,0,2,103,0,2,0.175438596,0,0,99929.74561,5.99122807,0.01754386,99998.69298,0.999313467,6.16529E-05,3.47828E-07,0,0.019417476,17,12
D:0| T0: 0.10| T1: 20.00| R0: 0.0| R1: 0.0| WTP: 0,0,0.096153846,20,0,0,0,0,0,-2409591363,1592383984,11296.08194,1844787265,184478726.5,2,91198,4125,681,1876,1195,681,91198,1195,1876,151.96,1.797142857,5.182857143,64457.52857,759.6971429,7.145714286,99317.19714,0.642225259,0.007711374,7.41483E-05,0.636993603,0.020570627,50,20
D:0| T0: 0.10| T1: 20.00| R0: 0.0| R1: 0.0| WTP: 0,0,0.096153846,20,0,0,0,0,0,-2362219413,1440183867,10512.73708,1836582559,183658255.9,2,89848,3901,749,1746,997,749,89848,997,1746,120.9572864,1.798994975,4.271356784,68399.8191,1091.540201,6.153266332,99433.21106,0.684500596,0.010981901,6.30731E-05,0.571019473,0.01943282,57,20
D:0| T0: 0.10| T1: 20.00| R0: 0.0| R1: 0.0| WTP: 0,0,0.096153846,20,0,0,0,0,0,-1228510203,1696510588,24.08557134,1227305925,122730592.5,1,185,7,4,4,0,4,185,0,4,0.939393939,0,0,99886.80303,6.424242424,0.03030303,99998.94697,0.998873696,6.65158E-05,6.0607E-07,0,0.016304348,19,14
D:0| T0: 0.10| T1: 20.00| R0: 0.0| R1: 0.0| WTP: 0,0,0.096153846,20,0,0,0,0,0,-2486660950,895039877,12798.20773,1846750563,184675056.3,2,96680,4221,1043,2126,1083,1043,96680,1083,2126,146.0871935,2.70027248,5.613079019,54092.73569,1386.509537,8.471389646,99066.92098,0.524129837,0.014521264,9.04081E-05,0.509407338,0.02199007,51,20
D:0| T0: 0.10| T1: 20.00| R0: 0.0| R1: 0.0| WTP: 0,0,0.096153846,20,0,0,0,0,0,-2462546470,129565953,12465.42282,1839275329,183927532.9,2,91777,3959,894,2071,1177,894,91777,1177,2071,119.729927,2.080291971,4.917274939,68108.88808,1583.742092,7.107055961,99357.53285,0.680065636,0.016033888,7.30675E-05,0.568324481,0.022565567,58,20
D:0| T0: 0.10| T1: 20.00| R0: 0.0| R1: 0.0| WTP: 0,0,0.096153846,20,0,0,0,0,0,-614205817.2,1902565669,12.02590655,613604521.8,61360452.18,1,159,7,2,2,0,2,159,0,2,0.337078652,0,0,99909.01124,6.584269663,0.02247191,99999.30337,0.999048342,7.11768E-05,4.70591E-07,0,0.012578616,12,7
D:0| T0: 0.10| T1: 20.00| R0: 0.0| R1: 0.0| WTP: 0,0,0.096153846,20,0,0,0,0,0,-1491498301,1984179288,24.09664827,1490293468,149029346.8,1,236,13,4,4,0,4,236,0,4,0.852941176,0,0,99849.64118,10.67058824,0.023529412,99997.91176,0.998310015,0.000121613,5.36921E-07,0,0.016949153,22,17
D:0| T0: 0.10| T1: 20.00| R0: 0.0| R1: 0.0| WTP: 0,0,0.096153846,20,0,0,0,0,0,-2459880026,677377223,12299.16823,1844921614,184492161.4,2,95036,4102,1024,2043,1019,1024,95036,1019,2043,152.5855072,2.811594203,5.733333333,60602.49855,2246.602899,8.698550725,99239.55942,0.606822723,0.022625549,8.95186E-05,0.498776309,0.021497117,49,20
D:0| T0: 0.10| T1: 20.00| R0: 0.0| R1: 0.0| WTP: 0,0,0.096153846,20,0,0,0,0,0,-2432797010,973583301,11717.19907,1846937056,184693705.6,2,95809,4305,800,1946,1146,800,95809,1146,1946,134.8507463,1.895522388,4.711442786,55290.02488,1941.121891,6.706467662,99162.42537,0.551209019,0.019643383,6.91371E-05,0.588900308,0.020311244,58,20
D:0| T0: 0.10| T1: 20.00| R0: 0.0| R1: 0.0| WTP: 0,0,0.096153846,20,0,0,0,0,0,-2361315408,781062938,10311.51126,1845739845,184573984.5,2,91748,4327,723,1712,989,723,91748,989,1712,145.1563342,1.857142857,4.482479784,69942.88679,1139.22372,6.433962264,99493.15364,0.699684178,0.01145646,6.60118E-05,0.577686916,0.018659807,53,20
D:0| T0: 0.10| T1: 20.00| R0: 0.0| R1: 0.0| WTP: 0,0,0.096153846,20,0,0,0,0,0,-2407075066,338783425,11153.51612,1849399259,184939925.9,2,95158,4323,803,1852,1049,803,95158,1049,1852,138.3242574,1.900990099,4.457920792,64754.99505,1917.341584,6.445544554,99384.38366,0.640666831,0.019688799,6.74948E-05,0.566414687,0.019462368,57,20
D:0| T0: 0.10| T1: 24.00| R0: 0.0| R1: 0.0| WTP: 0,0,0.096153846,24,0,0,0,0,0,-2750397948,650073325,11056.59483,2197568206,219756820.6,2,93048,4361,743,1836,1093,743,93048,1093,1836,98.76950998,1.301270417,3.257713249,75391.07985,1078.969147,4.613430127,99559.2196,0.678979922,0.014172892,6.15284E-05,0.595315904,0.019731751,61,24
D:0| T0: 0.10| T1: 24.00| R0: 0.0| R1: 0.0| WTP: 0,0,0.096153846,24,0,0,0,0,0,-2783835952,2029998696,11776.60327,2195005789,219500578.9,2,94756,4152,1241,1956,715,1241,94756,715,1956,148.21875,3.355113636,5.349431818,57248.03409,907.8778409,8.877840909,99179.17898,0.56233223,0.009407277,9.40534E-05,0.365541922,0.020642492,49,24
D:0| T0: 0.10| T1: 24.00| R0: 0.0| R1: 0.0| WTP: 0,0,0.096153846,24,0,0,0,0,0,-2811787362,776062361,12500.81828,2186746448,218674644.8,2,88559,3681,1803,2077,274,1803,88559,274,2077,99.79741379,3.730603448,4.30387931,48613.75862,1187.260776,8.191810345,98860.60776,0.459875657,0.012650808,8.91116E-05,0.13192104,0.023453291,62,24
D:0| T0: 0.10| T1: 24.00| R0: 0.0| R1: 0.0| WTP: 0,0,0.096153846,24,0,0,0,0,0,-790143259.7,1813046880,24.0502197,788940748.7,78894074.87,1,100,3,4,4,0,4,100,0,4,0.505154639,0.020618557,0.020618557,99933.56701,5.783505155,0.06185567,99997.71134,0.999361715,5.9491E-05,8.16337E-07,0,0.04,14,9
D:0| T0: 0.10| T1: 24.00| R0: 0.0| R1: 0.0| WTP: 0,0,0.096153846,24,0,0,0,0,0,-969116302.8,2032407216,84.31581289,964900512.2,96490051.22,1,779,40,14,14,0,14,779,0,14,3.552845528,0.056910569,0.056910569,99539.73171,21.43902439,0.162601626,99992.72358,0.994948703,0.000239204,2.52268E-06,0,0.018018018,16,11
D:0| T0: 0.10| T1: 24.00| R0: 0.0| R1: 0.0| WTP: 0,0,0.096153846,24,0,0,0,0,0,-613612900.2,1507873352,0.019516484,613611924.4,61361192.44,1,20,3,0,0,0,0,20,0,0,0.359223301,0,0,99989.39806,1.747572816,0,100000,0.999877209,2.0814E-05,0,0,0,12,7
D:0| T0: 0.10| T1: 24.00| R0: 0.0| R1: 0.0| WTP: 0,0,0.096153846,24,0,0,0,0,0,-613940692.7,1855899401,6.032997232,613639042.8,61363904.28,1,115,5,1,1,0,1,115,0,1,0.6625,0,0,99925.2875,4.475,0.0125,99999.425,0.999253494,4.67503E-05,0.00000025,0,0.008695652,12,7
D:0| T0: 0.10| T1: 24.00| R0: 0.0| R1: 0.0| WTP: 0,0,0.096153846,24,0,0,0,0,0,-2800437733,1819459251,12242.63195,2188306136,218830613.6,2,92802,3861,737,2034,1297,737,92802,1297,2034,131.5609756,1.826558266,5.311653117,66442.28726,900.3468835,7.33604336,99314.23306,0.665261918,0.009067864,7.56229E-05,0.637659784,0.021917631,53,24
D:0| T0: 0.10| T1: 24.00| R0: 0.0| R1: 0.0| WTP: 0,0,0.096153846,24,0,0,0,0,0,-350960853.1,909791748,6.024030199,350659651.6,35065965.16,1,60,2,1,1,0,1,60,0,1,0.590163934,0,0,99965.06557,2.770491803,0.016393443,99999.70492,0.999655805,3.03226E-05,3.22581E-07,0,0.016949153,9,4
D:0| T0: 0.10| T1: 24.00| R0: 0.0| R1: 0.0| WTP: 0,0,0.096153846,24,0,0,0,0,0,-2818627286,1339092841,12656.23302,2185815634,218581563.4,2,87573,3707,814,2103,1289,814,87573,1289,2103,125.5898123,2.008042895,5.436997319,71831.89276,837.8016086,7.624664879,99376.50134,0.719272966,0.008440555,7.87984E-05,0.612933904,0.024014251,54,24
D:0| T0: 0.10| T1: 24.00| R0: 0.0| R1: 0.0| WTP: 0,0,0.096153846,24,0,0,0,0,0,-2815440581,1365866345,12395.29102,2195676030,219567603,2,97401,4193,1046,2059,1013,1046,97401,1013,2059,127.2173913,2.376811594,4.809178744,60716.67391,737.8164251,7.347826087,99202.91063,0.555273833,0.008454305,8.58744E-05,0.491986401,0.021139413,52,24
D:0| T0: 0.10| T1: 24.00| R0: 0.0| R1: 0.0| WTP: 0,0,0.096153846,24,0,0,0,0,0,-2764143874,825453433,11385.98384,2194844681,219484468.1,2,93694,4218,704,1891,1187,704,93694,1187,1891,133.8299492,1.69035533,4.672588832,66323.48223,1209.601523,6.449238579,99381.29695,0.663587129,0.012175704,6.63058E-05,0.627710206,0.020182722,57,24
D:0| T0: 0.10| T1: 24.00| R0: 0.0| R1: 0.0| WTP: 0,0,0.096153846,24,0,0,0,0,0,-2794576021,939711378,11986.88445,2195231799,219523179.9,2,95736,4162,1284,1991,707,1284,95736,707,1991,147.4745763,3.457627119,5.429378531,51494.37006,1067.689266,9.056497175,99049.01695,0.517493045,0.010752759,9.31091E-05,0.355097941,0.020796774,51,24
D:0| T0: 0.10| T1: 24.00| R0: 0.0| R1: 0.0| WTP: 0,0,0.096153846,24,0,0,0,0,0,-2747826107,638950699,11038.07065,2195922575,219592257.5,2,92983,4194,788,1833,1045,788,92983,1045,1833,125.6564706,1.762352941,4.188235294,68838.74353,1386.04,6.051764706,99445.08471,0.688684275,0.013951455,6.2086E-05,0.570103655,0.019713281,61,24
D:0| T0: 0.10| T1: 24.00| R0: 0.0| R1: 0.0| WTP: 0,0,0.096153846,24,0,0,0,0,0,-1141838461,938699148,42.12651908,1139732135,113973213.5,1,448,21,7,7,0,7,448,0,7,1.104895105,0.027972028,0.027972028,99750.46154,10.41958042,0.083916084,99996.03497,0.997085929,0.000124468,1.15705E-06,0,0.015625,18,13
D:0| T0: 0.10| T1: 24.00| R0: 0.0| R1: 0.0| WTP: 0,0,0.096153846,24,0,0,0,0,0,-1608662468,1412065496,524.0343361,1582460751,158246075.1,1,4166,192,87,87,0,87,4166,0,87,11.96566524,0.296137339,0.296137339,97987.71245,52.7167382,0.665236052,99961.07725,0.971141792,0.000765818,1.08795E-05,0,0.020888355,23,18
D:0| T0: 0.10| T1: 24.00| R0: 0.0| R1: 0.0| WTP: 0,0,0.096153846,24,0,0,0,0,0,-2795255033,1331335240,11987.25389,2195892339,219589233.9,2,92575,4066,1589,1991,402,1589,92575,402,1991,127.8484108,3.748166259,4.699266504,51484.28117,1487.997555,8.572127139,99027.27139,0.501019009,0.015482035,9.10473E-05,0.201908589,0.021506886,57,24
D:0| T0: 0.10| T1: 24.00| R0: 0.0| R1: 0.0| WTP: 0,0,0.096153846,24,0,0,0,0,0,-2256898098,470935411,10400.72688,1736861754,173686175.4,1,76553,3241,665,1728,1063,665,76553,1063,1728,218.4385027,3.470588235,9.080213904,51483.99465,1060.395722,12.61497326,98995.65241,0.457515785,0.011972692,0.000144568,0.615162037,0.022572892,24,19
D:0| T0: 0.10| T1: 24.00| R0: 0.0| R1: 0.0| WTP: 0,0,0.096153846,24,0,0,0,0,0,-1580920072,823434397,60.11843935,1577914150,157791415,1,521,14,10,10,0,10,521,0,10,0.73125,0.01875,0.01875,99655.375,15.425,0.075,99994.88125,0.996611501,0.00015603,1.24229E-06,0,0.019230769,23,18
D:0| T0: 0.10| T1: 24.00| R0: 0.0| R1: 0.0| WTP: 0,0,0.096153846,24,0,0,0,0,0,-525966716.9,493045351,0.020043956,525965714.7,52596571.47,1,140,7,0,0,0,0,140,0,0,0.493506494,0,0,99918.5974,4.74025974,0,100000,0.999168158,5.05263E-05,0,0,0,11,6
D:0| T0: 0.10| T1: 24.00| R0: 0.0| R1: 0.0| WTP: 0,0,0.096153846,24,0,0,0,0,0,-1666457118,1700216563,18.07842027,1665553197,166555319.7,1,285,12,3,3,0,3,285,0,3,0.727272727,0,0,99812.71515,8.690909091,0.018181818,99998.15152,0.998150074,8.88566E-05,3.61449E-07,0,0.01056338,24,19
D:0| T0: 0.10| T1: 24.00| R0: 0.0| R1: 0.0| WTP: 0,0,0.096153846,24,0,0,0,0,0,-1325431175,1744119059,180.6954829,1316396400,131639640,1,1555,78,30,30,0,30,1555,0,30,6.927536232,0.137681159,0.137681159,98907.02899,29.65217391,0.34057971,99980.17391,0.989289112,0.000296518,4.31714E-06,0,0.019292605,20,15
D:0| T0: 0.10| T1: 24.00| R0: 0.0| R1: 0.0| WTP: 0,0,0.096153846,24,0,0,0,0,0,-701896219.8,2036906360,12.03909336,701294265.1,70129426.51,1,90,7,2,2,0,2,90,0,2,0.5,0,0,99953.46364,5.272727273,0.018181818,99998.94545,0.999462571,6.35494E-05,4.3011E-07,0,0.022222222,13,8
D:0| T0: 0.10| T1: 24.00| R0: 0.0| R1: 0.0| WTP: 0,0,0.096153846,24,0,0,0,0,0,-2753075013,809704121,11234.72053,2191338986,219133898.6,2,90942,4108,739,1866,1127,739,90942,1127,1866,121.7759036,1.701204819,4.38313253,71787.28434,1128.433735,6.178313253,99474.84578,0.716832154,0.011413946,6.35103E-05,0.603965702,0.020518572,58,24
D:0| T0: 0.10| T1: 24.00| R0: 0.0| R1: 0.0| WTP: 0,0,0.096153846,24,0,0,0,0,0,-2811361520,1219866412,12364.46057,2193138492,219313849.2,2,96883,4227,1162,2054,892,1162,96883,892,2054,142.2122905,3.086592179,5.544692737,58328.65642,2219.541899,8.796089385,99199.73464,0.584496032,0.022357276,9.04541E-05,0.434274586,0.02120083,52,24
D:0| T0: 0.10| T1: 24.00| R0: 0.0| R1: 0.0| WTP: 0,0,0.096153846,24,0,0,0,0,0,-527532089.2,843498920,30.06529385,526028824.5,52602882.45,1,89,7,5,5,0,5,89,0,5,1.013333333,0,0,99943.44,5.053333333,0.08,99997.84,0.999459456,5.19746E-05,1.31582E-06,0,0.057471264,11,6
D:0| T0: 0.10| T1: 24.00| R0: 0.0| R1: 0.0| WTP: 0,0,0.096153846,24,0,0,0,0,0,-1056001584,107351963,78.1609805,1052093535,105209353.5,1,429,18,13,13,0,13,429,0,13,1.387931034,0.043103448,0.043103448,99715.08621,23.24137931,0.155172414,99993.66379,0.997198116,0.000234582,2.24151E-06,0,0.03030303,17,12
D:0| T0: 0.10| T1: 24.00| R0: 0.0| R1: 0.0| WTP: 0,0,0.096153846,24,0,0,0,0,0,-1229355149,773789021,42.0817004,1227251064,122725106.4,1,333,12,7,7,0,7,333,0,7,0.622222222,0.007407407,0.007407407,99783.48148,16.42222222,0.059259259,99996.36296,0.997845037,0.000167467,1.04481E-06,0,0.021021021,19,14
D:0| T0: 0.10| T1: 24.00| R0: 0.0| R1: 0.0| WTP: 0,0,0.096153846,24,0,0,0,0,0,-2831394163,850936611,12914.40647,2185673839,218567383.9,2,91307,3728,757,2146,1389,757,91307,1389,2146,105.4469526,1.607223476,4.717832957,68245.307,1091.406321,6.446952596,99311.07449,0.672696711,0.0113624,6.82287E-05,0.647250699,0.023503127,62,24
D:0| T0: 0.10| T1: 24.00| R0: 0.0| R1: 0.0| WTP: 0,0,0.096153846,24,0,0,0,0,0,-2129238062,1701318364,433.6792622,2107554099,210755409.9,2,3844,167,72,72,0,72,3844,0,72,10.58064516,0.230414747,0.230414747,97320.96774,75.29493088,0.562211982,99952.08756,0.972178328,0.00079515,6.99271E-06,0,0.018730489,30,24
D:0| T0: 0.10| T1: 24.00| R0: 0.0| R1: 0.0| WTP: 0,0,0.096153846,24,0,0,0,0,0,-701235203.9,778708269,0.010549451,701234676.5,70123467.65,1,42,2,0,0,0,0,42,0,0,0.224719101,0,0,99973.55056,3.516853933,0,100000,0.99972908,3.7931E-05,0,0,0,13,8
D:0| T0: 0.10| T1: 24.00| R0: 0.0| R1: 0.0| WTP: 0,0,0.096153846,24,0,0,0,0,0,-1149072005,1391938506,174.4410021,1140349954,114034995.4,1,765,35,29,29,0,29,765,0,29,4.184,0.072,0.072,99465.488,22.664,0.328,99983.104,0.994835265,0.000227169,4.60381E-06,0,0.037908497,18,13
D:0| T0: 0.10| T1: 24.00| R0: 0.0| R1: 0.0| WTP: 0,0,0.096153846,24,0,0,0,0,0,-789483172.3,43418681,12.01852194,788882246.2,78888224.62,1,96,6,2,2,0,2,96,0,2,0.173913043,0,0,99939.82609,6.27173913,0.02173913,99998.92391,0.999412034,6.43017E-05,4.3011E-07,0,0.020833333,14,9
D:0| T0: 0.10| T1: 24.00| R0: 0.0| R1: 0.0| WTP: 0,0,0.096153846,24,0,0,0,0,0,-1933022618,817384966,4700.967959,1697974220,169797422,1,35075,1454,502,781,279,502,35075,279,781,109.7559524,2.880952381,4.5,74182.78571,570.8452381,7.494047619,99474.94048,0.741220086,0.005799161,7.75974E-05,0.357234315,0.022266572,24,19
D:0| T0: 0.10| T1: 24.00| R0: 0.0| R1: 0.0| WTP: 0,0,0.096153846,24,0,0,0,0,0,-2060199363,762053968,2270.112325,1946693747,194669374.7,1,18589,805,352,377,25,352,18589,25,377,54.70157068,1.680628272,1.806282723,86422.54974,305.2356021,3.638743455,99746.60209,0.865141197,0.003076137,3.84398E-05,0.066312997,0.020280811,27,22
D:0| T0: 0.10| T1: 24.00| R0: 0.0| R1: 0.0| WTP: 0,0,0.096153846,24,0,0,0,0,0,-2022117363,1692506311,114.2434419,2016405191,201640519.1,1,554,21,19,19,0,19,554,0,19,1.185185185,0.027777778,0.027777778,99635.78241,17.24537037,0.115740741,99988.91667,0.996212583,0.000186105,1.88135E-06,0,0.03442029,28,23
D:0| T0: 0.10| T1: 24.00| R0: 0.0| R1: 0.0| WTP: 0,0,0.096153846,24,0,0,0,0,0,-2529871727,883828863,8869.02478,2086420488,208642048.8,1,72399,3225,693,1473,780,693,72399,780,1473,127.8454259,2.129337539,4.545741325,68328.85174,597.7917981,6.738170347,99401.89905,0.481055828,0.00987943,0.000113073,0.529531568,0.020345866,28,23
D:0| T0: 0.10| T1: 24.00| R0: 0.0| R1: 0.0| WTP: 0,0,0.096153846,24,0,0,0,0,0,-879289142.1,301400999,48.16217016,876881033.6,87688103.36,1,430,19,8,8,0,8,430,0,8,2.203883495,0.009708738,0.009708738,99719.3301,17.98058252,0.077669903,99996.08738,0.997240136,0.000180391,1.53851E-06,0,0.01627907,15,10
D:0| T0: 0.10| T1: 24.00| R0: 0.0| R1: 0.0| WTP: 0,0,0.096153846,24,0,0,0,0,0,-2793626058,1868336855,11956.83359,2195784378,219578437.8,2,96299,4260,830,1986,1156,830,96299,1156,1986,143.8075881,2.097560976,5.195121951,60993.4336,1021.140921,7.436314363,99246.39295,0.610709361,0.010284236,7.68239E-05,0.582074522,0.020623267,53,24
D:0| T0: 0.10| T1: 24.00| R0: 0.0| R1: 0.0| WTP: 0,0,0.096153846,24,0,0,0,0,0,-2838386747,1868498144,12898.95038,2193439228,219343922.8,2,95151,4077,895,2143,1248,895,95151,1248,2143,143.1002786,2.311977716,5.760445682,63583.11142,1102.534819,8.267409471,99243.86908,0.636754497,0.011110267,8.52535E-05,0.582361176,0.022522096,52,24
D:0| T0: 0.10| T1: 24.00| R0: 0.0| R1: 0.0| WTP: 0,0,0.096153846,24,0,0,0,0,0,-1316208864,2101566889,24.10086805,1315003820,131500382,1,197,10,4,4,0,4,197,0,4,1.092857143,0,0,99871.20714,8.478571429,0.028571429,99998.49286,0.998730896,8.63841E-05,5.67384E-07,0,0.020304569,20,15
D:0| T0: 0.10| T1: 24.00| R0: 0.0| R1: 0.0| WTP: 0,0,0.096153846,24,0,0,0,0,0,-2506479601,1665097450,8601.545333,2076402335,207640233.5,1,65856,2797,727,1429,702,727,65856,702,1429,150.0829694,3.091703057,6.091703057,59978.36681,986.6637555,9.279475983,99187.04803,0.531996643,0.011669175,0.000111386,0.491252624,0.021699188,28,23
D:0| T0: 0.10| T1: 24.00| R0: 0.0| R1: 0.0| WTP: 0,0,0.096153846,24,0,0,0,0,0,-2705133223,1716179948,10280.05016,2191130715,219113071.5,2,89403,4093,1416,1707,291,1416,89403,291,1707,112.3873874,3.031531532,3.655405405,37928.28829,691.3490991,6.858108108,98869.68243,0.382579831,0.006957289,7.07973E-05,0.170474517,0.019093319,64,24
D:0| T0: 0.10| T1: 24.00| R0: 0.0| R1: 0.0| WTP: 0,0,0.096153846,24,0,0,0,0,0,-968211161.5,1560278715,72.20920854,964600701.1,96460070.11,1,378,20,12,12,0,12,378,0,12,1.911111111,0.044444444,0.044444444,99801.24444,9.266666667,0.140740741,99995.45926,0.997746913,0.000108893,2.05139E-06,0,0.031830239,16,11
D:0| T0: 0.10| T1: 24.00| R0: 0.0| R1: 0.0| WTP: 0,0,0.096153846,24,0,0,0,0,0,-2874330773,991019385,13590.04859,2194828343,219482834.3,2,97259,4173,971,2258,1287,971,97259,1287,2258,147.5880682,2.590909091,6.21875,61016.15625,1643.090909,8.963068182,99182.16477,0.6111001,0.01656051,9.24435E-05,0.569973428,0.02321636,51,24
D:0| T0: 0.10| T1: 24.00| R0: 0.0| R1: 0.0| WTP: 0,0,0.096153846,24,0,0,0,0,0,-2838628596,118052103,12928.56263,2192200464,219220046.4,2,95767,4040,837,2148,1311,837,95767,1311,2148,135.3957219,2.106951872,5.588235294,65657.92246,1292.318182,7.847593583,99304.95989,0.637607728,0.013754196,8.4955E-05,0.610335196,0.022429438,51,24
D:0| T0: 0.10| T1: 24.00| R0: 0.0| R1: 0.0| WTP: 0,0,0.096153846,24,0,0,0,0,0,-2799506659,1209758844,12236.80338,2187666490,218766649,2,88142,3693,1594,2033,439,1594,88142,439,2033,113.6987952,3.684337349,4.710843373,55975.01205,621.2578313,8.530120482,99030.79759,0.533734251,0.00667948,9.39056E-05,0.215937039,0.023065054,56,24
D:0| T0: 0.10| T1: 24.00| R0: 0.0| R1: 0.0| WTP: 0,0,0.096153846,24,0,0,0,0,0,-1052947058,70671723,18.09266202,1052042425,105204242.5,1,127,9,3,3,0,3,127,0,3,1.204918033,0,0,99909.68033,6.418032787,0.024590164,99998.28689,0.999087878,6.70596E-05,5.04207E-07,0,0.023622047,17,12
D:0| T0: 0.10| T1: 24.00| R0: 0.0| R1: 0.0| WTP: 0,0,0.096153846,24,0,0,0,0,0,-1052433031,1722612191,12.01904941,1051832078,105183207.8,1,52,2,2,2,0,2,52,0,2,0.137096774,0,0,99968.91129,2.266129032,0.016129032,99999.69355,0.999688942,2.43903E-05,3.25205E-07,0,0.019230769,17,12
D:0| T0: 0.10| T1: 24.00| R0: 0.0| R1: 0.0| WTP: 0,0,0.096153846,24,0,0,0,0,0,-1315580982,1968291596,12.08340106,1314976812,131497681.2,1,74,4,2,2,0,2,74,0,2,0.939189189,0,0,99953.10135,2.054054054,0.013513514,99999.31757,0.999506154,2.30435E-05,2.89857E-07,0,0.027027027,20,15
D:0| T0: 0.10| T1: 24.00| R0: 0.0| R1: 0.0| WTP: 0,0,0.096153846,24,0,0,0,0,0,-2839852394,1877569084,13011.94161,2189255313,218925531.3,2,92385,3840,1446,2162,716,1446,92385,716,2162,113.4716981,3.285377358,4.929245283,42590.40802,698.2735849,8.33490566,98735.41981,0.415943615,0.007211057,8.79026E-05,0.331174838,0.023402067,60,24
D:0| T0: 0.10| T1: 24.00| R0: 0.0| R1: 0.0| WTP: 0,0,0.096153846,24,0,0,0,0,0,-2731077585,1726322189,10914.72567,2185341302,218534130.2,2,84508,3713,1351,1813,462,1351,84508,462,1813,88.4351145,2.423664122,3.276717557,37491.6126,547.1469466,5.866412214,98699.67939,0.371709831,0.005575108,6.15435E-05,0.254826255,0.02145359,74,24
D:0| T0: 0.10| T1: 24.00| R0: 0.0| R1: 0.0| WTP: 0,0,0.096153846,24,0,0,0,0,0,-2788361819,307848836,11949.45995,2190888822,219088882.2,2,92567,4002,1338,1985,647,1338,92567,647,1985,129.8136483,3.359580052,5.034120735,52506.3727,851.7611549,8.545931759,99055.22572,0.527468169,0.008577478,8.77962E-05,0.325944584,0.021443927,55,24
D:0| T0: 0.10| T1: 24.00| R0: 0.0| R1: 0.0| WTP: 0,0,0.096153846,24,0,0,0,0,0,-2428005378,1154000220,8622.134929,1996898631,199689863.1,1,70493,3203,573,1432,859,573,70493,859,1432,213.7567568,2.978378378,7.589189189,45278.82162,991.427027,10.7027027,98967.50811,0.457113026,0.009926297,0.000108592,0.599860335,0.020314074,27,22
D:0| T0: 0.10| T1: 24.00| R0: 0.0| R1: 0.0| WTP: 0,0,0.096153846,24,0,0,0,0,0,-1052833485,2028661055,18.05783785,1051930593,105193059.3,1,112,6,3,3,0,3,112,0,3,0.629310345,0.017241379,0.017241379,99925.72414,5.24137931,0.043103448,99998.93103,0.999270844,5.44448E-05,5.12824E-07,0,0.026785714,17,12
D:0| T0: 0.10| T1: 24.00| R0: 0.0| R1: 0.0| WTP: 0,0,0.096153846,24,0,0,0,0,0,-2799283361,1629114640,12159.5249,2191307116,219130711.6,2,95491,4182,779,2020,1241,779,95491,1241,2020,130.8776042,1.901041667,5.109375,68906.0026,1544.645833,7.140625,99415.91146,0.689236311,0.015554901,7.34337E-05,0.614660723,0.021143354,55,24
D:0| T0: 0.10| T1: 24.00| R0: 0.0| R1: 0.0| WTP: 0,0,0.096153846,24,0,0,0,0,0,-2789952909,1439048174,12026.88503,2188608658,218860865.8,2,89755,3876,1565,1998,433,1565,89755,433,1998,112.4329412,3.538823529,4.529411765,41847.26824,897.4541176,8.209411765,98747.69647,0.418252324,0.009109958,8.51045E-05,0.216716717,0.022260598,61,24
D:0| T0: 0.10| T1: 24.00| R0: 0.0| R1: 0.0| WTP: 0,0,0.096153846,24,0,0,0,0,0,-2429458360,865227006,10387.96343,1910060189,191006018.9,1,77049,3206,516,1726,1210,516,77049,1210,1726,192.7427184,2.432038835,8.266990291,47539.26699,1004.548544,10.77669903,98903.93689,0.397248879,0.011652111,0.000126356,0.701042874,0.022401329,26,21
D:0| T0: 0.10| T1: 24.00| R0: 0.0| R1: 0.0| WTP: 0,0,0.096153846,24,0,0,0,0,0,-2814803119,890479738,12371.6053,2196222854,219622285.4,2,93919,4215,1419,2055,636,1419,93919,636,2055,146,3.772222222,5.525,56161.35278,1867.488889,9.475,99133.63056,0.563191287,0.018810909,9.71711E-05,0.309489051,0.021880557,52,24
D:0| T0: 0.10| T1: 24.00| R0: 0.0| R1: 0.0| WTP: 0,0,0.096153846,24,0,0,0,0,0,-527585116.1,1017049163,30.08270044,526080981,52608098.1,1,206,7,5,5,0,5,206,0,5,1.415584416,0,0,99874.22078,8.922077922,0.077922078,99997.54545,0.998771236,9.08995E-05,1.28208E-06,0,0.024271845,11,6
D:0| T0: 0.10| T1: 24.00| R0: 0.0| R1: 0.0| WTP: 0,0,0.096153846,24,0,0,0,0,0,-525937956.2,1707305064,0.011604396,525937375.9,52593737.59,1,42,2,0,0,0,0,42,0,0,0.258823529,0,0,99976.75294,2.105882353,0,100000,0.999740263,2.59211E-05,0,0,0,11,6
D:0| T0: 0.10| T1: 24.00| R0: 0.0| R1: 0.0| WTP: 0,0,0.096153846,24,0,0,0,0,0,-2139519155,400145663,9835.667205,1647735795,164773579.5,1,73632,3191,470,1634,1164,470,73632,1164,1634,251.75,2.86875,10.1,43556.6625,1234.725,13.04375,98834.25,0.440080531,0.01236459,0.000131774,0.712362301,0.022191439,23,18
D:0| T0: 0.10| T1: 24.00| R0: 0.0| R1: 0.0| WTP: 0,0,0.096153846,24,0,0,0,0,0,-525941393.5,1662654181,0.012131868,525940786.9,52594078.69,1,82,5,0,0,0,0,82,0,0,0.319444444,0,0,99949.04167,4.236111111,0,100000,0.999493151,4.41096E-05,0,0,0,11,6
D:0| T0: 0.10| T1: 24.00| R0: 0.0| R1: 0.0| WTP: 0,0,0.096153846,24,0,0,0,0,0,-2763213354,182136456,11368.15102,2194805803,219480580.3,2,95063,4199,1184,1888,704,1184,95063,704,1888,137.6226913,3.005277045,4.820580475,50214.40633,869.8443272,7.939313984,99053.91821,0.498615167,0.008875645,8.26714E-05,0.372881356,0.019860514,54,24
D:0| T0: 0.10| T1: 24.00| R0: 0.0| R1: 0.0| WTP: 0,0,0.096153846,24,0,0,0,0,0,-526250066.5,979575387,6.020337891,525949049.6,52594904.96,1,39,2,1,1,0,1,39,0,1,0.397260274,0,0,99973.34247,3.178082192,0.01369863,99999.63014,0.999739188,3.32433E-05,2.7027E-07,0,0.025641026,11,6
D:0| T0: 0.10| T1: 24.00| R0: 0.0| R1: 0.0| WTP: 0,0,0.096153846,24,0,0,0,0,0,-2806631415,2142525414,12280.40952,2192610939,219261093.9,2,92655,4057,1560,2040,480,1560,92655,480,2040,136.0135501,4.06504065,5.341463415,56427.58808,983.6856369,9.547425474,99098.98103,0.550616123,0.010273557,0.000101823,0.235294118,0.02201716,51,24
D:0| T0: 0.10| T1: 24.00| R0: 0.0| R1: 0.0| WTP: 0,0,0.096153846,24,0,0,0,0,0,-2779040551,1464057597,11727.66141,2192657480,219265748,2,93105,4001,886,1948,1062,886,93105,1062,1948,144.559322,2.344632768,5.302259887,64409.14407,985.6694915,7.838983051,99319.51412,0.643823465,0.009950981,8.08071E-05,0.545174538,0.020922614,51,24
D:0| T0: 0.10| T1: 24.00| R0: 0.0| R1: 0.0| WTP: 0,0,0.096153846,24,0,0,0,0,0,-2732742937,364562610,10915.37164,2186974355,218697435.5,2,85914,3749,1591,1813,222,1591,85914,222,1813,114.2087379,3.67961165,4.191747573,50334.16748,703.6747573,8.041262136,98988.45388,0.500778042,0.007172523,8.41865E-05,0.12244898,0.021102498,59,24
D:0| T0: 0.10| T1: 24.00| R0: 0.0| R1: 0.0| WTP: 0,0,0.096153846,24,0,0,0,0,0,-2762886707,40350784,11515.92251,2187090581,218709058.1,2,88540,3810,1564,1913,349,1564,88540,349,1913,129.8314917,4.110497238,5.046961326,55494.89503,940.8922652,9.403314917,99102.05801,0.557504426,0.009473493,9.66677E-05,0.182435964,0.021606542,52,24
D:0| T0: 0.10| T1: 24.00| R0: 0.0| R1: 0.0| WTP: 0,0,0.096153846,24,0,0,0,0,0,-2757030315,804064356,11188.68276,2197596177,219759617.7,2,96027,4328,676,1858,1182,676,96027,1182,1858,145.4053333,1.672,4.802666667,67056.95733,743.208,6.602666667,99417.18133,0.659328258,0.00774476,7.04292E-05,0.636167922,0.019348725,52,24
D:0| T0: 0.10| T1: 24.00| R0: 0.0| R1: 0.0| WTP: 0,0,0.096153846,24,0,0,0,0,0,-1591445843,2125493986,246.6775898,1579111963,157911196.3,1,1624,65,41,41,0,41,1624,0,41,4.919753086,0.148148148,0.148148148,98779.08642,31.29012346,0.388888889,99971.61111,0.988023329,0.000315492,5.06271E-06,0,0.025246305,23,18
D:0| T0: 0.10| T1: 24.00| R0: 0.0| R1: 0.0| WTP: 0,0,0.096153846,24,0,0,0,0,0,-2698860777,23154253,10130.14274,2192353639,219235363.9,2,88559,4072,956,1682,726,956,88559,726,1682,130.75,2.270408163,4.102040816,61842.65306,603.3188776,6.525510204,99321.56633,0.611083471,0.006210801,6.92445E-05,0.431629013,0.018992988,55,24
D:0| T0: 0.10| T1: 24.00| R0: 0.0| R1: 0.0| WTP: 0,0,0.096153846,24,0,0,0,0,0,-1142623034,1391367689,54.19463992,1139913302,113991330.2,1,338,17,9,9,0,9,338,0,9,2.113636364,0.007575758,0.007575758,99793.95455,9.575757576,0.068181818,99995.55303,0.99782669,0.000104557,1.46347E-06,0,0.026627219,18,13
D:0| T0: 0.10| T1: 24.00| R0: 0.0| R1: 0.0| WTP: 0,0,0.096153846,24,0,0,0,0,0,-2783672486,574142276,11882.69936,2189537519,218953751.9,2,90798,4013,697,1974,1277,697,90798,1277,1974,124.9037975,1.675949367,4.878481013,72089.85316,1054.681013,6.658227848,99448.48101,0.718377267,0.010727797,6.88087E-05,0.646909828,0.021740567,56,24
D:0| T0: 0.10| T1: 24.00| R0: 0.0| R1: 0.0| WTP: 0,0,0.096153846,24,0,0,0,0,0,-789165407.6,898736779,6.008733495,788864970.9,78886497.09,1,24,2,1,1,0,1,24,0,1,0.061946903,0,0,99986.50442,1.566371681,0.017699115,99999.30088,0.999855611,1.85716E-05,2.04082E-07,0,0.041666667,14,9
D:0| T0: 0.10| T1: 24.00| R0: 0.0| R1: 0.0| WTP: 0,0,0.096153846,24,0,0,0,0,0,-2736985576,346473503,10679.94197,2202988478,220298847.8,2,97315,4672,643,1773,1130,643,97315,1130,1773,127.1140351,1.307017544,3.756578947,67750.02632,1217.958333,5.175438596,99465.86184,0.617197193,0.014542466,6.3298E-05,0.637337845,0.018219185,55,24
D:0| T0: 0.10| T1: 24.00| R0: 0.0| R1: 0.0| WTP: 0,0,0.096153846,24,0,0,0,0,0,-2779387357,445552282,11733.57927,2192708393,219270839.3,2,94964,4236,719,1949,1230,719,94964,1230,1949,116.2902494,1.532879819,4.292517007,73598.00227,1232.414966,5.920634921,99506.32653,0.70012039,0.014103961,6.92455E-05,0.631092868,0.020523567,55,24
D:0| T0: 0.10| T1: 24.00| R0: 0.0| R1: 0.0| WTP: 0,0,0.096153846,24,0,0,0,0,0,-2011827938,911758476,8977.866356,1562934620,156293462,1,73322,3308,588,1491,903,588,73322,903,1491,232.6961326,3.132596685,8.071823204,54995.9779,1135.596685,11.35359116,99165.98895,0.475027389,0.013352622,0.000135158,0.605633803,0.020334961,22,17
D:0| T0: 0.10| T1: 24.00| R0: 0.0| R1: 0.0| WTP: 0,0,0.096153846,24,0,0,0,0,0,-2735396816,1464197940,10886.6746,2191063086,219106308.6,2,88843,3942,1611,1808,197,1611,88843,197,1808,111.6216216,3.441441441,3.876126126,40437.85811,1163.470721,7.497747748,98836.94595,0.407637942,0.011715261,7.75416E-05,0.108960177,0.020350506,64,24
D:0| T0: 0.10| T1: 24.00| R0: 0.0| R1: 0.0| WTP: 0,0,0.096153846,24,0,0,0,0,0,-1846187106,500405854,96.31167549,1841371522,184137152.2,1,815,38,16,16,0,16,815,0,16,2.195876289,0.015463918,0.015463918,99429.20619,17.81443299,0.103092784,99990.11856,0.994033317,0.000190615,1.74876E-06,0,0.019631902,26,21
D:0| T0: 0.10| T1: 24.00| R0: 0.0| R1: 0.0| WTP: 0,0,0.096153846,24,0,0,0,0,0,-2834544021,772037341,12814.93814,2193797114,219379711.4,2,95958,4155,773,2129,1356,773,95958,1356,2129,139.3827493,1.938005391,5.566037736,63392.53908,844.7250674,7.649595687,99231.33693,0.635109859,0.008511338,7.87902E-05,0.636918741,0.02218679,53,24
D:0| T0: 0.10| T1: 24.00| R0: 0.0| R1: 0.0| WTP: 0,0,0.096153846,24,0,0,0,0,0,-614302229.6,1543158763,12.0575549,613699351.8,61369935.18,1,88,7,2,2,0,2,88,0,2,0.957446809,0,0,99948.54255,4.223404255,0.021276596,99999.11702,0.999429028,4.89161E-05,4.8193E-07,0,0.022988506,12,7
D:0| T0: 0.10| T1: 24.00| R0: 0.0| R1: 0.0| WTP: 0,0,0.096153846,24,0,0,0,0,0,-2829736319,1604932531,12795.86638,2189942999,218994299.9,2,93564,3900,1182,2126,944,1182,93564,944,2126,120.3596059,2.802955665,5.093596059,44602.36453,678.5960591,7.992610837,98774.86207,0.427265261,0.007122806,8.55206E-05,0.444026341,0.022722415,56,24
D:0| T0: 0.10| T1: 24.00| R0: 0.0| R1: 0.0| WTP: 0,0,0.096153846,24,0,0,0,0,0,-2819703614,539051477,12479.53404,2195726912,219572691.2,2,94613,4240,1438,2073,635,1438,94613,635,2073,133.5345269,3.519181586,5.109974425,58417.52941,1381.943734,8.78516624,99163.78772,0.550223843,0.015123317,9.8208E-05,0.306319344,0.021910308,52,24
D:0| T0: 0.10| T1: 24.00| R0: 0.0| R1: 0.0| WTP: 0,0,0.096153846,24,0,0,0,0,0,-351017927.4,1743124675,6.041964265,350715829.2,35071582.92,1,67,6,1,1,0,1,67,0,1,1.044776119,0,0,99964.02985,3.119402985,0.014925373,99999.62687,0.999618251,3.49208E-05,3.1746E-07,0,0.015151515,9,4
D:0| T0: 0.10| T1: 24.00| R0: 0.0| R1: 0.0| WTP: 0,0,0.096153846,24,0,0,0,0,0,-2793339666,1965983789,12092.70068,2188704632,218870463.2,2,89700,3883,851,2009,1158,851,89700,1158,2009,103.2356688,1.740976645,4.161358811,65525.62845,1110.749469,5.963906582,99284.97028,0.651598673,0.01133653,6.19838E-05,0.576406172,0.022396878,67,24
D:0| T0: 0.10| T1: 24.00| R0: 0.0| R1: 0.0| WTP: 0,0,0.096153846,24,0,0,0,0,0,-1317483978,516774280,48.14581302,1315076687,131507668.7,1,422,13,8,8,0,8,422,0,8,1.315068493,0.01369863,0.01369863,99708.17123,17.60273973,0.054794521,99995.21918,0.997096431,0.000179454,1.10349E-06,0,0.018957346,20,15
D:0| T0: 0.10| T1: 24.00| R0: 0.0| R1: 0.0| WTP: 0,0,0.096153846,24,0,0,0,0,0,-2178897392,86603142,10427.39956,1657527414,165752741.4,1,82662,3563,504,1732,1228,504,82662,1228,1732,273.1005917,2.917159763,10.14792899,41358.82249,1269.260355,13.13017751,98857.53254,0.376476684,0.013599575,0.000141862,0.709006928,0.020952796,23,18
D:0| T0: 0.10| T1: 24.00| R0: 0.0| R1: 0.0| WTP: 0,0,0.096153846,24,0,0,0,0,0,-1052438462,1431870609,12.02063183,1051837430,105183743,1,103,3,2,2,0,2,103,0,2,0.175438596,0,0,99929.74561,5.99122807,0.01754386,99998.69298,0.999313467,6.16529E-05,3.47828E-07,0,0.019417476,17,12
D:0| T0: 0.10| T1: 24.00| R0: 0.0| R1: 0.0| WTP: 0,0,0.096153846,24,0,0,0,0,0,-2747178281,1592383984,11090.99959,2192628301,219262830.1,2,91083,4090,728,1842,1114,728,91083,1114,1842,137.5855615,1.794117647,4.740641711,67549.92246,711.1898396,6.692513369,99389.40909,0.673513045,0.007214023,6.97089E-05,0.604777416,0.020223313,53,24
D:0| T0: 0.10| T1: 24.00| R0: 0.0| R1: 0.0| WTP: 0,0,0.096153846,24,0,0,0,0,0,-1845386120,1440183867,84.24197223,1841174021,184117402.1,1,562,23,14,14,0,14,562,0,14,1.653846154,0.032967033,0.032967033,99580.32967,14.44505495,0.104395604,99990.38462,0.995907812,0.00014591,1.53015E-06,0,0.024911032,26,21
D:0| T0: 0.10| T1: 24.00| R0: 0.0| R1: 0.0| WTP: 0,0,0.096153846,24,0,0,0,0,0,-1228510203,1696510588,24.08557134,1227305925,122730592.5,1,185,7,4,4,0,4,185,0,4,0.939393939,0,0,99886.80303,6.424242424,0.03030303,99998.94697,0.998873696,6.65158E-05,6.0607E-07,0,0.016304348,19,14
D:0| T0: 0.10| T1: 24.00| R0: 0.0| R1: 0.0| WTP: 0,0,0.096153846,24,0,0,0,0,0,-2862109098,895039877,13290.76411,2197570892,219757089.2,2,96408,4185,1153,2208,1055,1153,96408,1055,2208,141.2770449,2.878627968,5.622691293,58566.73879,1339.060686,8.686015831,99132.83905,0.57136641,0.014014279,9.27784E-05,0.477807971,0.022902664,53,24
D:0| T0: 0.10| T1: 24.00| R0: 0.0| R1: 0.0| WTP: 0,0,0.096153846,24,0,0,0,0,0,-2822732075,129565953,12663.52415,2189555868,218955586.8,2,91248,3849,916,2104,1188,916,91248,1188,2104,109.3214286,1.964285714,4.578125,69312.27232,1431.792411,6.627232143,99363.38393,0.692313285,0.014495671,6.82727E-05,0.564638783,0.02305804,63,24
D:0| T0: 0.10| T1: 24.00| R0: 0.0| R1: 0.0| WTP: 0,0,0.096153846,24,0,0,0,0,0,-614205817.2,1902565669,12.02590655,613604521.8,61360452.18,1,159,7,2,2,0,2,159,0,2,0.337078652,0,0,99909.01124,6.584269663,0.02247191,99999.30337,0.999048342,7.11768E-05,4.70591E-07,0,0.012578616,12,7
D:0| T0: 0.10| T1: 24.00| R0: 0.0| R1: 0.0| WTP: 0,0,0.096153846,24,0,0,0,0,0,-1491498301,1984179288,24.09664827,1490293468,149029346.8,1,236,13,4,4,0,4,236,0,4,0.852941176,0,0,99849.64118,10.67058824,0.023529412,99997.91176,0.998310015,0.000121613,5.36921E-07,0,0.016949153,22,17
D:0| T0: 0.10| T1: 24.00| R0: 0.0| R1: 0.0| WTP: 0,0,0.096153846,24,0,0,0,0,0,-2821333018,677377223,12539.03041,2194381498,219438149.8,2,94598,4105,1114,2083,969,1114,94598,969,2083,132.0790816,2.683673469,5.12244898,59284.16582,1959.931122,7.974489796,99182.94898,0.593894138,0.019748654,8.21606E-05,0.465194431,0.022019493,55,24
D:0| T0: 0.10| T1: 24.00| R0: 0.0| R1: 0.0| WTP: 0,0,0.096153846,24,0,0,0,0,0,-2787618187,973583301,11889.92042,2193122166,219312216.6,2,95668,4158,839,1975,1136,839,95668,1136,1975,130.7913486,2.022900763,4.872773537,62580.25954,1975.755725,7.015267176,99300.48346,0.624269032,0.019998918,7.24863E-05,0.575189873,0.020644312,56,24
D:0| T0: 0.10| T1: 24.00| R0: 0.0| R1: 0.0| WTP: 0,0,0.096153846,24,0,0,0,0,0,-1934003567,781062938,96.36862604,1929185135,192918513.5,1,768,40,16,16,0,16,768,0,16,2.836956522,0.032608696,0.032608696,99436.40761,20.13043478,0.114130435,99989.17391,0.994483096,0.000202611,1.72986E-06,0,0.020833333,27,22
D:0| T0: 0.10| T1: 24.00| R0: 0.0| R1: 0.0| WTP: 0,0,0.096153846,24,0,0,0,0,0,-2772565093,338783425,11583.73039,2193378573,219337857.3,2,95255,4221,817,1924,1107,817,95255,1107,1924,123.4210526,1.897129187,4.511961722,69337.95933,1860.54067,6.456937799,99455.95933,0.687481297,0.019096368,6.73354E-05,0.575363825,0.020198415,59,24
D:0| T0: 0.10| T1: 28.00| R0: 0.0| R1: 0.0| WTP: 0,0,0.096153846,28,0,0,0,0,0,-3134150083,650073325,11788.1282,2544743672,254474367.2,2,92936,4248,750,1958,1208,750,92936,1208,1958,91.94003527,1.266313933,3.377425044,78625.22575,1054.097002,4.701940035,99596.81129,0.723483585,0.013736311,6.22899E-05,0.616956078,0.021068262,63,28
D:0| T0: 0.10| T1: 28.00| R0: 0.0| R1: 0.0| WTP: 0,0,0.096153846,28,0,0,0,0,0,-3128396128,2029998696,11668.28684,2544981786,254498178.6,2,94706,4184,1248,1938,690,1248,94706,690,1938,128.5384615,2.920595533,4.612903226,55797.36228,797.9230769,7.712158809,99144.74194,0.549261471,0.008240959,8.1588E-05,0.356037152,0.020463329,57,28
D:0| T0: 0.10| T1: 28.00| R0: 0.0| R1: 0.0| WTP: 0,0,0.096153846,28,0,0,0,0,0,-3162755977,776062361,12524.57676,2536527140,253652714,2,87167,3662,1853,2081,228,1853,87167,228,2081,85.37686567,3.292910448,3.707089552,46671.49813,1012.235075,7.164179104,98791.26306,0.444033753,0.010707474,7.76539E-05,0.10956271,0.023873714,72,28
D:0| T0: 0.10| T1: 28.00| R0: 0.0| R1: 0.0| WTP: 0,0,0.096153846,28,0,0,0,0,0,-790143259.7,1813046880,24.0502197,788940748.7,78894074.87,1,100,3,4,4,0,4,100,0,4,0.505154639,0.020618557,0.020618557,99933.56701,5.783505155,0.06185567,99997.71134,0.999361715,5.9491E-05,8.16337E-07,0,0.04,14,9
D:0| T0: 0.10| T1: 28.00| R0: 0.0| R1: 0.0| WTP: 0,0,0.096153846,28,0,0,0,0,0,-969116302.8,2032407216,84.31581289,964900512.2,96490051.22,1,779,40,14,14,0,14,779,0,14,3.552845528,0.056910569,0.056910569,99539.73171,21.43902439,0.162601626,99992.72358,0.994948703,0.000239204,2.52268E-06,0,0.018018018,16,11
D:0| T0: 0.10| T1: 28.00| R0: 0.0| R1: 0.0| WTP: 0,0,0.096153846,28,0,0,0,0,0,-613612900.2,1507873352,0.019516484,613611924.4,61361192.44,1,20,3,0,0,0,0,20,0,0,0.359223301,0,0,99989.39806,1.747572816,0,100000,0.999877209,2.0814E-05,0,0,0,12,7
D:0| T0: 0.10| T1: 28.00| R0: 0.0| R1: 0.0| WTP: 0,0,0.096153846,28,0,0,0,0,0,-613940692.7,1855899401,6.032997232,613639042.8,61363904.28,1,115,5,1,1,0,1,115,0,1,0.6625,0,0,99925.2875,4.475,0.0125,99999.425,0.999253494,4.67503E-05,0.00000025,0,0.008695652,12,7
D:0| T0: 0.10| T1: 28.00| R0: 0.0| R1: 0.0| WTP: 0,0,0.096153846,28,0,0,0,0,0,-3156518993,1819459251,12333.03711,2539867137,253986713.7,2,92717,3901,768,2049,1281,768,92717,1281,2049,123.0100251,1.766917293,4.947368421,69431.13534,828.8546366,6.884711779,99369.46617,0.695147831,0.008350867,7.11211E-05,0.625183016,0.022099507,57,28
D:0| T0: 0.10| T1: 28.00| R0: 0.0| R1: 0.0| WTP: 0,0,0.096153846,28,0,0,0,0,0,-350960853.1,909791748,6.024030199,350659651.6,35065965.16,1,60,2,1,1,0,1,60,0,1,0.590163934,0,0,99965.06557,2.770491803,0.016393443,99999.70492,0.999655805,3.03226E-05,3.22581E-07,0,0.016949153,9,4
D:0| T0: 0.10| T1: 28.00| R0: 0.0| R1: 0.0| WTP: 0,0,0.096153846,28,0,0,0,0,0,-3123377166,1339092841,11737.42369,2536505982,253650598.2,2,87352,3760,787,1950,1163,787,87352,1163,1950,110.8658824,1.705882353,4.421176471,71725.88,737.6635294,6.284705882,99403.30824,0.718241892,0.007431461,6.48592E-05,0.596410256,0.022323473,61,28
D:0| T0: 0.10| T1: 28.00| R0: 0.0| R1: 0.0| WTP: 0,0,0.096153846,28,0,0,0,0,0,-3181721369,1365866345,12713.49582,2546046578,254604657.8,2,97319,4195,1066,2112,1046,1066,97319,1046,2112,118.6606335,2.248868778,4.597285068,62547.65837,689.2352941,7.031674208,99224.34163,0.579920994,0.007831329,8.16521E-05,0.495265152,0.021701826,56,28
D:0| T0: 0.10| T1: 28.00| R0: 0.0| R1: 0.0| WTP: 0,0,0.096153846,28,0,0,0,0,0,-3093994004,825453433,10977.50779,2545118615,254511861.5,2,93874,4221,719,1823,1104,719,93874,1104,1823,126.177458,1.611510791,4.232613909,69349.23741,1147.908873,5.952038369,99460.61391,0.693739388,0.011552477,6.13571E-05,0.605595173,0.019419648,60,28
D:0| T0: 0.10| T1: 28.00| R0: 0.0| R1: 0.0| WTP: 0,0,0.096153846,28,0,0,0,0,0,-3134249710,939711378,11717.47743,2548375838,254837583.8,2,95576,4217,1287,1946,659,1287,95576,659,1946,143.2553191,3.244680851,4.984042553,53668.14362,1001.007979,8.406914894,99103.06915,0.539425288,0.010081211,8.65397E-05,0.338643371,0.02036076,54,28
D:0| T0: 0.10| T1: 28.00| R0: 0.0| R1: 0.0| WTP: 0,0,0.096153846,28,0,0,0,0,0,-3110878274,638950699,11367.06435,2542525056,254252505.6,2,92967,4087,811,1888,1077,811,92967,1077,1888,111.9096916,1.707048458,4.044052863,70853.94053,1298.180617,5.823788546,99465.88106,0.708809067,0.013073508,5.98802E-05,0.570444915,0.0203085,65,28
D:0| T0: 0.10| T1: 28.00| R0: 0.0| R1: 0.0| WTP: 0,0,0.096153846,28,0,0,0,0,0,-1141838461,938699148,42.12651908,1139732135,113973213.5,1,448,21,7,7,0,7,448,0,7,1.104895105,0.027972028,0.027972028,99750.46154,10.41958042,0.083916084,99996.03497,0.997085929,0.000124468,1.15705E-06,0,0.015625,18,13
D:0| T0: 0.10| T1: 28.00| R0: 0.0| R1: 0.0| WTP: 0,0,0.096153846,28,0,0,0,0,0,-1608662468,1412065496,524.0343361,1582460751,158246075.1,1,4166,192,87,87,0,87,4166,0,87,11.96566524,0.296137339,0.296137339,97987.71245,52.7167382,0.665236052,99961.07725,0.971141792,0.000765818,1.08795E-05,0,0.020888355,23,18
D:0| T0: 0.10| T1: 28.00| R0: 0.0| R1: 0.0| WTP: 0,0,0.096153846,28,0,0,0,0,0,-3136956707,1331335240,11878.0668,2543053367,254305336.7,2,91059,4008,1739,1973,234,1739,91059,234,1973,108.7434783,3.613043478,4.104347826,50461.11739,1305.197826,7.880434783,98995.3413,0.492699845,0.013533177,8.36634E-05,0.118601115,0.021667271,64,28
D:0| T0: 0.10| T1: 28.00| R0: 0.0| R1: 0.0| WTP: 0,0,0.096153846,28,0,0,0,0,0,-2256898098,470935411,10400.72688,1736861754,173686175.4,1,76553,3241,665,1728,1063,665,76553,1063,1728,218.4385027,3.470588235,9.080213904,51483.99465,1060.395722,12.61497326,98995.65241,0.457515785,0.011972692,0.000144568,0.615162037,0.022572892,24,19
D:0| T0: 0.10| T1: 28.00| R0: 0.0| R1: 0.0| WTP: 0,0,0.096153846,28,0,0,0,0,0,-1580920072,823434397,60.11843935,1577914150,157791415,1,521,14,10,10,0,10,521,0,10,0.73125,0.01875,0.01875,99655.375,15.425,0.075,99994.88125,0.996611501,0.00015603,1.24229E-06,0,0.019230769,23,18
D:0| T0: 0.10| T1: 28.00| R0: 0.0| R1: 0.0| WTP: 0,0,0.096153846,28,0,0,0,0,0,-525966716.9,493045351,0.020043956,525965714.7,52596571.47,1,140,7,0,0,0,0,140,0,0,0.493506494,0,0,99918.5974,4.74025974,0,100000,0.999168158,5.05263E-05,0,0,0,11,6
D:0| T0: 0.10| T1: 28.00| R0: 0.0| R1: 0.0| WTP: 0,0,0.096153846,28,0,0,0,0,0,-1666457118,1700216563,18.07842027,1665553197,166555319.7,1,285,12,3,3,0,3,285,0,3,0.727272727,0,0,99812.71515,8.690909091,0.018181818,99998.15152,0.998150074,8.88566E-05,3.61449E-07,0,0.01056338,24,19
D:0| T0: 0.10| T1: 28.00| R0: 0.0| R1: 0.0| WTP: 0,0,0.096153846,28,0,0,0,0,0,-1325431175,1744119059,180.6954829,1316396400,131639640,1,1555,78,30,30,0,30,1555,0,30,6.927536232,0.137681159,0.137681159,98907.02899,29.65217391,0.34057971,99980.17391,0.989289112,0.000296518,4.31714E-06,0,0.019292605,20,15
D:0| T0: 0.10| T1: 28.00| R0: 0.0| R1: 0.0| WTP: 0,0,0.096153846,28,0,0,0,0,0,-701896219.8,2036906360,12.03909336,701294265.1,70129426.51,1,90,7,2,2,0,2,90,0,2,0.5,0,0,99953.46364,5.272727273,0.018181818,99998.94545,0.999462571,6.35494E-05,4.3011E-07,0,0.022222222,13,8
D:0| T0: 0.10| T1: 28.00| R0: 0.0| R1: 0.0| WTP: 0,0,0.096153846,28,0,0,0,0,0,-3108867043,809704121,11313.21268,2543206409,254320640.9,2,90987,4173,761,1879,1118,761,90987,1118,1879,113.4070796,1.619469027,4.061946903,73377.09735,1036.515487,5.743362832,99497.77212,0.732888788,0.010483455,5.9081E-05,0.594997339,0.020651302,64,28
D:0| T0: 0.10| T1: 28.00| R0: 0.0| R1: 0.0| WTP: 0,0,0.096153846,28,0,0,0,0,0,-3163018226,1219866412,12288.03582,2548616435,254861643.5,2,96484,4305,1251,2041,790,1251,96484,790,2041,133.0592593,2.933333333,4.861728395,57260.66914,1955.804938,7.940740741,99167.95062,0.57407778,0.019707807,8.18641E-05,0.387065164,0.021153766,58,28
D:0| T0: 0.10| T1: 28.00| R0: 0.0| R1: 0.0| WTP: 0,0,0.096153846,28,0,0,0,0,0,-527532089.2,843498920,30.06529385,526028824.5,52602882.45,1,89,7,5,5,0,5,89,0,5,1.013333333,0,0,99943.44,5.053333333,0.08,99997.84,0.999459456,5.19746E-05,1.31582E-06,0,0.057471264,11,6
D:0| T0: 0.10| T1: 28.00| R0: 0.0| R1: 0.0| WTP: 0,0,0.096153846,28,0,0,0,0,0,-1056001584,107351963,78.1609805,1052093535,105209353.5,1,429,18,13,13,0,13,429,0,13,1.387931034,0.043103448,0.043103448,99715.08621,23.24137931,0.155172414,99993.66379,0.997198116,0.000234582,2.24151E-06,0,0.03030303,17,12
D:0| T0: 0.10| T1: 28.00| R0: 0.0| R1: 0.0| WTP: 0,0,0.096153846,28,0,0,0,0,0,-1229355149,773789021,42.0817004,1227251064,122725106.4,1,333,12,7,7,0,7,333,0,7,0.622222222,0.007407407,0.007407407,99783.48148,16.42222222,0.059259259,99996.36296,0.997845037,0.000167467,1.04481E-06,0,0.021021021,19,14
D:0| T0: 0.10| T1: 28.00| R0: 0.0| R1: 0.0| WTP: 0,0,0.096153846,28,0,0,0,0,0,-3162883010,850936611,12536.00669,2536082676,253608267.6,2,90884,3773,774,2083,1309,774,90884,1309,2083,105.0247748,1.653153153,4.574324324,74051.83784,1076.925676,6.317567568,99463.06532,0.732435198,0.01120587,6.69692E-05,0.628420547,0.022919326,62,28
D:0| T0: 0.10| T1: 28.00| R0: 0.0| R1: 0.0| WTP: 0,0,0.096153846,28,0,0,0,0,0,-2216888293,1701318364,433.6792622,2195204330,219520433,1,3844,167,72,72,0,72,3844,0,72,10.58064516,0.230414747,0.230414747,97320.96774,75.29493088,0.562211982,99952.08756,0.972178328,0.00079515,6.99271E-06,0,0.018730489,30,25
D:0| T0: 0.10| T1: 28.00| R0: 0.0| R1: 0.0| WTP: 0,0,0.096153846,28,0,0,0,0,0,-701235203.9,778708269,0.010549451,701234676.5,70123467.65,1,42,2,0,0,0,0,42,0,0,0.224719101,0,0,99973.55056,3.516853933,0,100000,0.99972908,3.7931E-05,0,0,0,13,8
D:0| T0: 0.10| T1: 28.00| R0: 0.0| R1: 0.0| WTP: 0,0,0.096153846,28,0,0,0,0,0,-1149072005,1391938506,174.4410021,1140349954,114034995.4,1,765,35,29,29,0,29,765,0,29,4.184,0.072,0.072,99465.488,22.664,0.328,99983.104,0.994835265,0.000227169,4.60381E-06,0,0.037908497,18,13
D:0| T0: 0.10| T1: 28.00| R0: 0.0| R1: 0.0| WTP: 0,0,0.096153846,28,0,0,0,0,0,-789483172.3,43418681,12.01852194,788882246.2,78888224.62,1,96,6,2,2,0,2,96,0,2,0.173913043,0,0,99939.82609,6.27173913,0.02173913,99998.92391,0.999412034,6.43017E-05,4.3011E-07,0,0.020833333,14,9
D:0| T0: 0.10| T1: 28.00| R0: 0.0| R1: 0.0| WTP: 0,0,0.096153846,28,0,0,0,0,0,-1933022618,817384966,4700.967959,1697974220,169797422,1,35075,1454,502,781,279,502,35075,279,781,109.7559524,2.880952381,4.5,74182.78571,570.8452381,7.494047619,99474.94048,0.741220086,0.005799161,7.75974E-05,0.357234315,0.022266572,24,19
D:0| T0: 0.10| T1: 28.00| R0: 0.0| R1: 0.0| WTP: 0,0,0.096153846,28,0,0,0,0,0,-2060199363,762053968,2270.112325,1946693747,194669374.7,1,18589,805,352,377,25,352,18589,25,377,54.70157068,1.680628272,1.806282723,86422.54974,305.2356021,3.638743455,99746.60209,0.865141197,0.003076137,3.84398E-05,0.066312997,0.020280811,27,22
D:0| T0: 0.10| T1: 28.00| R0: 0.0| R1: 0.0| WTP: 0,0,0.096153846,28,0,0,0,0,0,-2022117363,1692506311,114.2434419,2016405191,201640519.1,1,554,21,19,19,0,19,554,0,19,1.185185185,0.027777778,0.027777778,99635.78241,17.24537037,0.115740741,99988.91667,0.996212583,0.000186105,1.88135E-06,0,0.03442029,28,23
D:0| T0: 0.10| T1: 28.00| R0: 0.0| R1: 0.0| WTP: 0,0,0.096153846,28,0,0,0,0,0,-2529871727,883828863,8869.02478,2086420488,208642048.8,1,72399,3225,693,1473,780,693,72399,780,1473,127.8454259,2.129337539,4.545741325,68328.85174,597.7917981,6.738170347,99401.89905,0.481055828,0.00987943,0.000113073,0.529531568,0.020345866,28,23
D:0| T0: 0.10| T1: 28.00| R0: 0.0| R1: 0.0| WTP: 0,0,0.096153846,28,0,0,0,0,0,-879289142.1,301400999,48.16217016,876881033.6,87688103.36,1,430,19,8,8,0,8,430,0,8,2.203883495,0.009708738,0.009708738,99719.3301,17.98058252,0.077669903,99996.08738,0.997240136,0.000180391,1.53851E-06,0,0.01627907,15,10
D:0| T0: 0.10| T1: 28.00| R0: 0.0| R1: 0.0| WTP: 0,0,0.096153846,28,0,0,0,0,0,-3160315456,1868336855,12263.3727,2547146821,254714682.1,2,96050,4237,855,2037,1182,855,96050,1182,2037,136.0407125,2.020356234,5,63694.57506,958.6768448,7.170483461,99282.56234,0.63779277,0.009658605,7.41105E-05,0.580265096,0.021207704,57,28
D:0| T0: 0.10| T1: 28.00| R0: 0.0| R1: 0.0| WTP: 0,0,0.096153846,28,0,0,0,0,0,-3182951922,1868498144,12831.99981,2541351931,254135193.1,2,95114,4065,920,2132,1212,920,95114,1212,2132,126.7295918,2.168367347,5.221938776,64840.42092,1013.487245,7.566326531,99266.55612,0.649427936,0.010216673,7.84439E-05,0.5684803,0.022415207,56,28
D:0| T0: 0.10| T1: 28.00| R0: 0.0| R1: 0.0| WTP: 0,0,0.096153846,28,0,0,0,0,0,-1316208864,2101566889,24.10086805,1315003820,131500382,1,197,10,4,4,0,4,197,0,4,1.092857143,0,0,99871.20714,8.478571429,0.028571429,99998.49286,0.998730896,8.63841E-05,5.67384E-07,0,0.020304569,20,15
D:0| T0: 0.10| T1: 28.00| R0: 0.0| R1: 0.0| WTP: 0,0,0.096153846,28,0,0,0,0,0,-2506479601,1665097450,8601.545333,2076402335,207640233.5,1,65856,2797,727,1429,702,727,65856,702,1429,150.0829694,3.091703057,6.091703057,59978.36681,986.6637555,9.279475983,99187.04803,0.531996643,0.011669175,0.000111386,0.491252624,0.021699188,28,23
D:0| T0: 0.10| T1: 28.00| R0: 0.0| R1: 0.0| WTP: 0,0,0.096153846,28,0,0,0,0,0,-3051538765,1716179948,10172.33874,2542921828,254292182.8,2,89424,4136,1409,1689,280,1409,89424,280,1689,107.1268499,2.828752643,3.393234672,38905.2241,649.9682875,6.372093023,98890.50529,0.392494516,0.006541999,6.59289E-05,0.165778567,0.018887758,68,28
D:0| T0: 0.10| T1: 28.00| R0: 0.0| R1: 0.0| WTP: 0,0,0.096153846,28,0,0,0,0,0,-968211161.5,1560278715,72.20920854,964600701.1,96460070.11,1,378,20,12,12,0,12,378,0,12,1.911111111,0.044444444,0.044444444,99801.24444,9.266666667,0.140740741,99995.45926,0.997746913,0.000108893,2.05139E-06,0,0.031830239,16,11
D:0| T0: 0.10| T1: 28.00| R0: 0.0| R1: 0.0| WTP: 0,0,0.096153846,28,0,0,0,0,0,-3200417634,991019385,13091.75528,2545829870,254582987,2,97110,4182,1032,2175,1143,1032,97110,1143,2175,136.4386423,2.524804178,5.483028721,62406.66057,1509.036554,8.164490862,99228.75718,0.625177364,0.015211342,8.43632E-05,0.525517241,0.022397281,55,28
D:0| T0: 0.10| T1: 28.00| R0: 0.0| R1: 0.0| WTP: 0,0,0.096153846,28,0,0,0,0,0,-3184260381,118052103,12797.01482,2544409640,254440964,2,95248,4099,964,2126,1162,964,95248,1162,2126,120.3925234,2.123831776,4.808411215,62877.59579,1124.586449,7.077102804,99235.61449,0.611316422,0.011889504,7.63138E-05,0.546566322,0.022320679,59,28
D:0| T0: 0.10| T1: 28.00| R0: 0.0| R1: 0.0| WTP: 0,0,0.096153846,28,0,0,0,0,0,-3157025338,1209758844,12386.75522,2537687577,253768757.7,2,87826,3688,1607,2058,451,1607,87826,451,2058,107.9884527,3.570438799,4.586605081,58081.1224,594.6535797,8.272517321,99065.77367,0.557652909,0.006377565,9.07134E-05,0.219144801,0.023432696,59,28
D:0| T0: 0.10| T1: 28.00| R0: 0.0| R1: 0.0| WTP: 0,0,0.096153846,28,0,0,0,0,0,-1052947058,70671723,18.09266202,1052042425,105204242.5,1,127,9,3,3,0,3,127,0,3,1.204918033,0,0,99909.68033,6.418032787,0.024590164,99998.28689,0.999087878,6.70596E-05,5.04207E-07,0,0.023622047,17,12
D:0| T0: 0.10| T1: 28.00| R0: 0.0| R1: 0.0| WTP: 0,0,0.096153846,28,0,0,0,0,0,-1052433031,1722612191,12.01904941,1051832078,105183207.8,1,52,2,2,2,0,2,52,0,2,0.137096774,0,0,99968.91129,2.266129032,0.016129032,99999.69355,0.999688942,2.43903E-05,3.25205E-07,0,0.019230769,17,12
D:0| T0: 0.10| T1: 28.00| R0: 0.0| R1: 0.0| WTP: 0,0,0.096153846,28,0,0,0,0,0,-1315580982,1968291596,12.08340106,1314976812,131497681.2,1,74,4,2,2,0,2,74,0,2,0.939189189,0,0,99953.10135,2.054054054,0.013513514,99999.31757,0.999506154,2.30435E-05,2.89857E-07,0,0.027027027,20,15
D:0| T0: 0.10| T1: 28.00| R0: 0.0| R1: 0.0| WTP: 0,0,0.096153846,28,0,0,0,0,0,-2786191699,1877569084,7379.32745,2417225327,241722532.7,1,54489,2272,800,1226,426,800,54489,426,1226,124.8384279,3.384279476,5.19650655,62121.41048,760.4061135,8.681222707,99200.20961,0.608616732,0.007964239,9.26726E-05,0.347471452,0.022499954,32,27
D:0| T0: 0.10| T1: 28.00| R0: 0.0| R1: 0.0| WTP: 0,0,0.096153846,28,0,0,0,0,0,-2931834245,1726322189,8331.584474,2515255021,251525502.1,2,64431,2779,922,1384,462,922,64431,462,1384,130.5584906,3.38490566,5.071698113,53485.54717,824.7660377,8.558490566,99063.97736,0.528446049,0.008462903,8.93153E-05,0.333815029,0.021480343,37,28
D:0| T0: 0.10| T1: 28.00| R0: 0.0| R1: 0.0| WTP: 0,0,0.096153846,28,0,0,0,0,0,-3132470864,307848836,11846.93384,2540124172,254012417.2,2,92427,3906,1367,1968,601,1367,92427,601,1968,122.2261307,3.261306533,4.746231156,56027.79648,814.8743719,8.173366834,99135.25126,0.562878878,0.008206745,8.4353E-05,0.305386179,0.021292479,57,28
D:0| T0: 0.10| T1: 28.00| R0: 0.0| R1: 0.0| WTP: 0,0,0.096153846,28,0,0,0,0,0,-2428005378,1154000220,8622.134929,1996898631,199689863.1,1,70493,3203,573,1432,859,573,70493,859,1432,213.7567568,2.978378378,7.589189189,45278.82162,991.427027,10.7027027,98967.50811,0.457113026,0.009926297,0.000108592,0.599860335,0.020314074,27,22
D:0| T0: 0.10| T1: 28.00| R0: 0.0| R1: 0.0| WTP: 0,0,0.096153846,28,0,0,0,0,0,-1052833485,2028661055,18.05783785,1051930593,105193059.3,1,112,6,3,3,0,3,112,0,3,0.629310345,0.017241379,0.017241379,99925.72414,5.24137931,0.043103448,99998.93103,0.999270844,5.44448E-05,5.12824E-07,0,0.026785714,17,12
D:0| T0: 0.10| T1: 28.00| R0: 0.0| R1: 0.0| WTP: 0,0,0.096153846,28,0,0,0,0,0,-3146471303,1629114640,12075.70913,2542685847,254268584.7,2,95414,4187,779,2006,1227,779,95414,1227,2006,121.736211,1.757793765,4.669064748,70117.69065,1413.292566,6.541966427,99437.753,0.701365848,0.014233772,6.72879E-05,0.611665005,0.021024168,60,28
D:0| T0: 0.10| T1: 28.00| R0: 0.0| R1: 0.0| WTP: 0,0,0.096153846,28,0,0,0,0,0,-3148378872,1439048174,12135.75589,2541591078,254159107.8,2,89745,3944,1575,2016,441,1575,89745,441,2016,106.3779698,3.244060475,4.172786177,41481.12095,822.0820734,7.602591793,98726.49892,0.41503006,0.008342501,7.87095E-05,0.21875,0.022463647,66,28
D:0| T0: 0.10| T1: 28.00| R0: 0.0| R1: 0.0| WTP: 0,0,0.096153846,28,0,0,0,0,0,-2429458360,865227006,10387.96343,1910060189,191006018.9,1,77049,3206,516,1726,1210,516,77049,1210,1726,192.7427184,2.432038835,8.266990291,47539.26699,1004.548544,10.77669903,98903.93689,0.397248879,0.011652111,0.000126356,0.701042874,0.022401329,26,21
D:0| T0: 0.10| T1: 28.00| R0: 0.0| R1: 0.0| WTP: 0,0,0.096153846,28,0,0,0,0,0,-3120327392,890479738,11524.03629,2544125577,254412557.7,2,91935,4075,1593,1914,321,1593,91935,321,1914,121.8301435,3.633971292,4.38277512,53859.54785,1571.37799,8.205741627,99102.2201,0.540638538,0.015829056,8.44753E-05,0.167711599,0.020819057,60,28
D:0| T0: 0.10| T1: 28.00| R0: 0.0| R1: 0.0| WTP: 0,0,0.096153846,28,0,0,0,0,0,-527585116.1,1017049163,30.08270044,526080981,52608098.1,1,206,7,5,5,0,5,206,0,5,1.415584416,0,0,99874.22078,8.922077922,0.077922078,99997.54545,0.998771236,9.08995E-05,1.28208E-06,0,0.024271845,11,6
D:0| T0: 0.10| T1: 28.00| R0: 0.0| R1: 0.0| WTP: 0,0,0.096153846,28,0,0,0,0,0,-525937956.2,1707305064,0.011604396,525937375.9,52593737.59,1,42,2,0,0,0,0,42,0,0,0.258823529,0,0,99976.75294,2.105882353,0,100000,0.999740263,2.59211E-05,0,0,0,11,6
D:0| T0: 0.10| T1: 28.00| R0: 0.0| R1: 0.0| WTP: 0,0,0.096153846,28,0,0,0,0,0,-2139519155,400145663,9835.667205,1647735795,164773579.5,1,73632,3191,470,1634,1164,470,73632,1164,1634,251.75,2.86875,10.1,43556.6625,1234.725,13.04375,98834.25,0.440080531,0.01236459,0.000131774,0.712362301,0.022191439,23,18
D:0| T0: 0.10| T1: 28.00| R0: 0.0| R1: 0.0| WTP: 0,0,0.096153846,28,0,0,0,0,0,-525941393.5,1662654181,0.012131868,525940786.9,52594078.69,1,82,5,0,0,0,0,82,0,0,0.319444444,0,0,99949.04167,4.236111111,0,100000,0.999493151,4.41096E-05,0,0,0,11,6
D:0| T0: 0.10| T1: 28.00| R0: 0.0| R1: 0.0| WTP: 0,0,0.096153846,28,0,0,0,0,0,-3139766458,182136456,11890.55141,2545238887,254523888.7,2,94823,4226,1181,1975,794,1181,94823,794,1975,125.442029,2.736714976,4.61352657,50509.73188,791.9903382,7.456521739,99031.07488,0.502309439,0.008076452,7.77089E-05,0.402025316,0.02082828,59,28
D:0| T0: 0.10| T1: 28.00| R0: 0.0| R1: 0.0| WTP: 0,0,0.096153846,28,0,0,0,0,0,-526250066.5,979575387,6.020337891,525949049.6,52594904.96,1,39,2,1,1,0,1,39,0,1,0.397260274,0,0,99973.34247,3.178082192,0.01369863,99999.63014,0.999739188,3.32433E-05,2.7027E-07,0,0.025641026,11,6
D:0| T0: 0.10| T1: 28.00| R0: 0.0| R1: 0.0| WTP: 0,0,0.096153846,28,0,0,0,0,0,-3156089411,2142525414,12350.97345,2538540738,253854073.8,2,91866,3837,1613,2052,439,1613,91866,439,2052,110.6744731,3.615925059,4.62295082,53799.25293,842.9836066,8.391100703,99020.6089,0.526109653,0.008765005,8.91813E-05,0.213937622,0.022336882,60,28
D:0| T0: 0.10| T1: 28.00| R0: 0.0| R1: 0.0| WTP: 0,0,0.096153846,28,0,0,0,0,0,-3128538182,1464057597,11709.64331,2543056017,254305601.7,2,92193,3942,1028,1945,917,1028,92193,917,1945,132.5963542,2.510416667,4.8671875,65613.74219,899.6510417,7.572916667,99335.1901,0.656202156,0.009083333,7.81386E-05,0.471465296,0.021097046,55,28
D:0| T0: 0.10| T1: 28.00| R0: 0.0| R1: 0.0| WTP: 0,0,0.096153846,28,0,0,0,0,0,-3100010788,364562610,11269.3471,2536543433,253654343.3,2,86027,3767,1618,1872,254,1618,86027,254,1872,97.45263158,3.237894737,3.751578947,48559.09053,610.8315789,7.153684211,98922.65895,0.483830517,0.006219281,7.4787E-05,0.135683761,0.02176061,68,28
D:0| T0: 0.10| T1: 28.00| R0: 0.0| R1: 0.0| WTP: 0,0,0.096153846,28,0,0,0,0,0,-3115913870,40350784,11575.83078,2537122331,253712233.1,2,87910,3755,1647,1923,276,1647,87910,276,1923,105.3167421,3.549773756,4.153846154,51454.6086,768.8846154,7.882352941,98994.38462,0.517476534,0.007746293,8.134E-05,0.143525741,0.021874645,64,28
D:0| T0: 0.10| T1: 28.00| R0: 0.0| R1: 0.0| WTP: 0,0,0.096153846,28,0,0,0,0,0,-2505830727,804064356,873.3914557,2462161154,246216115.4,1,8065,346,145,145,0,145,8065,0,145,19.31512605,0.470588235,0.470588235,94387.64286,97.62184874,1.067226891,99905.22269,0.941649961,0.001031097,1.28409E-05,0,0.017978921,33,28
D:0| T0: 0.10| T1: 28.00| R0: 0.0| R1: 0.0| WTP: 0,0,0.096153846,28,0,0,0,0,0,-1591445843,2125493986,246.6775898,1579111963,157911196.3,1,1624,65,41,41,0,41,1624,0,41,4.919753086,0.148148148,0.148148148,98779.08642,31.29012346,0.388888889,99971.61111,0.988023329,0.000315492,5.06271E-06,0,0.025246305,23,18
D:0| T0: 0.10| T1: 28.00| R0: 0.0| R1: 0.0| WTP: 0,0,0.096153846,28,0,0,0,0,0,-3039524723,23154253,9943.787125,2542335367,254233536.7,2,88373,4016,987,1651,664,987,88373,664,1651,126.9476309,2.279301746,3.912718204,66271.7182,588.0897756,6.366583541,99412.33915,0.656565324,0.006050462,6.76495E-05,0.402180497,0.018682177,56,28
D:0| T0: 0.10| T1: 28.00| R0: 0.0| R1: 0.0| WTP: 0,0,0.096153846,28,0,0,0,0,0,-1142623034,1391367689,54.19463992,1139913302,113991330.2,1,338,17,9,9,0,9,338,0,9,2.113636364,0.007575758,0.007575758,99793.95455,9.575757576,0.068181818,99995.55303,0.99782669,0.000104557,1.46347E-06,0,0.026627219,18,13
D:0| T0: 0.10| T1: 28.00| R0: 0.0| R1: 0.0| WTP: 0,0,0.096153846,28,0,0,0,0,0,-2373249439,574142276,120.3212743,2367233375,236723337.5,1,904,35,20,20,0,20,904,0,20,1.743362832,0.026548673,0.026548673,99415.21239,18.70353982,0.119469027,99988.92478,0.994167234,0.00019208,1.79389E-06,0,0.022197558,32,27
D:0| T0: 0.10| T1: 28.00| R0: 0.0| R1: 0.0| WTP: 0,0,0.096153846,28,0,0,0,0,0,-789165407.6,898736779,6.008733495,788864970.9,78886497.09,1,24,2,1,1,0,1,24,0,1,0.061946903,0,0,99986.50442,1.566371681,0.017699115,99999.30088,0.999855611,1.85716E-05,2.04082E-07,0,0.041666667,14,9
D:0| T0: 0.10| T1: 28.00| R0: 0.0| R1: 0.0| WTP: 0,0,0.096153846,28,0,0,0,0,0,-3088891545,346473503,10727.65886,2552508602,255250860.2,2,97301,4553,675,1781,1106,675,97301,1106,1781,120.850211,1.320675105,3.622362869,71122.69831,1169.770042,5.046413502,99523.02532,0.659608143,0.013871708,6.14723E-05,0.620999439,0.018304026,58,28
D:0| T0: 0.10| T1: 28.00| R0: 0.0| R1: 0.0| WTP: 0,0,0.096153846,28,0,0,0,0,0,-3114277428,445552282,11444.91697,2542031579,254203157.9,2,94741,4173,742,1901,1159,742,94741,1159,1901,107.5340426,1.485106383,3.923404255,75292.51277,1149.63617,5.493617021,99548.63191,0.72169416,0.013044464,6.38228E-05,0.609679116,0.02006523,59,28
D:0| T0: 0.10| T1: 28.00| R0: 0.0| R1: 0.0| WTP: 0,0,0.096153846,28,0,0,0,0,0,-2011827938,911758476,8977.866356,1562934620,156293462,1,73322,3308,588,1491,903,588,73322,903,1491,232.6961326,3.132596685,8.071823204,54995.9779,1135.596685,11.35359116,99165.98895,0.475027389,0.013352622,0.000135158,0.605633803,0.020334961,22,17
D:0| T0: 0.10| T1: 28.00| R0: 0.0| R1: 0.0| WTP: 0,0,0.096153846,28,0,0,0,0,0,-3077860194,1464197940,10659.51497,2544884445,254488444.5,2,88860,4021,1571,1770,199,1571,88860,199,1770,109.6857749,3.167728238,3.57537155,41328.61571,1103.681529,6.89596603,98861.1189,0.416709617,0.011115184,7.14237E-05,0.112429379,0.019918974,68,28
D:0| T0: 0.10| T1: 28.00| R0: 0.0| R1: 0.0| WTP: 0,0,0.096153846,28,0,0,0,0,0,-1846187106,500405854,96.31167549,1841371522,184137152.2,1,815,38,16,16,0,16,815,0,16,2.195876289,0.015463918,0.015463918,99429.20619,17.81443299,0.103092784,99990.11856,0.994033317,0.000190615,1.74876E-06,0,0.019631902,26,21
D:0| T0: 0.10| T1: 28.00| R0: 0.0| R1: 0.0| WTP: 0,0,0.096153846,28,0,0,0,0,0,-3184520463,772037341,12791.10737,2544965094,254496509.4,2,95904,4131,758,2125,1367,758,95904,1367,2125,130.566416,1.771929825,5.172932331,66630.75689,790.5062657,7.077694236,99299.17293,0.667507693,0.00796617,7.27934E-05,0.643294118,0.022157574,57,28
D:0| T0: 0.10| T1: 28.00| R0: 0.0| R1: 0.0| WTP: 0,0,0.096153846,28,0,0,0,0,0,-614302229.6,1543158763,12.0575549,613699351.8,61369935.18,1,88,7,2,2,0,2,88,0,2,0.957446809,0,0,99948.54255,4.223404255,0.021276596,99999.11702,0.999429028,4.89161E-05,4.8193E-07,0,0.022988506,12,7
D:0| T0: 0.10| T1: 28.00| R0: 0.0| R1: 0.0| WTP: 0,0,0.096153846,28,0,0,0,0,0,-2760809633,1604932531,6975.221668,2412048550,241204855,1,49590,2060,647,1159,512,647,49590,512,1159,108.7584746,2.63559322,4.775423729,63899.97034,616.2457627,7.504237288,99204.4322,0.617890544,0.006618689,8.22141E-05,0.441760138,0.023371648,32,27
D:0| T0: 0.10| T1: 28.00| R0: 0.0| R1: 0.0| WTP: 0,0,0.096153846,28,0,0,0,0,0,-3139480943,539051477,11890.61375,2544950256,254495025.6,2,93564,4158,1579,1975,396,1579,93564,396,1975,114.6517857,3.359375,4.216517857,55947.14955,1191.602679,7.734375,99127.31473,0.528930925,0.012899251,8.58293E-05,0.200506329,0.021108546,60,28
D:0| T0: 0.10| T1: 28.00| R0: 0.0| R1: 0.0| WTP: 0,0,0.096153846,28,0,0,0,0,0,-351017927.4,1743124675,6.041964265,350715829.2,35071582.92,1,67,6,1,1,0,1,67,0,1,1.044776119,0,0,99964.02985,3.119402985,0.014925373,99999.62687,0.999618251,3.49208E-05,3.1746E-07,0,0.015151515,9,4
D:0| T0: 0.10| T1: 28.00| R0: 0.0| R1: 0.0| WTP: 0,0,0.096153846,28,0,0,0,0,0,-3127439840,1965983789,11797.85988,2537546846,253754684.6,2,90116,3828,851,1960,1109,851,90116,1109,1960,101.5095949,1.731343284,4.078891258,71074.47974,1125.385928,5.901918977,99425.73348,0.707489202,0.011485365,6.11741E-05,0.565816327,0.021749745,67,28
D:0| T0: 0.10| T1: 28.00| R0: 0.0| R1: 0.0| WTP: 0,0,0.096153846,28,0,0,0,0,0,-1317483978,516774280,48.14581302,1315076687,131507668.7,1,422,13,8,8,0,8,422,0,8,1.315068493,0.01369863,0.01369863,99708.17123,17.60273973,0.054794521,99995.21918,0.997096431,0.000179454,1.10349E-06,0,0.018957346,20,15
D:0| T0: 0.10| T1: 28.00| R0: 0.0| R1: 0.0| WTP: 0,0,0.096153846,28,0,0,0,0,0,-2178897392,86603142,10427.39956,1657527414,165752741.4,1,82662,3563,504,1732,1228,504,82662,1228,1732,273.1005917,2.917159763,10.14792899,41358.82249,1269.260355,13.13017751,98857.53254,0.376476684,0.013599575,0.000141862,0.709006928,0.020952796,23,18
D:0| T0: 0.10| T1: 28.00| R0: 0.0| R1: 0.0| WTP: 0,0,0.096153846,28,0,0,0,0,0,-1052438462,1431870609,12.02063183,1051837430,105183743,1,103,3,2,2,0,2,103,0,2,0.175438596,0,0,99929.74561,5.99122807,0.01754386,99998.69298,0.999313467,6.16529E-05,3.47828E-07,0,0.019417476,17,12
D:0| T0: 0.10| T1: 28.00| R0: 0.0| R1: 0.0| WTP: 0,0,0.096153846,28,0,0,0,0,0,-3120234942,1592383984,11553.20554,2542574664,254257466.4,2,90928,4053,753,1919,1166,753,90928,1166,1919,121.8564593,1.645933014,4.411483254,67776.33254,634.6196172,6.220095694,99362.11244,0.676182819,0.006436932,6.48293E-05,0.607608129,0.02110461,60,28
D:0| T0: 0.10| T1: 28.00| R0: 0.0| R1: 0.0| WTP: 0,0,0.096153846,28,0,0,0,0,0,-1845386120,1440183867,84.24197223,1841174021,184117402.1,1,562,23,14,14,0,14,562,0,14,1.653846154,0.032967033,0.032967033,99580.32967,14.44505495,0.104395604,99990.38462,0.995907812,0.00014591,1.53015E-06,0,0.024911032,26,21
D:0| T0: 0.10| T1: 28.00| R0: 0.0| R1: 0.0| WTP: 0,0,0.096153846,28,0,0,0,0,0,-1228510203,1696510588,24.08557134,1227305925,122730592.5,1,185,7,4,4,0,4,185,0,4,0.939393939,0,0,99886.80303,6.424242424,0.03030303,99998.94697,0.998873696,6.65158E-05,6.0607E-07,0,0.016304348,19,14
D:0| T0: 0.10| T1: 28.00| R0: 0.0| R1: 0.0| WTP: 0,0,0.096153846,28,0,0,0,0,0,-3188311882,895039877,12863.40097,2545141833,254514183.3,2,96135,4078,1185,2137,952,1185,96135,952,2137,122.3262411,2.63356974,4.858156028,58506.48227,1191.082742,7.654846336,99142.55319,0.572653378,0.012417946,8.18325E-05,0.445484324,0.022229157,59,28
D:0| T0: 0.10| T1: 28.00| R0: 0.0| R1: 0.0| WTP: 0,0,0.096153846,28,0,0,0,0,0,-3169998178,129565953,12597.44763,2540125797,254012579.7,2,91299,3875,914,2093,1179,914,91299,1179,2093,99.12145749,1.777327935,4.125506073,72702.07287,1298.445344,5.971659919,99438.34818,0.72636345,0.013142691,6.16311E-05,0.563306259,0.022924676,70,28
D:0| T0: 0.10| T1: 28.00| R0: 0.0| R1: 0.0| WTP: 0,0,0.096153846,28,0,0,0,0,0,-614205817.2,1902565669,12.02590655,613604521.8,61360452.18,1,159,7,2,2,0,2,159,0,2,0.337078652,0,0,99909.01124,6.584269663,0.02247191,99999.30337,0.999048342,7.11768E-05,4.70591E-07,0,0.012578616,12,7
D:0| T0: 0.10| T1: 28.00| R0: 0.0| R1: 0.0| WTP: 0,0,0.096153846,28,0,0,0,0,0,-1491498301,1984179288,24.09664827,1490293468,149029346.8,1,236,13,4,4,0,4,236,0,4,0.852941176,0,0,99849.64118,10.67058824,0.023529412,99997.91176,0.998310015,0.000121613,5.36921E-07,0,0.016949153,22,17
D:0| T0: 0.10| T1: 28.00| R0: 0.0| R1: 0.0| WTP: 0,0,0.096153846,28,0,0,0,0,0,-3154600224,677377223,12220.33317,2543583565,254358356.5,2,93618,4068,1239,2030,791,1239,93618,791,2030,114.509009,2.635135135,4.38963964,57702.81081,1715.914414,7.175675676,99147.62613,0.578377018,0.017295287,7.41744E-05,0.389655172,0.021683864,63,28
D:0| T0: 0.10| T1: 28.00| R0: 0.0| R1: 0.0| WTP: 0,0,0.096153846,28,0,0,0,0,0,-3127286125,973583301,11679.6069,2543305780,254330578,2,95391,4110,852,1940,1088,852,95391,1088,1940,123.9539952,1.949152542,4.549636804,65674.20823,1870.108959,6.605326877,99371.0678,0.655433885,0.018923216,6.84125E-05,0.560824742,0.020337562,59,28
D:0| T0: 0.10| T1: 28.00| R0: 0.0| R1: 0.0| WTP: 0,0,0.096153846,28,0,0,0,0,0,-1934003567,781062938,96.36862604,1929185135,192918513.5,1,768,40,16,16,0,16,768,0,16,2.836956522,0.032608696,0.032608696,99436.40761,20.13043478,0.114130435,99989.17391,0.994483096,0.000202611,1.72986E-06,0,0.020833333,27,22
D:0| T0: 0.10| T1: 28.00| R0: 0.0| R1: 0.0| WTP: 0,0,0.096153846,28,0,0,0,0,0,-3114873388,338783425,11309.25205,2549410785,254941078.5,2,95226,4349,795,1878,1083,795,95226,1083,1878,117.9614561,1.631691649,3.91862955,68856.69165,1663.385439,5.610278373,99449.49893,0.68326411,0.017041254,5.86557E-05,0.576677316,0.019721505,66,28
D:0| T0: 0.10| T1: 32.00| R0: 0.0| R1: 0.0| WTP: 0,0,0.096153846,32,0,0,0,0,0,-2807562546,650073325,48.15004379,2805155044,280515504.4,2,579,23,8,8,0,8,579,0,8,0.579081633,0,0,99718.25765,9.382653061,0.025510204,99996.30612,0.995919545,0.000133112,6.06082E-07,0,0.01208981,38,32
D:0| T0: 0.10| T1: 32.00| R0: 0.0| R1: 0.0| WTP: 0,0,0.096153846,32,0,0,0,0,0,-3474933683,2029998696,11607.891,2894539133,289453913.3,2,94804,4128,1247,1928,681,1247,94804,681,1928,120.4423529,2.76,4.334117647,58146.48235,754.5952941,7.268235294,99194.18588,0.574067777,0.007784358,7.70029E-05,0.353215768,0.020336695,60,32
D:0| T0: 0.10| T1: 32.00| R0: 0.0| R1: 0.0| WTP: 0,0,0.096153846,32,0,0,0,0,0,-3469058341,776062361,11688.93321,2884611680,288461168,2,85935,3604,1727,1942,215,1727,85935,215,1942,76.33047945,2.773972603,3.133561644,46729.46233,913.9178082,6.094178082,98827.29623,0.447122333,0.009627177,6.61685E-05,0.110710608,0.022599002,79,32
D:0| T0: 0.10| T1: 32.00| R0: 0.0| R1: 0.0| WTP: 0,0,0.096153846,32,0,0,0,0,0,-790143259.7,1813046880,24.0502197,788940748.7,78894074.87,1,100,3,4,4,0,4,100,0,4,0.505154639,0.020618557,0.020618557,99933.56701,5.783505155,0.06185567,99997.71134,0.999361715,5.9491E-05,8.16337E-07,0,0.04,14,9
D:0| T0: 0.10| T1: 32.00| R0: 0.0| R1: 0.0| WTP: 0,0,0.096153846,32,0,0,0,0,0,-969116302.8,2032407216,84.31581289,964900512.2,96490051.22,1,779,40,14,14,0,14,779,0,14,3.552845528,0.056910569,0.056910569,99539.73171,21.43902439,0.162601626,99992.72358,0.994948703,0.000239204,2.52268E-06,0,0.018018018,16,11
D:0| T0: 0.10| T1: 32.00| R0: 0.0| R1: 0.0| WTP: 0,0,0.096153846,32,0,0,0,0,0,-613612900.2,1507873352,0.019516484,613611924.4,61361192.44,1,20,3,0,0,0,0,20,0,0,0.359223301,0,0,99989.39806,1.747572816,0,100000,0.999877209,2.0814E-05,0,0,0,12,7
D:0| T0: 0.10| T1: 32.00| R0: 0.0| R1: 0.0| WTP: 0,0,0.096153846,32,0,0,0,0,0,-613940692.7,1855899401,6.032997232,613639042.8,61363904.28,1,115,5,1,1,0,1,115,0,1,0.6625,0,0,99925.2875,4.475,0.0125,99999.425,0.999253494,4.67503E-05,0.00000025,0,0.008695652,12,7
D:0| T0: 0.10| T1: 32.00| R0: 0.0| R1: 0.0| WTP: 0,0,0.096153846,32,0,0,0,0,0,-3509904465,1819459251,12357.56784,2892026073,289202607.3,2,92611,3971,774,2053,1279,774,92611,1279,2053,110.1872247,1.566079295,4.36123348,67883.95374,726.6762115,6.081497797,99326.2533,0.679803964,0.007324352,6.27439E-05,0.622990745,0.022167993,65,32
D:0| T0: 0.10| T1: 32.00| R0: 0.0| R1: 0.0| WTP: 0,0,0.096153846,32,0,0,0,0,0,-350960853.1,909791748,6.024030199,350659651.6,35065965.16,1,60,2,1,1,0,1,60,0,1,0.590163934,0,0,99965.06557,2.770491803,0.016393443,99999.70492,0.999655805,3.03226E-05,3.22581E-07,0,0.016949153,9,4
D:0| T0: 0.10| T1: 32.00| R0: 0.0| R1: 0.0| WTP: 0,0,0.096153846,32,0,0,0,0,0,-3479593735,1339092841,11922.39995,2883473738,288347373.8,2,87391,3625,801,1981,1180,801,87391,1180,1981,98.10722101,1.601750547,4.146608315,75549.68053,683.7899344,5.90809628,99480.407,0.7563673,0.006889429,6.13263E-05,0.595658758,0.022668238,66,32
D:0| T0: 0.10| T1: 32.00| R0: 0.0| R1: 0.0| WTP: 0,0,0.096153846,32,0,0,0,0,0,-3530321932,1365866345,12712.85074,2894679395,289467939.5,2,97285,4126,1052,2112,1060,1052,97285,1060,2112,114.3683036,2.200892857,4.540178571,65843.44643,679.3236607,6.901785714,99291.38839,0.617852099,0.007707451,8.00683E-05,0.501893939,0.021709634,57,32
D:0| T0: 0.10| T1: 32.00| R0: 0.0| R1: 0.0| WTP: 0,0,0.096153846,32,0,0,0,0,0,-3476070476,825453433,11619.87914,2895076519,289507651.9,2,93536,4175,727,1930,1203,727,93536,1203,1930,111.4989293,1.456102784,4.006423983,67750.23126,1016.648822,5.554603854,99390.2955,0.677891122,0.010237518,5.73142E-05,0.623316062,0.020633767,67,32
D:0| T0: 0.10| T1: 32.00| R0: 0.0| R1: 0.0| WTP: 0,0,0.096153846,32,0,0,0,0,0,-3488559937,939711378,11795.46014,2898786930,289878693,2,95557,4312,1286,1959,673,1286,95557,673,1959,124.5916473,2.821345708,4.366589327,51708.93968,872.5359629,7.352668213,99049.94664,0.519960028,0.00879141,7.5804E-05,0.343542624,0.020500853,62,32
D:0| T0: 0.10| T1: 32.00| R0: 0.0| R1: 0.0| WTP: 0,0,0.096153846,32,0,0,0,0,0,-2811136377,638950699,108.386626,2805717045,280571704.5,2,920,43,18,18,0,18,920,0,18,2.080769231,0.019230769,0.019230769,99325.93462,21.71153846,0.092307692,99987.01538,0.993398061,0.000218606,1.37943E-06,0,0.019565217,38,32
D:0| T0: 0.10| T1: 32.00| R0: 0.0| R1: 0.0| WTP: 0,0,0.096153846,32,0,0,0,0,0,-1141838461,938699148,42.12651908,1139732135,113973213.5,1,448,21,7,7,0,7,448,0,7,1.104895105,0.027972028,0.027972028,99750.46154,10.41958042,0.083916084,99996.03497,0.997085929,0.000124468,1.15705E-06,0,0.015625,18,13
D:0| T0: 0.10| T1: 32.00| R0: 0.0| R1: 0.0| WTP: 0,0,0.096153846,32,0,0,0,0,0,-1608662468,1412065496,524.0343361,1582460751,158246075.1,1,4166,192,87,87,0,87,4166,0,87,11.96566524,0.296137339,0.296137339,97987.71245,52.7167382,0.665236052,99961.07725,0.971141792,0.000765818,1.08795E-05,0,0.020888355,23,18
D:0| T0: 0.10| T1: 32.00| R0: 0.0| R1: 0.0| WTP: 0,0,0.096153846,32,0,0,0,0,0,-3470497726,1331335240,11594.87476,2890753988,289075398.8,2,89913,3844,1762,1926,164,1762,89913,164,1926,100.6729167,3.477083333,3.802083333,52122.39167,1235.389583,7.4875,99035.27708,0.51069153,0.012793909,7.9558E-05,0.085150571,0.021420945,67,32
D:0| T0: 0.10| T1: 32.00| R0: 0.0| R1: 0.0| WTP: 0,0,0.096153846,32,0,0,0,0,0,-2256898098,470935411,10400.72688,1736861754,173686175.4,1,76553,3241,665,1728,1063,665,76553,1063,1728,218.4385027,3.470588235,9.080213904,51483.99465,1060.395722,12.61497326,98995.65241,0.457515785,0.011972692,0.000144568,0.615162037,0.022572892,24,19
D:0| T0: 0.10| T1: 32.00| R0: 0.0| R1: 0.0| WTP: 0,0,0.096153846,32,0,0,0,0,0,-1580920072,823434397,60.11843935,1577914150,157791415,1,521,14,10,10,0,10,521,0,10,0.73125,0.01875,0.01875,99655.375,15.425,0.075,99994.88125,0.996611501,0.00015603,1.24229E-06,0,0.019230769,23,18
D:0| T0: 0.10| T1: 32.00| R0: 0.0| R1: 0.0| WTP: 0,0,0.096153846,32,0,0,0,0,0,-525966716.9,493045351,0.020043956,525965714.7,52596571.47,1,140,7,0,0,0,0,140,0,0,0.493506494,0,0,99918.5974,4.74025974,0,100000,0.999168158,5.05263E-05,0,0,0,11,6
D:0| T0: 0.10| T1: 32.00| R0: 0.0| R1: 0.0| WTP: 0,0,0.096153846,32,0,0,0,0,0,-1666457118,1700216563,18.07842027,1665553197,166555319.7,1,285,12,3,3,0,3,285,0,3,0.727272727,0,0,99812.71515,8.690909091,0.018181818,99998.15152,0.998150074,8.88566E-05,3.61449E-07,0,0.01056338,24,19
D:0| T0: 0.10| T1: 32.00| R0: 0.0| R1: 0.0| WTP: 0,0,0.096153846,32,0,0,0,0,0,-1325431175,1744119059,180.6954829,1316396400,131639640,1,1555,78,30,30,0,30,1555,0,30,6.927536232,0.137681159,0.137681159,98907.02899,29.65217391,0.34057971,99980.17391,0.989289112,0.000296518,4.31714E-06,0,0.019292605,20,15
D:0| T0: 0.10| T1: 32.00| R0: 0.0| R1: 0.0| WTP: 0,0,0.096153846,32,0,0,0,0,0,-701896219.8,2036906360,12.03909336,701294265.1,70129426.51,1,90,7,2,2,0,2,90,0,2,0.5,0,0,99953.46364,5.272727273,0.018181818,99998.94545,0.999462571,6.35494E-05,4.3011E-07,0,0.022222222,13,8
D:0| T0: 0.10| T1: 32.00| R0: 0.0| R1: 0.0| WTP: 0,0,0.096153846,32,0,0,0,0,0,-3415717838,809704121,10424.64535,2894485570,289448557,2,91057,4110,747,1731,984,747,91057,984,1731,108.2333333,1.479166667,3.502083333,73911.60625,981.3895833,5.06875,99545.80417,0.738259663,0.009916985,5.21798E-05,0.568457539,0.019010071,68,32
D:0| T0: 0.10| T1: 32.00| R0: 0.0| R1: 0.0| WTP: 0,0,0.096153846,32,0,0,0,0,0,-3498624100,1219866412,12017.32107,2897758047,289775804.7,2,95885,4318,1307,1996,689,1307,95885,689,1996,121.2173913,2.832951945,4.38215103,58292.09153,1794.949657,7.356979405,99191.34783,0.584624333,0.01808916,7.61203E-05,0.345190381,0.020816603,63,32
D:0| T0: 0.10| T1: 32.00| R0: 0.0| R1: 0.0| WTP: 0,0,0.096153846,32,0,0,0,0,0,-527532089.2,843498920,30.06529385,526028824.5,52602882.45,1,89,7,5,5,0,5,89,0,5,1.013333333,0,0,99943.44,5.053333333,0.08,99997.84,0.999459456,5.19746E-05,1.31582E-06,0,0.057471264,11,6
D:0| T0: 0.10| T1: 32.00| R0: 0.0| R1: 0.0| WTP: 0,0,0.096153846,32,0,0,0,0,0,-1056001584,107351963,78.1609805,1052093535,105209353.5,1,429,18,13,13,0,13,429,0,13,1.387931034,0.043103448,0.043103448,99715.08621,23.24137931,0.155172414,99993.66379,0.997198116,0.000234582,2.24151E-06,0,0.03030303,17,12
D:0| T0: 0.10| T1: 32.00| R0: 0.0| R1: 0.0| WTP: 0,0,0.096153846,32,0,0,0,0,0,-1229355149,773789021,42.0817004,1227251064,122725106.4,1,333,12,7,7,0,7,333,0,7,0.622222222,0.007407407,0.007407407,99783.48148,16.42222222,0.059259259,99996.36296,0.997845037,0.000167467,1.04481E-06,0,0.021021021,19,14
D:0| T0: 0.10| T1: 32.00| R0: 0.0| R1: 0.0| WTP: 0,0,0.096153846,32,0,0,0,0,0,-3514840692,850936611,12583.71056,2885655164,288565516.4,2,91324,3685,744,2091,1347,744,91324,1347,2091,93.96122449,1.43877551,4.155102041,73198.45102,983.6265306,5.689795918,99440.62653,0.724489971,0.010206257,6.00566E-05,0.644189383,0.0228965,68,32
D:0| T0: 0.10| T1: 32.00| R0: 0.0| R1: 0.0| WTP: 0,0,0.096153846,32,0,0,0,0,0,-2216888293,1701318364,433.6792622,2195204330,219520433,1,3844,167,72,72,0,72,3844,0,72,10.58064516,0.230414747,0.230414747,97320.96774,75.29493088,0.562211982,99952.08756,0.972178328,0.00079515,6.99271E-06,0,0.018730489,30,25
D:0| T0: 0.10| T1: 32.00| R0: 0.0| R1: 0.0| WTP: 0,0,0.096153846,32,0,0,0,0,0,-701235203.9,778708269,0.010549451,701234676.5,70123467.65,1,42,2,0,0,0,0,42,0,0,0.224719101,0,0,99973.55056,3.516853933,0,100000,0.99972908,3.7931E-05,0,0,0,13,8
D:0| T0: 0.10| T1: 32.00| R0: 0.0| R1: 0.0| WTP: 0,0,0.096153846,32,0,0,0,0,0,-1149072005,1391938506,174.4410021,1140349954,114034995.4,1,765,35,29,29,0,29,765,0,29,4.184,0.072,0.072,99465.488,22.664,0.328,99983.104,0.994835265,0.000227169,4.60381E-06,0,0.037908497,18,13
D:0| T0: 0.10| T1: 32.00| R0: 0.0| R1: 0.0| WTP: 0,0,0.096153846,32,0,0,0,0,0,-789483172.3,43418681,12.01852194,788882246.2,78888224.62,1,96,6,2,2,0,2,96,0,2,0.173913043,0,0,99939.82609,6.27173913,0.02173913,99998.92391,0.999412034,6.43017E-05,4.3011E-07,0,0.020833333,14,9
D:0| T0: 0.10| T1: 32.00| R0: 0.0| R1: 0.0| WTP: 0,0,0.096153846,32,0,0,0,0,0,-1933022618,817384966,4700.967959,1697974220,169797422,1,35075,1454,502,781,279,502,35075,279,781,109.7559524,2.880952381,4.5,74182.78571,570.8452381,7.494047619,99474.94048,0.741220086,0.005799161,7.75974E-05,0.357234315,0.022266572,24,19
D:0| T0: 0.10| T1: 32.00| R0: 0.0| R1: 0.0| WTP: 0,0,0.096153846,32,0,0,0,0,0,-2060199363,762053968,2270.112325,1946693747,194669374.7,1,18589,805,352,377,25,352,18589,25,377,54.70157068,1.680628272,1.806282723,86422.54974,305.2356021,3.638743455,99746.60209,0.865141197,0.003076137,3.84398E-05,0.066312997,0.020280811,27,22
D:0| T0: 0.10| T1: 32.00| R0: 0.0| R1: 0.0| WTP: 0,0,0.096153846,32,0,0,0,0,0,-2022117363,1692506311,114.2434419,2016405191,201640519.1,1,554,21,19,19,0,19,554,0,19,1.185185185,0.027777778,0.027777778,99635.78241,17.24537037,0.115740741,99988.91667,0.996212583,0.000186105,1.88135E-06,0,0.03442029,28,23
D:0| T0: 0.10| T1: 32.00| R0: 0.0| R1: 0.0| WTP: 0,0,0.096153846,32,0,0,0,0,0,-2529871727,883828863,8869.02478,2086420488,208642048.8,1,72399,3225,693,1473,780,693,72399,780,1473,127.8454259,2.129337539,4.545741325,68328.85174,597.7917981,6.738170347,99401.89905,0.481055828,0.00987943,0.000113073,0.529531568,0.020345866,28,23
D:0| T0: 0.10| T1: 32.00| R0: 0.0| R1: 0.0| WTP: 0,0,0.096153846,32,0,0,0,0,0,-879289142.1,301400999,48.16217016,876881033.6,87688103.36,1,430,19,8,8,0,8,430,0,8,2.203883495,0.009708738,0.009708738,99719.3301,17.98058252,0.077669903,99996.08738,0.997240136,0.000180391,1.53851E-06,0,0.01627907,15,10
D:0| T0: 0.10| T1: 32.00| R0: 0.0| R1: 0.0| WTP: 0,0,0.096153846,32,0,0,0,0,0,-3516457375,1868336855,12406.97659,2896108546,289610854.6,2,95763,4211,921,2061,1140,921,95763,1140,2061,124.0521327,2.007109005,4.68957346,65626.66825,887.7914692,6.874407583,99311.06398,0.657230363,0.008947248,7.11834E-05,0.553129549,0.021521882,61,32
D:0| T0: 0.10| T1: 32.00| R0: 0.0| R1: 0.0| WTP: 0,0,0.096153846,32,0,0,0,0,0,-3543498441,1868498144,13000.67668,2893464607,289346460.7,2,95095,4046,970,2160,1190,970,95095,1190,2160,119.2216981,2.110849057,4.891509434,66004.93632,938.9976415,7.183962264,99281.92925,0.661177647,0.009468035,7.44044E-05,0.550925926,0.022714128,61,32
D:0| T0: 0.10| T1: 32.00| R0: 0.0| R1: 0.0| WTP: 0,0,0.096153846,32,0,0,0,0,0,-1316208864,2101566889,24.10086805,1315003820,131500382,1,197,10,4,4,0,4,197,0,4,1.092857143,0,0,99871.20714,8.478571429,0.028571429,99998.49286,0.998730896,8.63841E-05,5.67384E-07,0,0.020304569,20,15
D:0| T0: 0.10| T1: 32.00| R0: 0.0| R1: 0.0| WTP: 0,0,0.096153846,32,0,0,0,0,0,-2506479601,1665097450,8601.545333,2076402335,207640233.5,1,65856,2797,727,1429,702,727,65856,702,1429,150.0829694,3.091703057,6.091703057,59978.36681,986.6637555,9.279475983,99187.04803,0.531996643,0.011669175,0.000111386,0.491252624,0.021699188,28,23
D:0| T0: 0.10| T1: 32.00| R0: 0.0| R1: 0.0| WTP: 0,0,0.096153846,32,0,0,0,0,0,-3134140790,1716179948,7100.749478,2779103316,277910331.6,1,62522,2888,904,1179,275,904,62522,275,1179,143.4939271,3.530364372,4.591093117,55256.96761,870.6153846,8.255060729,99212.95951,0.556409872,0.008722186,8.44886E-05,0.233248516,0.018857362,36,31
D:0| T0: 0.10| T1: 32.00| R0: 0.0| R1: 0.0| WTP: 0,0,0.096153846,32,0,0,0,0,0,-968211161.5,1560278715,72.20920854,964600701.1,96460070.11,1,378,20,12,12,0,12,378,0,12,1.911111111,0.044444444,0.044444444,99801.24444,9.266666667,0.140740741,99995.45926,0.997746913,0.000108893,2.05139E-06,0,0.031830239,16,11
D:0| T0: 0.10| T1: 32.00| R0: 0.0| R1: 0.0| WTP: 0,0,0.096153846,32,0,0,0,0,0,-3533834560,991019385,12767.16189,2895476466,289547646.6,2,96759,4167,1080,2121,1041,1080,96759,1041,2121,127.9579208,2.49009901,5.042079208,65134.96287,1424.782178,7.712871287,99295.42574,0.652625818,0.014363323,7.98189E-05,0.490806223,0.021920442,58,32
D:0| T0: 0.10| T1: 32.00| R0: 0.0| R1: 0.0| WTP: 0,0,0.096153846,32,0,0,0,0,0,-3525700793,118052103,12681.88633,2891606476,289160647.6,2,94237,3926,1165,2107,942,1165,94237,942,2107,115.6079812,2.582159624,4.76056338,68104.73239,1120.025822,7.514084507,99346.29343,0.666233591,0.011848413,8.1192E-05,0.447081158,0.022358522,58,32
D:0| T0: 0.10| T1: 32.00| R0: 0.0| R1: 0.0| WTP: 0,0,0.096153846,32,0,0,0,0,0,-3508116909,1209758844,12428.25254,2886704282,288670428.2,2,87367,3677,1607,2065,458,1607,87367,458,2065,91.749499,3.070140281,3.963927856,55719.16633,510.3627255,7.168336673,98999.21443,0.536655091,0.005429384,7.8233E-05,0.221791768,0.023636197,68,32
D:0| T0: 0.10| T1: 32.00| R0: 0.0| R1: 0.0| WTP: 0,0,0.096153846,32,0,0,0,0,0,-1052947058,70671723,18.09266202,1052042425,105204242.5,1,127,9,3,3,0,3,127,0,3,1.204918033,0,0,99909.68033,6.418032787,0.024590164,99998.28689,0.999087878,6.70596E-05,5.04207E-07,0,0.023622047,17,12
D:0| T0: 0.10| T1: 32.00| R0: 0.0| R1: 0.0| WTP: 0,0,0.096153846,32,0,0,0,0,0,-1052433031,1722612191,12.01904941,1051832078,105183207.8,1,52,2,2,2,0,2,52,0,2,0.137096774,0,0,99968.91129,2.266129032,0.016129032,99999.69355,0.999688942,2.43903E-05,3.25205E-07,0,0.019230769,17,12
D:0| T0: 0.10| T1: 32.00| R0: 0.0| R1: 0.0| WTP: 0,0,0.096153846,32,0,0,0,0,0,-1315580982,1968291596,12.08340106,1314976812,131497681.2,1,74,4,2,2,0,2,74,0,2,0.939189189,0,0,99953.10135,2.054054054,0.013513514,99999.31757,0.999506154,2.30435E-05,2.89857E-07,0,0.027027027,20,15
D:0| T0: 0.10| T1: 32.00| R0: 0.0| R1: 0.0| WTP: 0,0,0.096153846,32,0,0,0,0,0,-2786191699,1877569084,7379.32745,2417225327,241722532.7,1,54489,2272,800,1226,426,800,54489,426,1226,124.8384279,3.384279476,5.19650655,62121.41048,760.4061135,8.681222707,99200.20961,0.608616732,0.007964239,9.26726E-05,0.347471452,0.022499954,32,27
D:0| T0: 0.10| T1: 32.00| R0: 0.0| R1: 0.0| WTP: 0,0,0.096153846,32,0,0,0,0,0,-3282427743,1726322189,8331.581836,2865848652,286584865.2,1,64430,2780,922,1384,462,922,64430,462,1384,132.0343511,3.423664122,5.129770992,53690.77099,834.2099237,8.65648855,99069.10687,0.530405135,0.008561652,9.03579E-05,0.333815029,0.021480677,37,32
D:0| T0: 0.10| T1: 32.00| R0: 0.0| R1: 0.0| WTP: 0,0,0.096153846,32,0,0,0,0,0,-3497026269,307848836,12093.68527,2892342005,289234200.5,2,92329,3963,1372,2009,637,1372,92329,637,2009,107.0863931,2.816414687,4.172786177,53080.29806,699.9136069,7.11663067,99050.7149,0.533558311,0.007052611,7.35512E-05,0.317073171,0.021759144,67,32
D:0| T0: 0.10| T1: 32.00| R0: 0.0| R1: 0.0| WTP: 0,0,0.096153846,32,0,0,0,0,0,-2428005378,1154000220,8622.134929,1996898631,199689863.1,1,70493,3203,573,1432,859,573,70493,859,1432,213.7567568,2.978378378,7.589189189,45278.82162,991.427027,10.7027027,98967.50811,0.457113026,0.009926297,0.000108592,0.599860335,0.020314074,27,22
D:0| T0: 0.10| T1: 32.00| R0: 0.0| R1: 0.0| WTP: 0,0,0.096153846,32,0,0,0,0,0,-1052833485,2028661055,18.05783785,1051930593,105193059.3,1,112,6,3,3,0,3,112,0,3,0.629310345,0.017241379,0.017241379,99925.72414,5.24137931,0.043103448,99998.93103,0.999270844,5.44448E-05,5.12824E-07,0,0.026785714,17,12
D:0| T0: 0.10| T1: 32.00| R0: 0.0| R1: 0.0| WTP: 0,0,0.096153846,32,0,0,0,0,0,-3493776715,1629114640,11986.01918,2894475756,289447575.6,2,95470,4181,771,1991,1220,771,95470,1220,1991,110.4047109,1.541755889,4.128479657,68830.88223,1270.014989,5.762312634,99407.67238,0.688570257,0.012794426,5.95994E-05,0.612757408,0.020854719,67,32
D:0| T0: 0.10| T1: 32.00| R0: 0.0| R1: 0.0| WTP: 0,0,0.096153846,32,0,0,0,0,0,-3259939719,1439048174,7958.027189,2862038359,286203835.9,2,58598,2586,952,1322,370,952,58598,370,1322,110.6643836,3.157534247,4.386986301,56460.59247,852.8356164,7.657534247,99064.69178,0.564867544,0.00864515,7.89396E-05,0.279878971,0.022560497,42,32
D:0| T0: 0.10| T1: 32.00| R0: 0.0| R1: 0.0| WTP: 0,0,0.096153846,32,0,0,0,0,0,-2429458360,865227006,10387.96343,1910060189,191006018.9,1,77049,3206,516,1726,1210,516,77049,1210,1726,192.7427184,2.432038835,8.266990291,47539.26699,1004.548544,10.77669903,98903.93689,0.397248879,0.011652111,0.000126356,0.701042874,0.022401329,26,21
D:0| T0: 0.10| T1: 32.00| R0: 0.0| R1: 0.0| WTP: 0,0,0.096153846,32,0,0,0,0,0,-3472756826,890479738,11536.49392,2895932130,289593213,2,90757,4048,1715,1916,201,1715,90757,201,1916,100.3463035,3.163424125,3.546692607,48811.72374,1266.675097,6.883268482,98977.54475,0.490535393,0.012764114,7.11691E-05,0.104906054,0.021111319,74,32
D:0| T0: 0.10| T1: 32.00| R0: 0.0| R1: 0.0| WTP: 0,0,0.096153846,32,0,0,0,0,0,-527585116.1,1017049163,30.08270044,526080981,52608098.1,1,206,7,5,5,0,5,206,0,5,1.415584416,0,0,99874.22078,8.922077922,0.077922078,99997.54545,0.998771236,9.08995E-05,1.28208E-06,0,0.024271845,11,6
D:0| T0: 0.10| T1: 32.00| R0: 0.0| R1: 0.0| WTP: 0,0,0.096153846,32,0,0,0,0,0,-525937956.2,1707305064,0.011604396,525937375.9,52593737.59,1,42,2,0,0,0,0,42,0,0,0.258823529,0,0,99976.75294,2.105882353,0,100000,0.999740263,2.59211E-05,0,0,0,11,6
D:0| T0: 0.10| T1: 32.00| R0: 0.0| R1: 0.0| WTP: 0,0,0.096153846,32,0,0,0,0,0,-2139519155,400145663,9835.667205,1647735795,164773579.5,1,73632,3191,470,1634,1164,470,73632,1164,1634,251.75,2.86875,10.1,43556.6625,1234.725,13.04375,98834.25,0.440080531,0.01236459,0.000131774,0.712362301,0.022191439,23,18
D:0| T0: 0.10| T1: 32.00| R0: 0.0| R1: 0.0| WTP: 0,0,0.096153846,32,0,0,0,0,0,-525941393.5,1662654181,0.012131868,525940786.9,52594078.69,1,82,5,0,0,0,0,82,0,0,0.319444444,0,0,99949.04167,4.236111111,0,100000,0.999493151,4.41096E-05,0,0,0,11,6
D:0| T0: 0.10| T1: 32.00| R0: 0.0| R1: 0.0| WTP: 0,0,0.096153846,32,0,0,0,0,0,-2913521010,182136456,4924.857848,2667278117,266727811.7,1,40686,1786,622,818,196,622,40686,196,818,85.93975904,2.381526104,3.140562249,68996.13655,567.313253,5.614457831,99406.85944,0.687811385,0.005790945,5.90202E-05,0.239608802,0.02010569,35,30
D:0| T0: 0.10| T1: 32.00| R0: 0.0| R1: 0.0| WTP: 0,0,0.096153846,32,0,0,0,0,0,-526250066.5,979575387,6.020337891,525949049.6,52594904.96,1,39,2,1,1,0,1,39,0,1,0.397260274,0,0,99973.34247,3.178082192,0.01369863,99999.63014,0.999739188,3.32433E-05,2.7027E-07,0,0.025641026,11,6
D:0| T0: 0.10| T1: 32.00| R0: 0.0| R1: 0.0| WTP: 0,0,0.096153846,32,0,0,0,0,0,-3503175487,2142525414,12290.77468,2888636753,288863675.3,2,91147,3840,1690,2042,352,1690,91147,352,2042,100.8150538,3.462365591,4.208602151,53719.53763,766.4774194,7.825806452,99014.29892,0.526797579,0.007949657,8.3199E-05,0.17238002,0.02240337,65,32
D:0| T0: 0.10| T1: 32.00| R0: 0.0| R1: 0.0| WTP: 0,0,0.096153846,32,0,0,0,0,0,-3470801396,1464057597,11535.63561,2894019616,289401961.6,2,90987,4029,1165,1916,751,1165,90987,751,1916,124.1313869,2.649635036,4.440389294,67063.53285,827.7931873,7.309002433,99363.53771,0.671036388,0.008357295,7.56443E-05,0.391962422,0.021057953,59,32
D:0| T0: 0.10| T1: 32.00| R0: 0.0| R1: 0.0| WTP: 0,0,0.096153846,32,0,0,0,0,0,-3450940726,364562610,11275.36012,2887172721,288717272.1,2,86129,3726,1603,1873,270,1603,86129,270,1873,97.98942918,3.213530655,3.758985201,51551.71036,615,7.141649049,98986.69556,0.514202555,0.006262434,7.48042E-05,0.144230769,0.021735092,67,32
D:0| T0: 0.10| T1: 32.00| R0: 0.0| R1: 0.0| WTP: 0,0,0.096153846,32,0,0,0,0,0,-3452560967,40350784,11299.55149,2887583393,288758339.3,2,87147,3723,1691,1877,186,1691,87147,186,1877,102.4449339,3.528634361,3.916299559,54153.73789,742.1475771,7.651982379,99062.55507,0.54468836,0.007476744,7.91417E-05,0.099094299,0.021538567,65,32
D:0| T0: 0.10| T1: 32.00| R0: 0.0| R1: 0.0| WTP: 0,0,0.096153846,32,0,0,0,0,0,-2505830727,804064356,873.3914557,2462161154,246216115.4,1,8065,346,145,145,0,145,8065,0,145,19.31512605,0.470588235,0.470588235,94387.64286,97.62184874,1.067226891,99905.22269,0.941649961,0.001031097,1.28409E-05,0,0.017978921,33,28
D:0| T0: 0.10| T1: 32.00| R0: 0.0| R1: 0.0| WTP: 0,0,0.096153846,32,0,0,0,0,0,-1591445843,2125493986,246.6775898,1579111963,157911196.3,1,1624,65,41,41,0,41,1624,0,41,4.919753086,0.148148148,0.148148148,98779.08642,31.29012346,0.388888889,99971.61111,0.988023329,0.000315492,5.06271E-06,0,0.025246305,23,18
D:0| T0: 0.10| T1: 32.00| R0: 0.0| R1: 0.0| WTP: 0,0,0.096153846,32,0,0,0,0,0,-3377307936,23154253,9697.380161,2892438928,289243892.8,2,88339,4077,980,1610,630,980,88339,630,1610,115.1045455,2.05,3.456818182,66561.68864,538.0068182,5.668181818,99424.85909,0.660311748,0.005524715,6.04088E-05,0.391304348,0.018225246,62,32
D:0| T0: 0.10| T1: 32.00| R0: 0.0| R1: 0.0| WTP: 0,0,0.096153846,32,0,0,0,0,0,-1142623034,1391367689,54.19463992,1139913302,113991330.2,1,338,17,9,9,0,9,338,0,9,2.113636364,0.007575758,0.007575758,99793.95455,9.575757576,0.068181818,99995.55303,0.99782669,0.000104557,1.46347E-06,0,0.026627219,18,13
D:0| T0: 0.10| T1: 32.00| R0: 0.0| R1: 0.0| WTP: 0,0,0.096153846,32,0,0,0,0,0,-2373249439,574142276,120.3212743,2367233375,236723337.5,1,904,35,20,20,0,20,904,0,20,1.743362832,0.026548673,0.026548673,99415.21239,18.70353982,0.119469027,99988.92478,0.994167234,0.00019208,1.79389E-06,0,0.022197558,32,27
D:0| T0: 0.10| T1: 32.00| R0: 0.0| R1: 0.0| WTP: 0,0,0.096153846,32,0,0,0,0,0,-789165407.6,898736779,6.008733495,788864970.9,78886497.09,1,24,2,1,1,0,1,24,0,1,0.061946903,0,0,99986.50442,1.566371681,0.017699115,99999.30088,0.999855611,1.85716E-05,2.04082E-07,0,0.041666667,14,9
D:0| T0: 0.10| T1: 32.00| R0: 0.0| R1: 0.0| WTP: 0,0,0.096153846,32,0,0,0,0,0,-3429558157,346473503,10547.18703,2902198806,290219880.6,2,97226,4570,675,1751,1076,675,97226,1076,1751,116.0552147,1.267893661,3.445807771,74481.28425,1137.04908,4.832310838,99587.76483,0.700794813,0.013412613,5.8536E-05,0.614505997,0.018009586,60,32
D:0| T0: 0.10| T1: 32.00| R0: 0.0| R1: 0.0| WTP: 0,0,0.096153846,32,0,0,0,0,0,-3492911225,445552282,12021.19922,2891851264,289185126.4,2,94891,3997,720,1997,1277,720,94891,1277,1997,92.94609665,1.256505576,3.611524164,72131.38104,1006.120818,4.946096654,99453.96097,0.691185235,0.011243994,5.64566E-05,0.639459189,0.021045199,69,32
D:0| T0: 0.10| T1: 32.00| R0: 0.0| R1: 0.0| WTP: 0,0,0.096153846,32,0,0,0,0,0,-2011827938,911758476,8977.866356,1562934620,156293462,1,73322,3308,588,1491,903,588,73322,903,1491,232.6961326,3.132596685,8.071823204,54995.9779,1135.596685,11.35359116,99165.98895,0.475027389,0.013352622,0.000135158,0.605633803,0.020334961,22,17
D:0| T0: 0.10| T1: 32.00| R0: 0.0| R1: 0.0| WTP: 0,0,0.096153846,32,0,0,0,0,0,-3426144701,1464197940,10670.57296,2892616054,289261605.4,2,88925,3994,1582,1772,190,1582,88925,190,1772,96.24131274,2.891891892,3.243243243,42090.53668,1001.750965,6.281853282,98871.69691,0.424546122,0.010090783,6.52103E-05,0.107223476,0.019926905,74,32
D:0| T0: 0.10| T1: 32.00| R0: 0.0| R1: 0.0| WTP: 0,0,0.096153846,32,0,0,0,0,0,-1846187106,500405854,96.31167549,1841371522,184137152.2,1,815,38,16,16,0,16,815,0,16,2.195876289,0.015463918,0.015463918,99429.20619,17.81443299,0.103092784,99990.11856,0.994033317,0.000190615,1.74876E-06,0,0.019631902,26,21
D:0| T0: 0.10| T1: 32.00| R0: 0.0| R1: 0.0| WTP: 0,0,0.096153846,32,0,0,0,0,0,-2715436198,772037341,1516.694091,2639601493,263960149.3,1,10466,464,251,252,1,251,10466,1,252,23.22222222,0.872427984,0.87654321,91911.48971,139.7942387,1.9218107,99816.16461,0.920893209,0.001396184,2.06399E-05,0.003968254,0.024082569,35,30
D:0| T0: 0.10| T1: 32.00| R0: 0.0| R1: 0.0| WTP: 0,0,0.096153846,32,0,0,0,0,0,-614302229.6,1543158763,12.0575549,613699351.8,61369935.18,1,88,7,2,2,0,2,88,0,2,0.957446809,0,0,99948.54255,4.223404255,0.021276596,99999.11702,0.999429028,4.89161E-05,4.8193E-07,0,0.022988506,12,7
D:0| T0: 0.10| T1: 32.00| R0: 0.0| R1: 0.0| WTP: 0,0,0.096153846,32,0,0,0,0,0,-2760809633,1604932531,6975.221668,2412048550,241204855,1,49590,2060,647,1159,512,647,49590,512,1159,108.7584746,2.63559322,4.775423729,63899.97034,616.2457627,7.504237288,99204.4322,0.617890544,0.006618689,8.22141E-05,0.441760138,0.023371648,32,27
D:0| T0: 0.10| T1: 32.00| R0: 0.0| R1: 0.0| WTP: 0,0,0.096153846,32,0,0,0,0,0,-3502990498,539051477,12166.61743,2894659626,289465962.6,2,92880,4051,1677,2021,344,1677,92880,344,2021,105.1452282,3.302904564,4,56227.65145,1101.058091,7.477178423,99110.861,0.53470783,0.011859869,8.26109E-05,0.170212766,0.021759259,65,32
D:0| T0: 0.10| T1: 32.00| R0: 0.0| R1: 0.0| WTP: 0,0,0.096153846,32,0,0,0,0,0,-351017927.4,1743124675,6.041964265,350715829.2,35071582.92,1,67,6,1,1,0,1,67,0,1,1.044776119,0,0,99964.02985,3.119402985,0.014925373,99999.62687,0.999618251,3.49208E-05,3.1746E-07,0,0.015151515,9,4
D:0| T0: 0.10| T1: 32.00| R0: 0.0| R1: 0.0| WTP: 0,0,0.096153846,32,0,0,0,0,0,-3470981600,1965983789,11606.51416,2890655892,289065589.2,2,89433,3851,834,1928,1094,834,89433,1094,1928,98.10358566,1.591633466,3.743027888,71887.04183,1033.884462,5.400398406,99444.21116,0.715985954,0.010542793,5.61103E-05,0.567427386,0.021558279,71,32
D:0| T0: 0.10| T1: 32.00| R0: 0.0| R1: 0.0| WTP: 0,0,0.096153846,32,0,0,0,0,0,-1317483978,516774280,48.14581302,1315076687,131507668.7,1,422,13,8,8,0,8,422,0,8,1.315068493,0.01369863,0.01369863,99708.17123,17.60273973,0.054794521,99995.21918,0.997096431,0.000179454,1.10349E-06,0,0.018957346,20,15
D:0| T0: 0.10| T1: 32.00| R0: 0.0| R1: 0.0| WTP: 0,0,0.096153846,32,0,0,0,0,0,-2178897392,86603142,10427.39956,1657527414,165752741.4,1,82662,3563,504,1732,1228,504,82662,1228,1732,273.1005917,2.917159763,10.14792899,41358.82249,1269.260355,13.13017751,98857.53254,0.376476684,0.013599575,0.000141862,0.709006928,0.020952796,23,18
D:0| T0: 0.10| T1: 32.00| R0: 0.0| R1: 0.0| WTP: 0,0,0.096153846,32,0,0,0,0,0,-1052438462,1431870609,12.02063183,1051837430,105183743,1,103,3,2,2,0,2,103,0,2,0.175438596,0,0,99929.74561,5.99122807,0.01754386,99998.69298,0.999313467,6.16529E-05,3.47828E-07,0,0.019417476,17,12
D:0| T0: 0.10| T1: 32.00| R0: 0.0| R1: 0.0| WTP: 0,0,0.096153846,32,0,0,0,0,0,-3436527743,1592383984,10892.17824,2891918831,289191883.1,2,91162,4088,744,1809,1065,744,91162,1065,1809,113.3040541,1.513513514,3.887387387,70184.31982,601.4234234,5.56981982,99442.7545,0.700467508,0.006095717,5.82698E-05,0.588723051,0.019843795,63,32
D:0| T0: 0.10| T1: 32.00| R0: 0.0| R1: 0.0| WTP: 0,0,0.096153846,32,0,0,0,0,0,-1845386120,1440183867,84.24197223,1841174021,184117402.1,1,562,23,14,14,0,14,562,0,14,1.653846154,0.032967033,0.032967033,99580.32967,14.44505495,0.104395604,99990.38462,0.995907812,0.00014591,1.53015E-06,0,0.024911032,26,21
D:0| T0: 0.10| T1: 32.00| R0: 0.0| R1: 0.0| WTP: 0,0,0.096153846,32,0,0,0,0,0,-1228510203,1696510588,24.08557134,1227305925,122730592.5,1,185,7,4,4,0,4,185,0,4,0.939393939,0,0,99886.80303,6.424242424,0.03030303,99998.94697,0.998873696,6.65158E-05,6.0607E-07,0,0.016304348,19,14
D:0| T0: 0.10| T1: 32.00| R0: 0.0| R1: 0.0| WTP: 0,0,0.096153846,32,0,0,0,0,0,-3514601886,895039877,12376.97903,2895752934,289575293.4,2,96111,4115,1227,2056,829,1227,96111,829,2056,114.8558758,2.563192905,4.372505543,60232.08869,1119.257206,7.090909091,99196.27494,0.5915292,0.011644716,7.56733E-05,0.403210117,0.021391932,63,32
D:0| T0: 0.10| T1: 32.00| R0: 0.0| R1: 0.0| WTP: 0,0,0.096153846,32,0,0,0,0,0,-3514790815,129565953,12471.47901,2891216864,289121686.4,2,91520,3944,896,2072,1176,896,91520,1176,2072,94.07633588,1.643129771,3.854961832,71337.35305,1232.242366,5.557251908,99408.81679,0.712772352,0.012472079,5.73344E-05,0.567567568,0.02263986,74,32
D:0| T0: 0.10| T1: 32.00| R0: 0.0| R1: 0.0| WTP: 0,0,0.096153846,32,0,0,0,0,0,-614205817.2,1902565669,12.02590655,613604521.8,61360452.18,1,159,7,2,2,0,2,159,0,2,0.337078652,0,0,99909.01124,6.584269663,0.02247191,99999.30337,0.999048342,7.11768E-05,4.70591E-07,0,0.012578616,12,7
D:0| T0: 0.10| T1: 32.00| R0: 0.0| R1: 0.0| WTP: 0,0,0.096153846,32,0,0,0,0,0,-1491498301,1984179288,24.09664827,1490293468,149029346.8,1,236,13,4,4,0,4,236,0,4,0.852941176,0,0,99849.64118,10.67058824,0.023529412,99997.91176,0.998310015,0.000121613,5.36921E-07,0,0.016949153,22,17
D:0| T0: 0.10| T1: 32.00| R0: 0.0| R1: 0.0| WTP: 0,0,0.096153846,32,0,0,0,0,0,-3481822274,677377223,11751.96256,2894224146,289422414.6,2,92695,4116,1364,1952,588,1364,92695,588,1952,111.9493392,2.837004405,4.099118943,61069.44273,1662.870044,7.101321586,99240.53965,0.612211661,0.0167539,7.35595E-05,0.301229508,0.02105831,64,32
D:0| T0: 0.10| T1: 32.00| R0: 0.0| R1: 0.0| WTP: 0,0,0.096153846,32,0,0,0,0,0,-3494170857,973583301,11950.74187,2896633764,289663376.4,2,95178,4236,908,1985,1077,908,95178,1077,1985,120.7620137,1.938215103,4.366132723,67729.30435,1766.393593,6.448512586,99395.65217,0.676221274,0.017876466,6.69971E-05,0.54256927,0.02085566,63,32
D:0| T0: 0.10| T1: 32.00| R0: 0.0| R1: 0.0| WTP: 0,0,0.096153846,32,0,0,0,0,0,-1934003567,781062938,96.36862604,1929185135,192918513.5,1,768,40,16,16,0,16,768,0,16,2.836956522,0.032608696,0.032608696,99436.40761,20.13043478,0.114130435,99989.17391,0.994483096,0.000202611,1.72986E-06,0,0.020833333,27,22
D:0| T0: 0.10| T1: 32.00| R0: 0.0| R1: 0.0| WTP: 0,0,0.096153846,32,0,0,0,0,0,-3472778450,338783425,11612.93387,2892131756,289213175.6,2,95209,4179,812,1929,1117,812,95209,1117,1929,99.37698413,1.533730159,3.728174603,69471.76389,1534.297619,5.331349206,99442.90079,0.689937809,0.015704854,5.56833E-05,0.579056506,0.02026069,71,32
D:0| T0: 0.10| T1: 36.00| R0: 0.0| R1: 0.0| WTP: 0,0,0.096153846,36,0,0,0,0,0,-3157862607,650073325,42.1450026,3155755356,315575535.6,2,585,23,7,7,0,7,585,0,7,0.543062201,0,0,99699.44976,8.892344498,0.0215311,99996.10287,0.995767895,0.000122661,4.82773E-07,0,0.011965812,42,36
D:0| T0: 0.10| T1: 36.00| R0: 0.0| R1: 0.0| WTP: 0,0,0.096153846,36,0,0,0,0,0,-3839883089,2029998696,11866.60077,3246553051,324655305.1,2,94874,4142,1265,1971,706,1265,94874,706,1971,110.3800425,2.532908705,4.010615711,57625.6327,684.2526539,6.685774947,99169.63482,0.569886368,0.007045059,7.06829E-05,0.35819381,0.020774923,66,36
D:0| T0: 0.10| T1: 36.00| R0: 0.0| R1: 0.0| WTP: 0,0,0.096153846,36,0,0,0,0,0,-3839106377,776062361,12061.55508,3236028623,323602862.3,2,85880,3623,1787,2004,217,1787,85880,217,2004,70.215625,2.6171875,2.95,45639.30469,834.53125,5.7375,98779.56719,0.43812502,0.008758775,6.21735E-05,0.108283433,0.023335429,87,36
D:0| T0: 0.10| T1: 36.00| R0: 0.0| R1: 0.0| WTP: 0,0,0.096153846,36,0,0,0,0,0,-790143259.7,1813046880,24.0502197,788940748.7,78894074.87,1,100,3,4,4,0,4,100,0,4,0.505154639,0.020618557,0.020618557,99933.56701,5.783505155,0.06185567,99997.71134,0.999361715,5.9491E-05,8.16337E-07,0,0.04,14,9
D:0| T0: 0.10| T1: 36.00| R0: 0.0| R1: 0.0| WTP: 0,0,0.096153846,36,0,0,0,0,0,-969116302.8,2032407216,84.31581289,964900512.2,96490051.22,1,779,40,14,14,0,14,779,0,14,3.552845528,0.056910569,0.056910569,99539.73171,21.43902439,0.162601626,99992.72358,0.994948703,0.000239204,2.52268E-06,0,0.018018018,16,11
D:0| T0: 0.10| T1: 36.00| R0: 0.0| R1: 0.0| WTP: 0,0,0.096153846,36,0,0,0,0,0,-613612900.2,1507873352,0.019516484,613611924.4,61361192.44,1,20,3,0,0,0,0,20,0,0,0.359223301,0,0,99989.39806,1.747572816,0,100000,0.999877209,2.0814E-05,0,0,0,12,7
D:0| T0: 0.10| T1: 36.00| R0: 0.0| R1: 0.0| WTP: 0,0,0.096153846,36,0,0,0,0,0,-613940692.7,1855899401,6.032997232,613639042.8,61363904.28,1,115,5,1,1,0,1,115,0,1,0.6625,0,0,99925.2875,4.475,0.0125,99999.425,0.999253494,4.67503E-05,0.00000025,0,0.008695652,12,7
D:0| T0: 0.10| T1: 36.00| R0: 0.0| R1: 0.0| WTP: 0,0,0.096153846,36,0,0,0,0,0,-3863395519,1819459251,12482.55541,3239267748,323926774.8,2,92975,3981,771,2074,1303,771,92975,1303,2074,107.0939597,1.586129754,4.472035794,75217.16107,744.3646532,6.201342282,99487.08949,0.752943864,0.007502436,6.41366E-05,0.628254581,0.022307312,64,36
D:0| T0: 0.10| T1: 36.00| R0: 0.0| R1: 0.0| WTP: 0,0,0.096153846,36,0,0,0,0,0,-350960853.1,909791748,6.024030199,350659651.6,35065965.16,1,60,2,1,1,0,1,60,0,1,0.590163934,0,0,99965.06557,2.770491803,0.016393443,99999.70492,0.999655805,3.03226E-05,3.22581E-07,0,0.016949153,9,4
D:0| T0: 0.10| T1: 36.00| R0: 0.0| R1: 0.0| WTP: 0,0,0.096153846,36,0,0,0,0,0,-3862807656,1339092841,12446.9703,3240459141,324045914.1,2,87994,3787,806,2068,1262,806,87994,1262,2068,101.6221294,1.542797495,4.150313152,77681.39248,662.2651357,5.835073069,99509.62213,0.777625808,0.006677396,6.04804E-05,0.610251451,0.023501602,69,36
D:0| T0: 0.10| T1: 36.00| R0: 0.0| R1: 0.0| WTP: 0,0,0.096153846,36,0,0,0,0,0,-3894517260,1365866345,12912.22008,3248906257,324890625.7,2,97246,4283,1089,2145,1056,1089,97246,1056,2145,108.7250509,2.077393075,4.209775967,64981.83707,618.107943,6.435845214,99259.71487,0.612558332,0.006940267,7.38913E-05,0.492307692,0.022057463,63,36
D:0| T0: 0.10| T1: 36.00| R0: 0.0| R1: 0.0| WTP: 0,0,0.096153846,36,0,0,0,0,0,-3826007813,825453433,11643.28958,3243843334,324384333.4,2,93575,4132,730,1934,1204,730,93575,1204,1934,101.4701195,1.34063745,3.717131474,68649.11155,945.4083665,5.177290837,99401.14542,0.686894552,0.00952498,5.34675E-05,0.62254395,0.020667913,72,36
D:0| T0: 0.10| T1: 36.00| R0: 0.0| R1: 0.0| WTP: 0,0,0.096153846,36,0,0,0,0,0,-3841694085,939711378,11873.09097,3248039537,324803953.7,2,95639,4278,1312,1972,660,1312,95639,660,1972,118.7078652,2.77752809,4.240449438,54959.72584,844.8539326,7.195505618,99113.68315,0.552673962,0.008513139,7.43138E-05,0.334685598,0.020619203,64,36
D:0| T0: 0.10| T1: 36.00| R0: 0.0| R1: 0.0| WTP: 0,0,0.096153846,36,0,0,0,0,0,-2898786607,638950699,108.386626,2893367276,289336727.6,1,920,43,18,18,0,18,920,0,18,2.080769231,0.019230769,0.019230769,99325.93462,21.71153846,0.092307692,99987.01538,0.993398099,0.000218606,1.37943E-06,0,0.019565217,38,33
D:0| T0: 0.10| T1: 36.00| R0: 0.0| R1: 0.0| WTP: 0,0,0.096153846,36,0,0,0,0,0,-1141838461,938699148,42.12651908,1139732135,113973213.5,1,448,21,7,7,0,7,448,0,7,1.104895105,0.027972028,0.027972028,99750.46154,10.41958042,0.083916084,99996.03497,0.997085929,0.000124468,1.15705E-06,0,0.015625,18,13
D:0| T0: 0.10| T1: 36.00| R0: 0.0| R1: 0.0| WTP: 0,0,0.096153846,36,0,0,0,0,0,-1608662468,1412065496,524.0343361,1582460751,158246075.1,1,4166,192,87,87,0,87,4166,0,87,11.96566524,0.296137339,0.296137339,97987.71245,52.7167382,0.665236052,99961.07725,0.971141792,0.000765818,1.08795E-05,0,0.020888355,23,18
D:0| T0: 0.10| T1: 36.00| R0: 0.0| R1: 0.0| WTP: 0,0,0.096153846,36,0,0,0,0,0,-3825527709,1331335240,11643.57485,3243348967,324334896.7,2,89386,3948,1809,1934,125,1809,89386,125,1934,88.06761566,3.035587189,3.252669039,48940.07117,1049.023132,6.476868327,98953.35765,0.480356446,0.010823538,6.8713E-05,0.064632885,0.021636498,79,36
D:0| T0: 0.10| T1: 36.00| R0: 0.0| R1: 0.0| WTP: 0,0,0.096153846,36,0,0,0,0,0,-2256898098,470935411,10400.72688,1736861754,173686175.4,1,76553,3241,665,1728,1063,665,76553,1063,1728,218.4385027,3.470588235,9.080213904,51483.99465,1060.395722,12.61497326,98995.65241,0.457515785,0.011972692,0.000144568,0.615162037,0.022572892,24,19
D:0| T0: 0.10| T1: 36.00| R0: 0.0| R1: 0.0| WTP: 0,0,0.096153846,36,0,0,0,0,0,-1580920072,823434397,60.11843935,1577914150,157791415,1,521,14,10,10,0,10,521,0,10,0.73125,0.01875,0.01875,99655.375,15.425,0.075,99994.88125,0.996611501,0.00015603,1.24229E-06,0,0.019230769,23,18
D:0| T0: 0.10| T1: 36.00| R0: 0.0| R1: 0.0| WTP: 0,0,0.096153846,36,0,0,0,0,0,-525966716.9,493045351,0.020043956,525965714.7,52596571.47,1,140,7,0,0,0,0,140,0,0,0.493506494,0,0,99918.5974,4.74025974,0,100000,0.999168158,5.05263E-05,0,0,0,11,6
D:0| T0: 0.10| T1: 36.00| R0: 0.0| R1: 0.0| WTP: 0,0,0.096153846,36,0,0,0,0,0,-1666457118,1700216563,18.07842027,1665553197,166555319.7,1,285,12,3,3,0,3,285,0,3,0.727272727,0,0,99812.71515,8.690909091,0.018181818,99998.15152,0.998150074,8.88566E-05,3.61449E-07,0,0.01056338,24,19
D:0| T0: 0.10| T1: 36.00| R0: 0.0| R1: 0.0| WTP: 0,0,0.096153846,36,0,0,0,0,0,-1325431175,1744119059,180.6954829,1316396400,131639640,1,1555,78,30,30,0,30,1555,0,30,6.927536232,0.137681159,0.137681159,98907.02899,29.65217391,0.34057971,99980.17391,0.989289112,0.000296518,4.31714E-06,0,0.019292605,20,15
D:0| T0: 0.10| T1: 36.00| R0: 0.0| R1: 0.0| WTP: 0,0,0.096153846,36,0,0,0,0,0,-701896219.8,2036906360,12.03909336,701294265.1,70129426.51,1,90,7,2,2,0,2,90,0,2,0.5,0,0,99953.46364,5.272727273,0.018181818,99998.94545,0.999462571,6.35494E-05,4.3011E-07,0,0.022222222,13,8
D:0| T0: 0.10| T1: 36.00| R0: 0.0| R1: 0.0| WTP: 0,0,0.096153846,36,0,0,0,0,0,-3778808470,809704121,10647.30593,3246443174,324644317.4,2,90931,4103,750,1768,1018,750,90931,1018,1768,103.4176471,1.409803922,3.384313725,77304.1549,917.7588235,4.847058824,99598.59216,0.772304085,0.009274715,4.99026E-05,0.575791855,0.019443314,72,36
D:0| T0: 0.10| T1: 36.00| R0: 0.0| R1: 0.0| WTP: 0,0,0.096153846,36,0,0,0,0,0,-3877361027,1219866412,12611.39501,3246791276,324679127.6,2,95776,4173,1412,2095,683,1412,95776,683,2095,108.572327,2.80293501,4.203354298,58150.1782,1645.60587,7.144654088,99156.38365,0.583419241,0.016592235,7.40986E-05,0.32601432,0.021873956,69,36
D:0| T0: 0.10| T1: 36.00| R0: 0.0| R1: 0.0| WTP: 0,0,0.096153846,36,0,0,0,0,0,-527532089.2,843498920,30.06529385,526028824.5,52602882.45,1,89,7,5,5,0,5,89,0,5,1.013333333,0,0,99943.44,5.053333333,0.08,99997.84,0.999459456,5.19746E-05,1.31582E-06,0,0.057471264,11,6
D:0| T0: 0.10| T1: 36.00| R0: 0.0| R1: 0.0| WTP: 0,0,0.096153846,36,0,0,0,0,0,-1056001584,107351963,78.1609805,1052093535,105209353.5,1,429,18,13,13,0,13,429,0,13,1.387931034,0.043103448,0.043103448,99715.08621,23.24137931,0.155172414,99993.66379,0.997198116,0.000234582,2.24151E-06,0,0.03030303,17,12
D:0| T0: 0.10| T1: 36.00| R0: 0.0| R1: 0.0| WTP: 0,0,0.096153846,36,0,0,0,0,0,-1229355149,773789021,42.0817004,1227251064,122725106.4,1,333,12,7,7,0,7,333,0,7,0.622222222,0.007407407,0.007407407,99783.48148,16.42222222,0.059259259,99996.36296,0.997845037,0.000167467,1.04481E-06,0,0.021021021,19,14
D:0| T0: 0.10| T1: 36.00| R0: 0.0| R1: 0.0| WTP: 0,0,0.096153846,36,0,0,0,0,0,-3163350586,850936611,138.4445462,3156428359,315642835.9,1,1310,49,23,23,0,23,1310,0,23,2.043478261,0.010033445,0.010033445,99140.18395,23.34782609,0.100334448,99987.19398,0.991124267,0.000246315,1.60857E-06,0,0.017570665,41,36
D:0| T0: 0.10| T1: 36.00| R0: 0.0| R1: 0.0| WTP: 0,0,0.096153846,36,0,0,0,0,0,-2216888293,1701318364,433.6792622,2195204330,219520433,1,3844,167,72,72,0,72,3844,0,72,10.58064516,0.230414747,0.230414747,97320.96774,75.29493088,0.562211982,99952.08756,0.972178328,0.00079515,6.99271E-06,0,0.018730489,30,25
D:0| T0: 0.10| T1: 36.00| R0: 0.0| R1: 0.0| WTP: 0,0,0.096153846,36,0,0,0,0,0,-701235203.9,778708269,0.010549451,701234676.5,70123467.65,1,42,2,0,0,0,0,42,0,0,0.224719101,0,0,99973.55056,3.516853933,0,100000,0.99972908,3.7931E-05,0,0,0,13,8
D:0| T0: 0.10| T1: 36.00| R0: 0.0| R1: 0.0| WTP: 0,0,0.096153846,36,0,0,0,0,0,-1149072005,1391938506,174.4410021,1140349954,114034995.4,1,765,35,29,29,0,29,765,0,29,4.184,0.072,0.072,99465.488,22.664,0.328,99983.104,0.994835265,0.000227169,4.60381E-06,0,0.037908497,18,13
D:0| T0: 0.10| T1: 36.00| R0: 0.0| R1: 0.0| WTP: 0,0,0.096153846,36,0,0,0,0,0,-789483172.3,43418681,12.01852194,788882246.2,78888224.62,1,96,6,2,2,0,2,96,0,2,0.173913043,0,0,99939.82609,6.27173913,0.02173913,99998.92391,0.999412034,6.43017E-05,4.3011E-07,0,0.020833333,14,9
D:0| T0: 0.10| T1: 36.00| R0: 0.0| R1: 0.0| WTP: 0,0,0.096153846,36,0,0,0,0,0,-1933022618,817384966,4700.967959,1697974220,169797422,1,35075,1454,502,781,279,502,35075,279,781,109.7559524,2.880952381,4.5,74182.78571,570.8452381,7.494047619,99474.94048,0.741220086,0.005799161,7.75974E-05,0.357234315,0.022266572,24,19
D:0| T0: 0.10| T1: 36.00| R0: 0.0| R1: 0.0| WTP: 0,0,0.096153846,36,0,0,0,0,0,-2060199363,762053968,2270.112325,1946693747,194669374.7,1,18589,805,352,377,25,352,18589,25,377,54.70157068,1.680628272,1.806282723,86422.54974,305.2356021,3.638743455,99746.60209,0.865141197,0.003076137,3.84398E-05,0.066312997,0.020280811,27,22
D:0| T0: 0.10| T1: 36.00| R0: 0.0| R1: 0.0| WTP: 0,0,0.096153846,36,0,0,0,0,0,-2022117363,1692506311,114.2434419,2016405191,201640519.1,1,554,21,19,19,0,19,554,0,19,1.185185185,0.027777778,0.027777778,99635.78241,17.24537037,0.115740741,99988.91667,0.996212583,0.000186105,1.88135E-06,0,0.03442029,28,23
D:0| T0: 0.10| T1: 36.00| R0: 0.0| R1: 0.0| WTP: 0,0,0.096153846,36,0,0,0,0,0,-2529871727,883828863,8869.02478,2086420488,208642048.8,1,72399,3225,693,1473,780,693,72399,780,1473,127.8454259,2.129337539,4.545741325,68328.85174,597.7917981,6.738170347,99401.89905,0.481055828,0.00987943,0.000113073,0.529531568,0.020345866,28,23
D:0| T0: 0.10| T1: 36.00| R0: 0.0| R1: 0.0| WTP: 0,0,0.096153846,36,0,0,0,0,0,-879289142.1,301400999,48.16217016,876881033.6,87688103.36,1,430,19,8,8,0,8,430,0,8,2.203883495,0.009708738,0.009708738,99719.3301,17.98058252,0.077669903,99996.08738,0.997240136,0.000180391,1.53851E-06,0,0.01627907,15,10
D:0| T0: 0.10| T1: 36.00| R0: 0.0| R1: 0.0| WTP: 0,0,0.096153846,36,0,0,0,0,0,-3880436198,1868336855,12688.99761,3245986318,324598631.8,2,95688,4190,954,2108,1154,954,95688,1154,2108,122.7796209,2.071090047,4.777251185,71260.74171,884.3459716,7.047393365,99423.58531,0.71358026,0.008912722,7.31102E-05,0.54743833,0.022029931,61,36
D:0| T0: 0.10| T1: 36.00| R0: 0.0| R1: 0.0| WTP: 0,0,0.096153846,36,0,0,0,0,0,-3864934979,1868498144,12424.05375,3243732291,324373229.1,2,94742,4016,972,2064,1092,972,94742,1092,2064,107.1974522,1.898089172,4.18895966,65354.78556,837.0084926,6.244161359,99285.00212,0.654814362,0.008438457,6.49478E-05,0.529069767,0.021785481,68,36
D:0| T0: 0.10| T1: 36.00| R0: 0.0| R1: 0.0| WTP: 0,0,0.096153846,36,0,0,0,0,0,-1316208864,2101566889,24.10086805,1315003820,131500382,1,197,10,4,4,0,4,197,0,4,1.092857143,0,0,99871.20714,8.478571429,0.028571429,99998.49286,0.998730896,8.63841E-05,5.67384E-07,0,0.020304569,20,15
D:0| T0: 0.10| T1: 36.00| R0: 0.0| R1: 0.0| WTP: 0,0,0.096153846,36,0,0,0,0,0,-2506479601,1665097450,8601.545333,2076402335,207640233.5,1,65856,2797,727,1429,702,727,65856,702,1429,150.0829694,3.091703057,6.091703057,59978.36681,986.6637555,9.279475983,99187.04803,0.531996643,0.011669175,0.000111386,0.491252624,0.021699188,28,23
D:0| T0: 0.10| T1: 36.00| R0: 0.0| R1: 0.0| WTP: 0,0,0.096153846,36,0,0,0,0,0,-3134140790,1716179948,7100.749478,2779103316,277910331.6,1,62522,2888,904,1179,275,904,62522,275,1179,143.4939271,3.530364372,4.591093117,55256.96761,870.6153846,8.255060729,99212.95951,0.556409872,0.008722186,8.44886E-05,0.233248516,0.018857362,36,31
D:0| T0: 0.10| T1: 36.00| R0: 0.0| R1: 0.0| WTP: 0,0,0.096153846,36,0,0,0,0,0,-968211161.5,1560278715,72.20920854,964600701.1,96460070.11,1,378,20,12,12,0,12,378,0,12,1.911111111,0.044444444,0.044444444,99801.24444,9.266666667,0.140740741,99995.45926,0.997746913,0.000108893,2.05139E-06,0,0.031830239,16,11
D:0| T0: 0.10| T1: 36.00| R0: 0.0| R1: 0.0| WTP: 0,0,0.096153846,36,0,0,0,0,0,-3889448658,991019385,12827.86739,3248055289,324805528.9,2,96553,4198,1116,2131,1015,1116,96553,1015,2131,121.3692661,2.348623853,4.653669725,65740.31651,1308.245413,7.222477064,99302.22477,0.658853411,0.013188896,7.50406E-05,0.476302206,0.02207078,63,36
D:0| T0: 0.10| T1: 36.00| R0: 0.0| R1: 0.0| WTP: 0,0,0.096153846,36,0,0,0,0,0,-3883542703,118052103,12796.5634,3243714533,324371453.3,2,92907,3916,1341,2126,785,1341,92907,785,2126,104.5564854,2.656903766,4.278242678,65731.61925,979.6820084,7.10460251,99272.5251,0.643677521,0.010311641,7.62879E-05,0.369238006,0.022883098,66,36
D:0| T0: 0.10| T1: 36.00| R0: 0.0| R1: 0.0| WTP: 0,0,0.096153846,36,0,0,0,0,0,-3856916345,1209758844,12398.13082,3237009804,323700980.4,2,87866,3661,1616,2060,444,1616,87866,444,2060,90.30891089,3.045544554,3.899009901,58321.56634,509.4277228,7.081188119,99064.77624,0.564509084,0.005416422,7.73407E-05,0.215533981,0.023444791,69,36
D:0| T0: 0.10| T1: 36.00| R0: 0.0| R1: 0.0| WTP: 0,0,0.096153846,36,0,0,0,0,0,-1052947058,70671723,18.09266202,1052042425,105204242.5,1,127,9,3,3,0,3,127,0,3,1.204918033,0,0,99909.68033,6.418032787,0.024590164,99998.28689,0.999087878,6.70596E-05,5.04207E-07,0,0.023622047,17,12
D:0| T0: 0.10| T1: 36.00| R0: 0.0| R1: 0.0| WTP: 0,0,0.096153846,36,0,0,0,0,0,-1052433031,1722612191,12.01904941,1051832078,105183207.8,1,52,2,2,2,0,2,52,0,2,0.137096774,0,0,99968.91129,2.266129032,0.016129032,99999.69355,0.999688942,2.43903E-05,3.25205E-07,0,0.019230769,17,12
D:0| T0: 0.10| T1: 36.00| R0: 0.0| R1: 0.0| WTP: 0,0,0.096153846,36,0,0,0,0,0,-1315580982,1968291596,12.08340106,1314976812,131497681.2,1,74,4,2,2,0,2,74,0,2,0.939189189,0,0,99953.10135,2.054054054,0.013513514,99999.31757,0.999506154,2.30435E-05,2.89857E-07,0,0.027027027,20,15
D:0| T0: 0.10| T1: 36.00| R0: 0.0| R1: 0.0| WTP: 0,0,0.096153846,36,0,0,0,0,0,-2786191699,1877569084,7379.32745,2417225327,241722532.7,1,54489,2272,800,1226,426,800,54489,426,1226,124.8384279,3.384279476,5.19650655,62121.41048,760.4061135,8.681222707,99200.20961,0.608616732,0.007964239,9.26726E-05,0.347471452,0.022499954,32,27
D:0| T0: 0.10| T1: 36.00| R0: 0.0| R1: 0.0| WTP: 0,0,0.096153846,36,0,0,0,0,0,-3282427743,1726322189,8331.581836,2865848652,286584865.2,1,64430,2780,922,1384,462,922,64430,462,1384,132.0343511,3.423664122,5.129770992,53690.77099,834.2099237,8.65648855,99069.10687,0.530405135,0.008561652,9.03579E-05,0.333815029,0.021480677,37,32
D:0| T0: 0.10| T1: 36.00| R0: 0.0| R1: 0.0| WTP: 0,0,0.096153846,36,0,0,0,0,0,-3833358147,307848836,11781.82527,3244266883,324426688.3,2,92180,4023,1372,1957,585,1372,92180,585,1957,106.5253165,2.725738397,3.943037975,55739.54008,683.0168776,6.833333333,99117.9789,0.560289808,0.006883336,7.0726E-05,0.298926929,0.021230202,68,36
D:0| T0: 0.10| T1: 36.00| R0: 0.0| R1: 0.0| WTP: 0,0,0.096153846,36,0,0,0,0,0,-2428005378,1154000220,8622.134929,1996898631,199689863.1,1,70493,3203,573,1432,859,573,70493,859,1432,213.7567568,2.978378378,7.589189189,45278.82162,991.427027,10.7027027,98967.50811,0.457113026,0.009926297,0.000108592,0.599860335,0.020314074,27,22
D:0| T0: 0.10| T1: 36.00| R0: 0.0| R1: 0.0| WTP: 0,0,0.096153846,36,0,0,0,0,0,-1052833485,2028661055,18.05783785,1051930593,105193059.3,1,112,6,3,3,0,3,112,0,3,0.629310345,0.017241379,0.017241379,99925.72414,5.24137931,0.043103448,99998.93103,0.999270844,5.44448E-05,5.12824E-07,0,0.026785714,17,12
D:0| T0: 0.10| T1: 36.00| R0: 0.0| R1: 0.0| WTP: 0,0,0.096153846,36,0,0,0,0,0,-3850657631,1629114640,12088.49776,3246232743,324623274.3,2,95510,4204,797,2008,1211,797,95510,1211,2008,106.6081633,1.510204082,3.96122449,72983.8449,1206.995918,5.587755102,99484.03469,0.730026499,0.012165159,5.76974E-05,0.603087649,0.021023977,70,36
D:0| T0: 0.10| T1: 36.00| R0: 0.0| R1: 0.0| WTP: 0,0,0.096153846,36,0,0,0,0,0,-3610540642,1439048174,7958.027189,3212639282,321263928.2,2,58598,2586,952,1322,370,952,58598,370,1322,110.6643836,3.157534247,4.386986301,56460.59247,852.8356164,7.657534247,99064.69178,0.564867544,0.00864515,7.89396E-05,0.279878971,0.022560497,42,36
D:0| T0: 0.10| T1: 36.00| R0: 0.0| R1: 0.0| WTP: 0,0,0.096153846,36,0,0,0,0,0,-2429458360,865227006,10387.96343,1910060189,191006018.9,1,77049,3206,516,1726,1210,516,77049,1210,1726,192.7427184,2.432038835,8.266990291,47539.26699,1004.548544,10.77669903,98903.93689,0.397248879,0.011652111,0.000126356,0.701042874,0.022401329,26,21
D:0| T0: 0.10| T1: 36.00| R0: 0.0| R1: 0.0| WTP: 0,0,0.096153846,36,0,0,0,0,0,-3811594713,890479738,11373.18049,3242935689,324293568.9,2,89628,3940,1770,1889,119,1770,89628,119,1889,83.35472973,2.814189189,3.011824324,46914.40878,1082.922297,6.008445946,98930.30405,0.471859061,0.010914498,6.22831E-05,0.062996294,0.021076003,85,36
D:0| T0: 0.10| T1: 36.00| R0: 0.0| R1: 0.0| WTP: 0,0,0.096153846,36,0,0,0,0,0,-527585116.1,1017049163,30.08270044,526080981,52608098.1,1,206,7,5,5,0,5,206,0,5,1.415584416,0,0,99874.22078,8.922077922,0.077922078,99997.54545,0.998771236,9.08995E-05,1.28208E-06,0,0.024271845,11,6
D:0| T0: 0.10| T1: 36.00| R0: 0.0| R1: 0.0| WTP: 0,0,0.096153846,36,0,0,0,0,0,-525937956.2,1707305064,0.011604396,525937375.9,52593737.59,1,42,2,0,0,0,0,42,0,0,0.258823529,0,0,99976.75294,2.105882353,0,100000,0.999740263,2.59211E-05,0,0,0,11,6
D:0| T0: 0.10| T1: 36.00| R0: 0.0| R1: 0.0| WTP: 0,0,0.096153846,36,0,0,0,0,0,-2139519155,400145663,9835.667205,1647735795,164773579.5,1,73632,3191,470,1634,1164,470,73632,1164,1634,251.75,2.86875,10.1,43556.6625,1234.725,13.04375,98834.25,0.440080531,0.01236459,0.000131774,0.712362301,0.022191439,23,18
D:0| T0: 0.10| T1: 36.00| R0: 0.0| R1: 0.0| WTP: 0,0,0.096153846,36,0,0,0,0,0,-525941393.5,1662654181,0.012131868,525940786.9,52594078.69,1,82,5,0,0,0,0,82,0,0,0.319444444,0,0,99949.04167,4.236111111,0,100000,0.999493151,4.41096E-05,0,0,0,11,6
D:0| T0: 0.10| T1: 36.00| R0: 0.0| R1: 0.0| WTP: 0,0,0.096153846,36,0,0,0,0,0,-2913521010,182136456,4924.857848,2667278117,266727811.7,1,40686,1786,622,818,196,622,40686,196,818,85.93975904,2.381526104,3.140562249,68996.13655,567.313253,5.614457831,99406.85944,0.687811385,0.005790945,5.90202E-05,0.239608802,0.02010569,35,30
D:0| T0: 0.10| T1: 36.00| R0: 0.0| R1: 0.0| WTP: 0,0,0.096153846,36,0,0,0,0,0,-526250066.5,979575387,6.020337891,525949049.6,52594904.96,1,39,2,1,1,0,1,39,0,1,0.397260274,0,0,99973.34247,3.178082192,0.01369863,99999.63014,0.999739188,3.32433E-05,2.7027E-07,0,0.025641026,11,6
D:0| T0: 0.10| T1: 36.00| R0: 0.0| R1: 0.0| WTP: 0,0,0.096153846,36,0,0,0,0,0,-3829723415,2142525414,11828.04654,3238321087,323832108.7,2,90703,3841,1715,1965,250,1715,90703,250,1965,86.76635514,3.022429907,3.471028037,51222.0972,662.9439252,6.678504673,98972.49346,0.503191786,0.006851181,7.10406E-05,0.127226463,0.021664113,75,36
D:0| T0: 0.10| T1: 36.00| R0: 0.0| R1: 0.0| WTP: 0,0,0.096153846,36,0,0,0,0,0,-3832054379,1464057597,11822.72356,3240918201,324091820.1,2,89950,3937,1296,1964,668,1296,89950,668,1964,102.5475687,2.5602537,3.945031712,63795.28541,712.9788584,6.716701903,99265.14376,0.638795852,0.00720008,6.95609E-05,0.3401222,0.021834352,68,36
D:0| T0: 0.10| T1: 36.00| R0: 0.0| R1: 0.0| WTP: 0,0,0.096153846,36,0,0,0,0,0,-3794027969,364562610,11113.41341,3238357299,323835729.9,2,85452,3733,1611,1846,235,1611,85452,235,1846,84.52079566,2.766726944,3.168173599,49717.53345,520.1952984,6.079566004,98944.22061,0.496586426,0.005290274,6.35487E-05,0.127302275,0.021602771,79,36
D:0| T0: 0.10| T1: 36.00| R0: 0.0| R1: 0.0| WTP: 0,0,0.096153846,36,0,0,0,0,0,-3810210001,40350784,11467.24901,3236847550,323684755,2,86115,3708,1696,1905,209,1696,86115,209,1905,91.1237525,3.179640719,3.582834331,53430.27345,660.5309381,6.976047904,99029.63673,0.537691538,0.006655636,7.24033E-05,0.109711286,0.022121838,72,36
D:0| T0: 0.10| T1: 36.00| R0: 0.0| R1: 0.0| WTP: 0,0,0.096153846,36,0,0,0,0,0,-2505830727,804064356,873.3914557,2462161154,246216115.4,1,8065,346,145,145,0,145,8065,0,145,19.31512605,0.470588235,0.470588235,94387.64286,97.62184874,1.067226891,99905.22269,0.941649961,0.001031097,1.28409E-05,0,0.017978921,33,28
D:0| T0: 0.10| T1: 36.00| R0: 0.0| R1: 0.0| WTP: 0,0,0.096153846,36,0,0,0,0,0,-1591445843,2125493986,246.6775898,1579111963,157911196.3,1,1624,65,41,41,0,41,1624,0,41,4.919753086,0.148148148,0.148148148,98779.08642,31.29012346,0.388888889,99971.61111,0.988023329,0.000315492,5.06271E-06,0,0.025246305,23,18
D:0| T0: 0.10| T1: 36.00| R0: 0.0| R1: 0.0| WTP: 0,0,0.096153846,36,0,0,0,0,0,-3722141863,23154253,9583.270686,3242978329,324297832.9,2,88468,4034,1000,1591,591,1000,88468,591,1591,105.7118998,1.91440501,3.127348643,66372.96868,492.0187891,5.212943633,99422.08768,0.659049854,0.005045237,5.54259E-05,0.371464488,0.017983904,68,36
D:0| T0: 0.10| T1: 36.00| R0: 0.0| R1: 0.0| WTP: 0,0,0.096153846,36,0,0,0,0,0,-1142623034,1391367689,54.19463992,1139913302,113991330.2,1,338,17,9,9,0,9,338,0,9,2.113636364,0.007575758,0.007575758,99793.95455,9.575757576,0.068181818,99995.55303,0.99782669,0.000104557,1.46347E-06,0,0.026627219,18,13
D:0| T0: 0.10| T1: 36.00| R0: 0.0| R1: 0.0| WTP: 0,0,0.096153846,36,0,0,0,0,0,-2373249439,574142276,120.3212743,2367233375,236723337.5,1,904,35,20,20,0,20,904,0,20,1.743362832,0.026548673,0.026548673,99415.21239,18.70353982,0.119469027,99988.92478,0.994167234,0.00019208,1.79389E-06,0,0.022197558,32,27
D:0| T0: 0.10| T1: 36.00| R0: 0.0| R1: 0.0| WTP: 0,0,0.096153846,36,0,0,0,0,0,-789165407.6,898736779,6.008733495,788864970.9,78886497.09,1,24,2,1,1,0,1,24,0,1,0.061946903,0,0,99986.50442,1.566371681,0.017699115,99999.30088,0.999855611,1.85716E-05,2.04082E-07,0,0.041666667,14,9
D:0| T0: 0.10| T1: 36.00| R0: 0.0| R1: 0.0| WTP: 0,0,0.096153846,36,0,0,0,0,0,-3785252470,346473503,10613.80428,3254562256,325456225.6,2,97275,4661,678,1762,1084,678,97275,1084,1762,112.3145631,1.182524272,3.267961165,76309.04466,1079.976699,4.609708738,99617.95146,0.724623949,0.012630054,5.54268E-05,0.615209989,0.018113595,64,36
D:0| T0: 0.10| T1: 36.00| R0: 0.0| R1: 0.0| WTP: 0,0,0.096153846,36,0,0,0,0,0,-3819515882,445552282,11458.03369,3246614198,324661419.8,2,94888,4282,743,1903,1160,743,94888,1160,1903,97.83457249,1.299256506,3.42936803,77350.29554,1005.736059,4.801115242,99583.60037,0.748909856,0.011234988,5.49563E-05,0.609563847,0.020055223,69,36
D:0| T0: 0.10| T1: 36.00| R0: 0.0| R1: 0.0| WTP: 0,0,0.096153846,36,0,0,0,0,0,-2011827938,911758476,8977.866356,1562934620,156293462,1,73322,3308,588,1491,903,588,73322,903,1491,232.6961326,3.132596685,8.071823204,54995.9779,1135.596685,11.35359116,99165.98895,0.475027389,0.013352622,0.000135158,0.605633803,0.020334961,22,17
D:0| T0: 0.10| T1: 36.00| R0: 0.0| R1: 0.0| WTP: 0,0,0.096153846,36,0,0,0,0,0,-3588047130,1464197940,7436.756996,3216209280,321620928,2,60753,2707,1049,1235,186,1049,60753,186,1235,114.049505,3.316831683,3.907590759,57323.80858,1170.867987,7.366336634,99177.66337,0.57727344,0.011744359,7.55966E-05,0.150607287,0.020328214,44,36
D:0| T0: 0.10| T1: 36.00| R0: 0.0| R1: 0.0| WTP: 0,0,0.096153846,36,0,0,0,0,0,-1846187106,500405854,96.31167549,1841371522,184137152.2,1,815,38,16,16,0,16,815,0,16,2.195876289,0.015463918,0.015463918,99429.20619,17.81443299,0.103092784,99990.11856,0.994033317,0.000190615,1.74876E-06,0,0.019631902,26,21
D:0| T0: 0.10| T1: 36.00| R0: 0.0| R1: 0.0| WTP: 0,0,0.096153846,36,0,0,0,0,0,-2715436198,772037341,1516.694091,2639601493,263960149.3,1,10466,464,251,252,1,251,10466,1,252,23.22222222,0.872427984,0.87654321,91911.48971,139.7942387,1.9218107,99816.16461,0.920893209,0.001396184,2.06399E-05,0.003968254,0.024082569,35,30
D:0| T0: 0.10| T1: 36.00| R0: 0.0| R1: 0.0| WTP: 0,0,0.096153846,36,0,0,0,0,0,-614302229.6,1543158763,12.0575549,613699351.8,61369935.18,1,88,7,2,2,0,2,88,0,2,0.957446809,0,0,99948.54255,4.223404255,0.021276596,99999.11702,0.999429028,4.89161E-05,4.8193E-07,0,0.022988506,12,7
D:0| T0: 0.10| T1: 36.00| R0: 0.0| R1: 0.0| WTP: 0,0,0.096153846,36,0,0,0,0,0,-2760809633,1604932531,6975.221668,2412048550,241204855,1,49590,2060,647,1159,512,647,49590,512,1159,108.7584746,2.63559322,4.775423729,63899.97034,616.2457627,7.504237288,99204.4322,0.617890544,0.006618689,8.22141E-05,0.441760138,0.023371648,32,27
D:0| T0: 0.10| T1: 36.00| R0: 0.0| R1: 0.0| WTP: 0,0,0.096153846,36,0,0,0,0,0,-3847600497,539051477,12052.42194,3244979400,324497940,2,92146,4092,1717,2002,285,1717,92146,285,2002,99.96633663,3.217821782,3.76039604,57513.46931,1042.186139,7.154455446,99132.70297,0.550141609,0.011192585,7.90553E-05,0.142357642,0.021726391,68,36
D:0| T0: 0.10| T1: 36.00| R0: 0.0| R1: 0.0| WTP: 0,0,0.096153846,36,0,0,0,0,0,-351017927.4,1743124675,6.041964265,350715829.2,35071582.92,1,67,6,1,1,0,1,67,0,1,1.044776119,0,0,99964.02985,3.119402985,0.014925373,99999.62687,0.999618251,3.49208E-05,3.1746E-07,0,0.015151515,9,4
D:0| T0: 0.10| T1: 36.00| R0: 0.0| R1: 0.0| WTP: 0,0,0.096153846,36,0,0,0,0,0,-3835289265,1965983789,11929.99022,3238789754,323878975.4,2,89840,3851,859,1982,1123,859,89840,1123,1982,93.3,1.617647059,3.78627451,76274.62353,1029.131373,5.470588235,99526.5,0.760259512,0.010495882,5.68113E-05,0.566599395,0.022061443,72,36
D:0| T0: 0.10| T1: 36.00| R0: 0.0| R1: 0.0| WTP: 0,0,0.096153846,36,0,0,0,0,0,-1317483978,516774280,48.14581302,1315076687,131507668.7,1,422,13,8,8,0,8,422,0,8,1.315068493,0.01369863,0.01369863,99708.17123,17.60273973,0.054794521,99995.21918,0.997096431,0.000179454,1.10349E-06,0,0.018957346,20,15
D:0| T0: 0.10| T1: 36.00| R0: 0.0| R1: 0.0| WTP: 0,0,0.096153846,36,0,0,0,0,0,-2178897392,86603142,10427.39956,1657527414,165752741.4,1,82662,3563,504,1732,1228,504,82662,1228,1732,273.1005917,2.917159763,10.14792899,41358.82249,1269.260355,13.13017751,98857.53254,0.376476684,0.013599575,0.000141862,0.709006928,0.020952796,23,18
D:0| T0: 0.10| T1: 36.00| R0: 0.0| R1: 0.0| WTP: 0,0,0.096153846,36,0,0,0,0,0,-1052438462,1431870609,12.02063183,1051837430,105183743,1,103,3,2,2,0,2,103,0,2,0.175438596,0,0,99929.74561,5.99122807,0.01754386,99998.69298,0.999313467,6.16529E-05,3.47828E-07,0,0.019417476,17,12
D:0| T0: 0.10| T1: 36.00| R0: 0.0| R1: 0.0| WTP: 0,0,0.096153846,36,0,0,0,0,0,-3811855862,1592383984,11307.86145,3246462789,324646278.9,2,90515,4105,750,1878,1128,750,90515,1128,1878,110.7079832,1.418067227,3.768907563,71736.44958,550.9663866,5.348739496,99446.43067,0.71629556,0.005584634,5.59456E-05,0.600638978,0.020747942,68,36
D:0| T0: 0.10| T1: 36.00| R0: 0.0| R1: 0.0| WTP: 0,0,0.096153846,36,0,0,0,0,0,-1845386120,1440183867,84.24197223,1841174021,184117402.1,1,562,23,14,14,0,14,562,0,14,1.653846154,0.032967033,0.032967033,99580.32967,14.44505495,0.104395604,99990.38462,0.995907812,0.00014591,1.53015E-06,0,0.024911032,26,21
D:0| T0: 0.10| T1: 36.00| R0: 0.0| R1: 0.0| WTP: 0,0,0.096153846,36,0,0,0,0,0,-1228510203,1696510588,24.08557134,1227305925,122730592.5,1,185,7,4,4,0,4,185,0,4,0.939393939,0,0,99886.80303,6.424242424,0.03030303,99998.94697,0.998873696,6.65158E-05,6.0607E-07,0,0.016304348,19,14
D:0| T0: 0.10| T1: 36.00| R0: 0.0| R1: 0.0| WTP: 0,0,0.096153846,36,0,0,0,0,0,-3876538309,895039877,12628.78612,3245099003,324509900.3,2,95983,4070,1238,2098,860,1238,95983,860,2098,106.2145833,2.4,4.16875,61443.26458,1047.072917,6.760416667,99208.91458,0.604943511,0.01087387,7.21353E-05,0.409914204,0.021858037,67,36
D:0| T0: 0.10| T1: 36.00| R0: 0.0| R1: 0.0| WTP: 0,0,0.096153846,36,0,0,0,0,0,-3075530149,129565953,132.4911479,3068905591,306890559.1,1,1064,47,22,22,0,22,1064,0,22,2.336805556,0.041666667,0.041666667,99188.68056,26.70138889,0.114583333,99983.85764,0.99200247,0.000270307,1.53326E-06,0,0.020735156,40,35
D:0| T0: 0.10| T1: 36.00| R0: 0.0| R1: 0.0| WTP: 0,0,0.096153846,36,0,0,0,0,0,-614205817.2,1902565669,12.02590655,613604521.8,61360452.18,1,159,7,2,2,0,2,159,0,2,0.337078652,0,0,99909.01124,6.584269663,0.02247191,99999.30337,0.999048342,7.11768E-05,4.70591E-07,0,0.012578616,12,7
D:0| T0: 0.10| T1: 36.00| R0: 0.0| R1: 0.0| WTP: 0,0,0.096153846,36,0,0,0,0,0,-1491498301,1984179288,24.09664827,1490293468,149029346.8,1,236,13,4,4,0,4,236,0,4,0.852941176,0,0,99849.64118,10.67058824,0.023529412,99997.91176,0.998310015,0.000121613,5.36921E-07,0,0.016949153,22,17
D:0| T0: 0.10| T1: 36.00| R0: 0.0| R1: 0.0| WTP: 0,0,0.096153846,36,0,0,0,0,0,-3855833461,677377223,12249.99272,3243333825,324333382.5,2,91572,3962,1507,2035,528,1507,91572,528,2035,97.4,2.788235294,3.794117647,59211.7,1464.768627,6.743137255,99158.64706,0.593990328,0.014766776,6.99934E-05,0.259459459,0.02222295,72,36
D:0| T0: 0.10| T1: 36.00| R0: 0.0| R1: 0.0| WTP: 0,0,0.096153846,36,0,0,0,0,0,-3834139784,973583301,11699.17046,3249181261,324918126.1,2,94966,4322,966,1943,977,966,94966,977,1943,116.5593952,1.943844492,4.028077754,69162.11447,1665,6.125269978,99428.88337,0.69077396,0.016847202,6.35578E-05,0.502830674,0.020459954,66,36
D:0| T0: 0.10| T1: 36.00| R0: 0.0| R1: 0.0| WTP: 0,0,0.096153846,36,0,0,0,0,0,-1934003567,781062938,96.36862604,1929185135,192918513.5,1,768,40,16,16,0,16,768,0,16,2.836956522,0.032608696,0.032608696,99436.40761,20.13043478,0.114130435,99989.17391,0.994483096,0.000202611,1.72986E-06,0,0.020833333,27,22
D:0| T0: 0.10| T1: 36.00| R0: 0.0| R1: 0.0| WTP: 0,0,0.096153846,36,0,0,0,0,0,-3802954355,338783425,11086.40361,3248634174,324863417.4,2,95210,4329,822,1841,1019,822,95210,1019,1841,99.76851852,1.45,3.311111111,69515.62963,1435.361111,4.833333333,99465.15,0.690709841,0.014672686,5.04254E-05,0.553503531,0.019336204,76,36
D:0| T0: 0.10| T1: 40.00| R0: 0.0| R1: 0.0| WTP: 0,0,0.096153846,40,0,0,0,0,0,-3245512837,650073325,42.1450026,3243405587,324340558.7,1,585,23,7,7,0,7,585,0,7,0.543062201,0,0,99699.44976,8.892344498,0.0215311,99996.10287,0.995767895,0.000122661,4.82773E-07,0,0.011965812,42,37
D:0| T0: 0.10| T1: 40.00| R0: 0.0| R1: 0.0| WTP: 0,0,0.096153846,40,0,0,0,0,0,-4189029436,2029998696,11866.11659,3595723607,359572360.7,2,94729,4142,1251,1971,720,1251,94729,720,1971,96.96963947,2.235294118,3.582542694,55718.34535,608.5275142,5.960151803,99122.12144,0.551515439,0.006253729,6.27665E-05,0.365296804,0.020806722,74,40
D:0| T0: 0.10| T1: 40.00| R0: 0.0| R1: 0.0| WTP: 0,0,0.096153846,40,0,0,0,0,0,-4188334869,776062361,12043.38283,3586165727,358616572.7,2,85717,3587,1782,2001,219,1782,85717,219,2001,63.02397743,2.345557123,2.648801128,44124.14951,752.4062059,5.163610719,98738.33427,0.424760475,0.007867386,5.57916E-05,0.109445277,0.023344533,97,40
D:0| T0: 0.10| T1: 40.00| R0: 0.0| R1: 0.0| WTP: 0,0,0.096153846,40,0,0,0,0,0,-790143259.7,1813046880,24.0502197,788940748.7,78894074.87,1,100,3,4,4,0,4,100,0,4,0.505154639,0.020618557,0.020618557,99933.56701,5.783505155,0.06185567,99997.71134,0.999361715,5.9491E-05,8.16337E-07,0,0.04,14,9
D:0| T0: 0.10| T1: 40.00| R0: 0.0| R1: 0.0| WTP: 0,0,0.096153846,40,0,0,0,0,0,-969116302.8,2032407216,84.31581289,964900512.2,96490051.22,1,779,40,14,14,0,14,779,0,14,3.552845528,0.056910569,0.056910569,99539.73171,21.43902439,0.162601626,99992.72358,0.994948703,0.000239204,2.52268E-06,0,0.018018018,16,11
D:0| T0: 0.10| T1: 40.00| R0: 0.0| R1: 0.0| WTP: 0,0,0.096153846,40,0,0,0,0,0,-613612900.2,1507873352,0.019516484,613611924.4,61361192.44,1,20,3,0,0,0,0,20,0,0,0.359223301,0,0,99989.39806,1.747572816,0,100000,0.999877209,2.0814E-05,0,0,0,12,7
D:0| T0: 0.10| T1: 40.00| R0: 0.0| R1: 0.0| WTP: 0,0,0.096153846,40,0,0,0,0,0,-613940692.7,1855899401,6.032997232,613639042.8,61363904.28,1,115,5,1,1,0,1,115,0,1,0.6625,0,0,99925.2875,4.475,0.0125,99999.425,0.999253494,4.67503E-05,0.00000025,0,0.008695652,12,7
D:0| T0: 0.10| T1: 40.00| R0: 0.0| R1: 0.0| WTP: 0,0,0.096153846,40,0,0,0,0,0,-4216472452,1819459251,12542.44123,3589350391,358935039.1,2,92857,3951,775,2084,1309,775,92857,1309,2084,96.82892057,1.441955193,4.089613035,75080.27699,676.7494908,5.678207739,99478.89206,0.751646374,0.006822092,5.8695E-05,0.628119002,0.022443111,71,40
D:0| T0: 0.10| T1: 40.00| R0: 0.0| R1: 0.0| WTP: 0,0,0.096153846,40,0,0,0,0,0,-350960853.1,909791748,6.024030199,350659651.6,35065965.16,1,60,2,1,1,0,1,60,0,1,0.590163934,0,0,99965.06557,2.770491803,0.016393443,99999.70492,0.999655805,3.03226E-05,3.22581E-07,0,0.016949153,9,4
D:0| T0: 0.10| T1: 40.00| R0: 0.0| R1: 0.0| WTP: 0,0,0.096153846,40,0,0,0,0,0,-4199982467,1339092841,12212.20103,3589372415,358937241.5,2,88099,3724,776,2029,1253,776,88099,1253,2029,94.48910891,1.40990099,3.865346535,76350.61386,630.3445545,5.405940594,99486.90297,0.764363986,0.006354389,5.59844E-05,0.617545589,0.023030908,73,40
D:0| T0: 0.10| T1: 40.00| R0: 0.0| R1: 0.0| WTP: 0,0,0.096153846,40,0,0,0,0,0,-3694038360,1365866345,3316.332629,3528221728,352822172.8,2,24196,1027,537,551,14,537,24196,14,551,33.60869565,1.3125,1.350543478,83595.75,206.0054348,2.831521739,99638.55435,0.813640445,0.002383834,3.41997E-05,0.025408348,0.0227733,46,40
D:0| T0: 0.10| T1: 40.00| R0: 0.0| R1: 0.0| WTP: 0,0,0.096153846,40,0,0,0,0,0,-4173287474,825453433,11589.03743,3593835603,359383560.3,2,93592,4163,731,1925,1194,731,93592,1194,1925,103.5655738,1.393442623,3.81557377,75401.29508,973.5163934,5.295081967,99544.02459,0.754216927,0.009807819,5.48304E-05,0.62025974,0.020567997,70,40
D:0| T0: 0.10| T1: 40.00| R0: 0.0| R1: 0.0| WTP: 0,0,0.096153846,40,0,0,0,0,0,-4201672736,939711378,12077.02229,3597821621,359782162.1,2,95529,4164,1305,2006,701,1305,95529,701,2006,104.1992032,2.450199203,3.832669323,52921.4741,748.0756972,6.434262948,99056.63147,0.532361115,0.007540904,6.64424E-05,0.349451645,0.020998859,72,40
D:0| T0: 0.10| T1: 40.00| R0: 0.0| R1: 0.0| WTP: 0,0,0.096153846,40,0,0,0,0,0,-2898786607,638950699,108.386626,2893367276,289336727.6,1,920,43,18,18,0,18,920,0,18,2.080769231,0.019230769,0.019230769,99325.93462,21.71153846,0.092307692,99987.01538,0.993398099,0.000218606,1.37943E-06,0,0.019565217,38,33
D:0| T0: 0.10| T1: 40.00| R0: 0.0| R1: 0.0| WTP: 0,0,0.096153846,40,0,0,0,0,0,-1141838461,938699148,42.12651908,1139732135,113973213.5,1,448,21,7,7,0,7,448,0,7,1.104895105,0.027972028,0.027972028,99750.46154,10.41958042,0.083916084,99996.03497,0.997085929,0.000124468,1.15705E-06,0,0.015625,18,13
D:0| T0: 0.10| T1: 40.00| R0: 0.0| R1: 0.0| WTP: 0,0,0.096153846,40,0,0,0,0,0,-1608662468,1412065496,524.0343361,1582460751,158246075.1,1,4166,192,87,87,0,87,4166,0,87,11.96566524,0.296137339,0.296137339,97987.71245,52.7167382,0.665236052,99961.07725,0.971141792,0.000765818,1.08795E-05,0,0.020888355,23,18
D:0| T0: 0.10| T1: 40.00| R0: 0.0| R1: 0.0| WTP: 0,0,0.096153846,40,0,0,0,0,0,-4157323627,1331335240,11312.52985,3591697135,359169713.5,2,89053,3854,1781,1879,98,1781,89053,98,1879,74.65634675,2.588235294,2.735294118,46265.94892,906.749226,5.479876161,98903.90557,0.454801804,0.009328403,5.82734E-05,0.052155402,0.021099795,91,40
D:0| T0: 0.10| T1: 40.00| R0: 0.0| R1: 0.0| WTP: 0,0,0.096153846,40,0,0,0,0,0,-2256898098,470935411,10400.72688,1736861754,173686175.4,1,76553,3241,665,1728,1063,665,76553,1063,1728,218.4385027,3.470588235,9.080213904,51483.99465,1060.395722,12.61497326,98995.65241,0.457515785,0.011972692,0.000144568,0.615162037,0.022572892,24,19
D:0| T0: 0.10| T1: 40.00| R0: 0.0| R1: 0.0| WTP: 0,0,0.096153846,40,0,0,0,0,0,-1580920072,823434397,60.11843935,1577914150,157791415,1,521,14,10,10,0,10,521,0,10,0.73125,0.01875,0.01875,99655.375,15.425,0.075,99994.88125,0.996611501,0.00015603,1.24229E-06,0,0.019230769,23,18
D:0| T0: 0.10| T1: 40.00| R0: 0.0| R1: 0.0| WTP: 0,0,0.096153846,40,0,0,0,0,0,-525966716.9,493045351,0.020043956,525965714.7,52596571.47,1,140,7,0,0,0,0,140,0,0,0.493506494,0,0,99918.5974,4.74025974,0,100000,0.999168158,5.05263E-05,0,0,0,11,6
D:0| T0: 0.10| T1: 40.00| R0: 0.0| R1: 0.0| WTP: 0,0,0.096153846,40,0,0,0,0,0,-1666457118,1700216563,18.07842027,1665553197,166555319.7,1,285,12,3,3,0,3,285,0,3,0.727272727,0,0,99812.71515,8.690909091,0.018181818,99998.15152,0.998150074,8.88566E-05,3.61449E-07,0,0.01056338,24,19
D:0| T0: 0.10| T1: 40.00| R0: 0.0| R1: 0.0| WTP: 0,0,0.096153846,40,0,0,0,0,0,-1325431175,1744119059,180.6954829,1316396400,131639640,1,1555,78,30,30,0,30,1555,0,30,6.927536232,0.137681159,0.137681159,98907.02899,29.65217391,0.34057971,99980.17391,0.989289112,0.000296518,4.31714E-06,0,0.019292605,20,15
D:0| T0: 0.10| T1: 40.00| R0: 0.0| R1: 0.0| WTP: 0,0,0.096153846,40,0,0,0,0,0,-701896219.8,2036906360,12.03909336,701294265.1,70129426.51,1,90,7,2,2,0,2,90,0,2,0.5,0,0,99953.46364,5.272727273,0.018181818,99998.94545,0.999462571,6.35494E-05,4.3011E-07,0,0.022222222,13,8
D:0| T0: 0.10| T1: 40.00| R0: 0.0| R1: 0.0| WTP: 0,0,0.096153846,40,0,0,0,0,0,-3248723308,809704121,102.2623815,3243610189,324361018.9,1,681,38,17,17,0,17,681,0,17,1.059800664,0.013289037,0.013289037,99526.12957,11.79401993,0.07641196,99987.95349,0.995356487,0.000120778,1.13342E-06,0,0.025,42,37
D:0| T0: 0.10| T1: 40.00| R0: 0.0| R1: 0.0| WTP: 0,0,0.096153846,40,0,0,0,0,0,-4204778453,1219866412,12131.21669,3598217619,359821761.9,2,95582,4249,1420,2015,595,1420,95582,595,2015,104.6167665,2.656686627,3.816367265,59689.16966,1569.582834,6.632734531,99209.57685,0.598971301,0.015821557,6.90796E-05,0.29528536,0.021081375,72,40
D:0| T0: 0.10| T1: 40.00| R0: 0.0| R1: 0.0| WTP: 0,0,0.096153846,40,0,0,0,0,0,-527532089.2,843498920,30.06529385,526028824.5,52602882.45,1,89,7,5,5,0,5,89,0,5,1.013333333,0,0,99943.44,5.053333333,0.08,99997.84,0.999459456,5.19746E-05,1.31582E-06,0,0.057471264,11,6
D:0| T0: 0.10| T1: 40.00| R0: 0.0| R1: 0.0| WTP: 0,0,0.096153846,40,0,0,0,0,0,-1056001584,107351963,78.1609805,1052093535,105209353.5,1,429,18,13,13,0,13,429,0,13,1.387931034,0.043103448,0.043103448,99715.08621,23.24137931,0.155172414,99993.66379,0.997198116,0.000234582,2.24151E-06,0,0.03030303,17,12
D:0| T0: 0.10| T1: 40.00| R0: 0.0| R1: 0.0| WTP: 0,0,0.096153846,40,0,0,0,0,0,-1229355149,773789021,42.0817004,1227251064,122725106.4,1,333,12,7,7,0,7,333,0,7,0.622222222,0.007407407,0.007407407,99783.48148,16.42222222,0.059259259,99996.36296,0.997845037,0.000167467,1.04481E-06,0,0.021021021,19,14
D:0| T0: 0.10| T1: 40.00| R0: 0.0| R1: 0.0| WTP: 0,0,0.096153846,40,0,0,0,0,0,-3163350586,850936611,138.4445462,3156428359,315642835.9,1,1310,49,23,23,0,23,1310,0,23,2.043478261,0.010033445,0.010033445,99140.18395,23.34782609,0.100334448,99987.19398,0.991124267,0.000246315,1.60857E-06,0,0.017570665,41,36
D:0| T0: 0.10| T1: 40.00| R0: 0.0| R1: 0.0| WTP: 0,0,0.096153846,40,0,0,0,0,0,-2216888293,1701318364,433.6792622,2195204330,219520433,1,3844,167,72,72,0,72,3844,0,72,10.58064516,0.230414747,0.230414747,97320.96774,75.29493088,0.562211982,99952.08756,0.972178328,0.00079515,6.99271E-06,0,0.018730489,30,25
D:0| T0: 0.10| T1: 40.00| R0: 0.0| R1: 0.0| WTP: 0,0,0.096153846,40,0,0,0,0,0,-701235203.9,778708269,0.010549451,701234676.5,70123467.65,1,42,2,0,0,0,0,42,0,0,0.224719101,0,0,99973.55056,3.516853933,0,100000,0.99972908,3.7931E-05,0,0,0,13,8
D:0| T0: 0.10| T1: 40.00| R0: 0.0| R1: 0.0| WTP: 0,0,0.096153846,40,0,0,0,0,0,-1149072005,1391938506,174.4410021,1140349954,114034995.4,1,765,35,29,29,0,29,765,0,29,4.184,0.072,0.072,99465.488,22.664,0.328,99983.104,0.994835265,0.000227169,4.60381E-06,0,0.037908497,18,13
D:0| T0: 0.10| T1: 40.00| R0: 0.0| R1: 0.0| WTP: 0,0,0.096153846,40,0,0,0,0,0,-789483172.3,43418681,12.01852194,788882246.2,78888224.62,1,96,6,2,2,0,2,96,0,2,0.173913043,0,0,99939.82609,6.27173913,0.02173913,99998.92391,0.999412034,6.43017E-05,4.3011E-07,0,0.020833333,14,9
D:0| T0: 0.10| T1: 40.00| R0: 0.0| R1: 0.0| WTP: 0,0,0.096153846,40,0,0,0,0,0,-1933022618,817384966,4700.967959,1697974220,169797422,1,35075,1454,502,781,279,502,35075,279,781,109.7559524,2.880952381,4.5,74182.78571,570.8452381,7.494047619,99474.94048,0.741220086,0.005799161,7.75974E-05,0.357234315,0.022266572,24,19
D:0| T0: 0.10| T1: 40.00| R0: 0.0| R1: 0.0| WTP: 0,0,0.096153846,40,0,0,0,0,0,-2060199363,762053968,2270.112325,1946693747,194669374.7,1,18589,805,352,377,25,352,18589,25,377,54.70157068,1.680628272,1.806282723,86422.54974,305.2356021,3.638743455,99746.60209,0.865141197,0.003076137,3.84398E-05,0.066312997,0.020280811,27,22
D:0| T0: 0.10| T1: 40.00| R0: 0.0| R1: 0.0| WTP: 0,0,0.096153846,40,0,0,0,0,0,-2022117363,1692506311,114.2434419,2016405191,201640519.1,1,554,21,19,19,0,19,554,0,19,1.185185185,0.027777778,0.027777778,99635.78241,17.24537037,0.115740741,99988.91667,0.996212583,0.000186105,1.88135E-06,0,0.03442029,28,23
D:0| T0: 0.10| T1: 40.00| R0: 0.0| R1: 0.0| WTP: 0,0,0.096153846,40,0,0,0,0,0,-2529871727,883828863,8869.02478,2086420488,208642048.8,1,72399,3225,693,1473,780,693,72399,780,1473,127.8454259,2.129337539,4.545741325,68328.85174,597.7917981,6.738170347,99401.89905,0.481055828,0.00987943,0.000113073,0.529531568,0.020345866,28,23
D:0| T0: 0.10| T1: 40.00| R0: 0.0| R1: 0.0| WTP: 0,0,0.096153846,40,0,0,0,0,0,-879289142.1,301400999,48.16217016,876881033.6,87688103.36,1,430,19,8,8,0,8,430,0,8,2.203883495,0.009708738,0.009708738,99719.3301,17.98058252,0.077669903,99996.08738,0.997240136,0.000180391,1.53851E-06,0,0.01627907,15,10
D:0| T0: 0.10| T1: 40.00| R0: 0.0| R1: 0.0| WTP: 0,0,0.096153846,40,0,0,0,0,0,-4213605684,1868336855,12364.31835,3595389767,359538976.7,2,95630,4119,971,2054,1083,971,95630,1083,2054,96.3559322,1.651600753,3.674199623,62003.05461,702.920904,5.517890772,99221.30885,0.621287119,0.007088794,5.74124E-05,0.527263875,0.021478615,76,40
D:0| T0: 0.10| T1: 40.00| R0: 0.0| R1: 0.0| WTP: 0,0,0.096153846,40,0,0,0,0,0,-4208255854,1868498144,12291.70763,3593670473,359367047.3,2,94432,4062,1000,2042,1042,1000,94432,1042,2042,93.59252336,1.702803738,3.629906542,62728.59065,731.9700935,5.495327103,99225.00187,0.62871217,0.00738176,5.73018E-05,0.510284035,0.021624026,77,40
D:0| T0: 0.10| T1: 40.00| R0: 0.0| R1: 0.0| WTP: 0,0,0.096153846,40,0,0,0,0,0,-1316208864,2101566889,24.10086805,1315003820,131500382,1,197,10,4,4,0,4,197,0,4,1.092857143,0,0,99871.20714,8.478571429,0.028571429,99998.49286,0.998730896,8.63841E-05,5.67384E-07,0,0.020304569,20,15
D:0| T0: 0.10| T1: 40.00| R0: 0.0| R1: 0.0| WTP: 0,0,0.096153846,40,0,0,0,0,0,-2506479601,1665097450,8601.545333,2076402335,207640233.5,1,65856,2797,727,1429,702,727,65856,702,1429,150.0829694,3.091703057,6.091703057,59978.36681,986.6637555,9.279475983,99187.04803,0.531996643,0.011669175,0.000111386,0.491252624,0.021699188,28,23
D:0| T0: 0.10| T1: 40.00| R0: 0.0| R1: 0.0| WTP: 0,0,0.096153846,40,0,0,0,0,0,-3134140790,1716179948,7100.749478,2779103316,277910331.6,1,62522,2888,904,1179,275,904,62522,275,1179,143.4939271,3.530364372,4.591093117,55256.96761,870.6153846,8.255060729,99212.95951,0.556409872,0.008722186,8.44886E-05,0.233248516,0.018857362,36,31
D:0| T0: 0.10| T1: 40.00| R0: 0.0| R1: 0.0| WTP: 0,0,0.096153846,40,0,0,0,0,0,-968211161.5,1560278715,72.20920854,964600701.1,96460070.11,1,378,20,12,12,0,12,378,0,12,1.911111111,0.044444444,0.044444444,99801.24444,9.266666667,0.140740741,99995.45926,0.997746913,0.000108893,2.05139E-06,0,0.031830239,16,11
D:0| T0: 0.10| T1: 40.00| R0: 0.0| R1: 0.0| WTP: 0,0,0.096153846,40,0,0,0,0,0,-4246799614,991019385,12983.67296,3597615966,359761596.6,2,96301,4113,1127,2157,1030,1127,96301,1030,2157,108.6528067,2.135135135,4.251559252,64450.02911,1184.931393,6.617463617,99263.2079,0.646116929,0.01194676,6.88181E-05,0.477515067,0.022398521,69,40
D:0| T0: 0.10| T1: 40.00| R0: 0.0| R1: 0.0| WTP: 0,0,0.096153846,40,0,0,0,0,0,-4213979708,118052103,12411.97996,3593380709,359338070.9,2,91619,3860,1517,2062,545,1517,91619,545,2062,91.83612663,2.670391061,3.659217877,63142.96276,864.5642458,6.495344507,99219.16387,0.618887025,0.009056583,6.97701E-05,0.264306499,0.022506249,74,40
D:0| T0: 0.10| T1: 40.00| R0: 0.0| R1: 0.0| WTP: 0,0,0.096153846,40,0,0,0,0,0,-3739276661,1209758844,5669.548903,3455799216,345579921.6,1,39802,1632,912,942,30,912,39802,30,942,62.55421687,2.59939759,2.68373494,74012.20181,350.5481928,5.40060241,99421.42771,0.722330104,0.003809646,6.06732E-05,0.031847134,0.023668342,44,39
D:0| T0: 0.10| T1: 40.00| R0: 0.0| R1: 0.0| WTP: 0,0,0.096153846,40,0,0,0,0,0,-1052947058,70671723,18.09266202,1052042425,105204242.5,1,127,9,3,3,0,3,127,0,3,1.204918033,0,0,99909.68033,6.418032787,0.024590164,99998.28689,0.999087878,6.70596E-05,5.04207E-07,0,0.023622047,17,12
D:0| T0: 0.10| T1: 40.00| R0: 0.0| R1: 0.0| WTP: 0,0,0.096153846,40,0,0,0,0,0,-1052433031,1722612191,12.01904941,1051832078,105183207.8,1,52,2,2,2,0,2,52,0,2,0.137096774,0,0,99968.91129,2.266129032,0.016129032,99999.69355,0.999688942,2.43903E-05,3.25205E-07,0,0.019230769,17,12
D:0| T0: 0.10| T1: 40.00| R0: 0.0| R1: 0.0| WTP: 0,0,0.096153846,40,0,0,0,0,0,-1315580982,1968291596,12.08340106,1314976812,131497681.2,1,74,4,2,2,0,2,74,0,2,0.939189189,0,0,99953.10135,2.054054054,0.013513514,99999.31757,0.999506154,2.30435E-05,2.89857E-07,0,0.027027027,20,15
D:0| T0: 0.10| T1: 40.00| R0: 0.0| R1: 0.0| WTP: 0,0,0.096153846,40,0,0,0,0,0,-2786191699,1877569084,7379.32745,2417225327,241722532.7,1,54489,2272,800,1226,426,800,54489,426,1226,124.8384279,3.384279476,5.19650655,62121.41048,760.4061135,8.681222707,99200.20961,0.608616732,0.007964239,9.26726E-05,0.347471452,0.022499954,32,27
D:0| T0: 0.10| T1: 40.00| R0: 0.0| R1: 0.0| WTP: 0,0,0.096153846,40,0,0,0,0,0,-3282427743,1726322189,8331.581836,2865848652,286584865.2,1,64430,2780,922,1384,462,922,64430,462,1384,132.0343511,3.423664122,5.129770992,53690.77099,834.2099237,8.65648855,99069.10687,0.530405135,0.008561652,9.03579E-05,0.333815029,0.021480677,37,32
D:0| T0: 0.10| T1: 40.00| R0: 0.0| R1: 0.0| WTP: 0,0,0.096153846,40,0,0,0,0,0,-4196387825,307848836,12122.64497,3590255577,359025557.7,2,92201,3810,1396,2014,618,1396,92201,618,2014,95.098,2.634,3.85,56945.084,648.974,6.642,99132.592,0.572472061,0.006541093,6.87046E-05,0.307004471,0.021832735,72,40
D:0| T0: 0.10| T1: 40.00| R0: 0.0| R1: 0.0| WTP: 0,0,0.096153846,40,0,0,0,0,0,-2428005378,1154000220,8622.134929,1996898631,199689863.1,1,70493,3203,573,1432,859,573,70493,859,1432,213.7567568,2.978378378,7.589189189,45278.82162,991.427027,10.7027027,98967.50811,0.457113026,0.009926297,0.000108592,0.599860335,0.020314074,27,22
D:0| T0: 0.10| T1: 40.00| R0: 0.0| R1: 0.0| WTP: 0,0,0.096153846,40,0,0,0,0,0,-1052833485,2028661055,18.05783785,1051930593,105193059.3,1,112,6,3,3,0,3,112,0,3,0.629310345,0.017241379,0.017241379,99925.72414,5.24137931,0.043103448,99998.93103,0.999270844,5.44448E-05,5.12824E-07,0,0.026785714,17,12
D:0| T0: 0.10| T1: 40.00| R0: 0.0| R1: 0.0| WTP: 0,0,0.096153846,40,0,0,0,0,0,-4188287655,1629114640,11842.06755,3596184277,359618427.7,2,95513,4164,785,1967,1182,785,95513,1182,1967,101.7764706,1.435294118,3.731372549,75765.80392,1158.415686,5.270588235,99549.98431,0.757784961,0.011673026,5.43811E-05,0.600915099,0.020594055,73,40
D:0| T0: 0.10| T1: 40.00| R0: 0.0| R1: 0.0| WTP: 0,0,0.096153846,40,0,0,0,0,0,-3698190873,1439048174,7958.027189,3300289513,330028951.3,1,58598,2586,952,1322,370,952,58598,370,1322,110.6643836,3.157534247,4.386986301,56460.59247,852.8356164,7.657534247,99064.69178,0.564867544,0.00864515,7.89396E-05,0.279878971,0.022560497,42,37
D:0| T0: 0.10| T1: 40.00| R0: 0.0| R1: 0.0| WTP: 0,0,0.096153846,40,0,0,0,0,0,-2429458360,865227006,10387.96343,1910060189,191006018.9,1,77049,3206,516,1726,1210,516,77049,1210,1726,192.7427184,2.432038835,8.266990291,47539.26699,1004.548544,10.77669903,98903.93689,0.397248879,0.011652111,0.000126356,0.701042874,0.022401329,26,21
D:0| T0: 0.10| T1: 40.00| R0: 0.0| R1: 0.0| WTP: 0,0,0.096153846,40,0,0,0,0,0,-4166141612,890479738,11433.53782,3594464721,359446472.1,2,89168,4001,1800,1899,99,1800,89168,99,1899,83.26210351,2.821368948,2.98163606,49569.71786,1064.086811,5.984974958,98980.22204,0.498654519,0.01072442,6.22336E-05,0.052132701,0.021296878,86,40
D:0| T0: 0.10| T1: 40.00| R0: 0.0| R1: 0.0| WTP: 0,0,0.096153846,40,0,0,0,0,0,-527585116.1,1017049163,30.08270044,526080981,52608098.1,1,206,7,5,5,0,5,206,0,5,1.415584416,0,0,99874.22078,8.922077922,0.077922078,99997.54545,0.998771236,9.08995E-05,1.28208E-06,0,0.024271845,11,6
D:0| T0: 0.10| T1: 40.00| R0: 0.0| R1: 0.0| WTP: 0,0,0.096153846,40,0,0,0,0,0,-525937956.2,1707305064,0.011604396,525937375.9,52593737.59,1,42,2,0,0,0,0,42,0,0,0.258823529,0,0,99976.75294,2.105882353,0,100000,0.999740263,2.59211E-05,0,0,0,11,6
D:0| T0: 0.10| T1: 40.00| R0: 0.0| R1: 0.0| WTP: 0,0,0.096153846,40,0,0,0,0,0,-2139519155,400145663,9835.667205,1647735795,164773579.5,1,73632,3191,470,1634,1164,470,73632,1164,1634,251.75,2.86875,10.1,43556.6625,1234.725,13.04375,98834.25,0.440080531,0.01236459,0.000131774,0.712362301,0.022191439,23,18
D:0| T0: 0.10| T1: 40.00| R0: 0.0| R1: 0.0| WTP: 0,0,0.096153846,40,0,0,0,0,0,-525941393.5,1662654181,0.012131868,525940786.9,52594078.69,1,82,5,0,0,0,0,82,0,0,0.319444444,0,0,99949.04167,4.236111111,0,100000,0.999493151,4.41096E-05,0,0,0,11,6
D:0| T0: 0.10| T1: 40.00| R0: 0.0| R1: 0.0| WTP: 0,0,0.096153846,40,0,0,0,0,0,-2913521010,182136456,4924.857848,2667278117,266727811.7,1,40686,1786,622,818,196,622,40686,196,818,85.93975904,2.381526104,3.140562249,68996.13655,567.313253,5.614457831,99406.85944,0.687811385,0.005790945,5.90202E-05,0.239608802,0.02010569,35,30
D:0| T0: 0.10| T1: 40.00| R0: 0.0| R1: 0.0| WTP: 0,0,0.096153846,40,0,0,0,0,0,-526250066.5,979575387,6.020337891,525949049.6,52594904.96,1,39,2,1,1,0,1,39,0,1,0.397260274,0,0,99973.34247,3.178082192,0.01369863,99999.63014,0.999739188,3.32433E-05,2.7027E-07,0,0.025641026,11,6
D:0| T0: 0.10| T1: 40.00| R0: 0.0| R1: 0.0| WTP: 0,0,0.096153846,40,0,0,0,0,0,-4186599655,2142525414,11954.14869,3588892221,358889222.1,2,90756,3823,1707,1986,279,1707,90756,279,1986,83.43705036,2.89028777,3.377697842,52683.43165,639.4784173,6.444244604,98994.42086,0.518829554,0.006603784,6.85438E-05,0.140483384,0.021882851,78,40
D:0| T0: 0.10| T1: 40.00| R0: 0.0| R1: 0.0| WTP: 0,0,0.096153846,40,0,0,0,0,0,-4152246318,1464057597,11198.48522,3592322057,359232205.7,2,88908,3857,1399,1860,461,1399,88908,461,1860,98.75855131,2.6277666,3.527162978,65379.03421,671.1247485,6.368209256,99319.41851,0.654902105,0.006775615,6.61573E-05,0.247849462,0.020920737,71,40
D:0| T0: 0.10| T1: 40.00| R0: 0.0| R1: 0.0| WTP: 0,0,0.096153846,40,0,0,0,0,0,-4139491633,364562610,11029.03111,3588040077,358804007.7,2,85572,3756,1619,1832,213,1619,85572,213,1832,81.84219858,2.726950355,3.083333333,51410.57092,511.4787234,5.943262411,98982.98582,0.513868513,0.005200797,6.21889E-05,0.116266376,0.021409122,80,40
D:0| T0: 0.10| T1: 40.00| R0: 0.0| R1: 0.0| WTP: 0,0,0.096153846,40,0,0,0,0,0,-4154333041,40350784,11317.44487,3588460798,358846079.8,2,86674,3696,1691,1880,189,1691,86674,189,1880,87.96394687,3.001897533,3.337760911,54432.83681,633.829222,6.571157495,99058.27514,0.54784882,0.006387679,6.82577E-05,0.100531915,0.021690723,76,40
D:0| T0: 0.10| T1: 40.00| R0: 0.0| R1: 0.0| WTP: 0,0,0.096153846,40,0,0,0,0,0,-2505830727,804064356,873.3914557,2462161154,246216115.4,1,8065,346,145,145,0,145,8065,0,145,19.31512605,0.470588235,0.470588235,94387.64286,97.62184874,1.067226891,99905.22269,0.941649961,0.001031097,1.28409E-05,0,0.017978921,33,28
D:0| T0: 0.10| T1: 40.00| R0: 0.0| R1: 0.0| WTP: 0,0,0.096153846,40,0,0,0,0,0,-1591445843,2125493986,246.6775898,1579111963,157911196.3,1,1624,65,41,41,0,41,1624,0,41,4.919753086,0.148148148,0.148148148,98779.08642,31.29012346,0.388888889,99971.61111,0.988023329,0.000315492,5.06271E-06,0,0.025246305,23,18
D:0| T0: 0.10| T1: 40.00| R0: 0.0| R1: 0.0| WTP: 0,0,0.096153846,40,0,0,0,0,0,-4091270819,23154253,9937.839627,3594378837,359437883.7,2,88174,4082,1008,1650,642,1008,88174,642,1650,105.4772727,1.890495868,3.202479339,69946.19628,486.1797521,5.285123967,99474.34504,0.695545065,0.004985027,5.62771E-05,0.389090909,0.018713848,68,40
D:0| T0: 0.10| T1: 40.00| R0: 0.0| R1: 0.0| WTP: 0,0,0.096153846,40,0,0,0,0,0,-1142623034,1391367689,54.19463992,1139913302,113991330.2,1,338,17,9,9,0,9,338,0,9,2.113636364,0.007575758,0.007575758,99793.95455,9.575757576,0.068181818,99995.55303,0.99782669,0.000104557,1.46347E-06,0,0.026627219,18,13
D:0| T0: 0.10| T1: 40.00| R0: 0.0| R1: 0.0| WTP: 0,0,0.096153846,40,0,0,0,0,0,-2373249439,574142276,120.3212743,2367233375,236723337.5,1,904,35,20,20,0,20,904,0,20,1.743362832,0.026548673,0.026548673,99415.21239,18.70353982,0.119469027,99988.92478,0.994167234,0.00019208,1.79389E-06,0,0.022197558,32,27
D:0| T0: 0.10| T1: 40.00| R0: 0.0| R1: 0.0| WTP: 0,0,0.096153846,40,0,0,0,0,0,-789165407.6,898736779,6.008733495,788864970.9,78886497.09,1,24,2,1,1,0,1,24,0,1,0.061946903,0,0,99986.50442,1.566371681,0.017699115,99999.30088,0.999855611,1.85716E-05,2.04082E-07,0,0.041666667,14,9
D:0| T0: 0.10| T1: 40.00| R0: 0.0| R1: 0.0| WTP: 0,0,0.096153846,40,0,0,0,0,0,-4120613714,346473503,10283.93649,3606416889,360641688.9,2,97304,4613,680,1707,1027,680,97304,1027,1707,104.6916221,1.085561497,2.898395722,75139.61676,992.7005348,4.128342246,99603.88057,0.714913404,0.011458059,4.91179E-05,0.601640305,0.017542958,70,40
D:0| T0: 0.10| T1: 40.00| R0: 0.0| R1: 0.0| WTP: 0,0,0.096153846,40,0,0,0,0,0,-3522565671,445552282,294.8487435,3507823234,350782323.4,1,1897,71,49,49,0,49,1897,0,49,2.808,0.058666667,0.058666667,98828.98933,29.76266667,0.184,99970.36267,0.986723145,0.000346249,3.03477E-06,0,0.025830258,45,40
D:0| T0: 0.10| T1: 40.00| R0: 0.0| R1: 0.0| WTP: 0,0,0.096153846,40,0,0,0,0,0,-2011827938,911758476,8977.866356,1562934620,156293462,1,73322,3308,588,1491,903,588,73322,903,1491,232.6961326,3.132596685,8.071823204,54995.9779,1135.596685,11.35359116,99165.98895,0.475027389,0.013352622,0.000135158,0.605633803,0.020334961,22,17
D:0| T0: 0.10| T1: 40.00| R0: 0.0| R1: 0.0| WTP: 0,0,0.096153846,40,0,0,0,0,0,-3763347592,1464197940,7436.756996,3391509742,339150974.2,1,60745,2707,1049,1235,186,1049,60745,186,1235,117.1423729,3.406779661,4.013559322,57814.15593,1202.549153,7.566101695,99188.85424,0.582136824,0.012061021,7.76397E-05,0.150729335,0.020314429,43,38
D:0| T0: 0.10| T1: 40.00| R0: 0.0| R1: 0.0| WTP: 0,0,0.096153846,40,0,0,0,0,0,-1846187106,500405854,96.31167549,1841371522,184137152.2,1,815,38,16,16,0,16,815,0,16,2.195876289,0.015463918,0.015463918,99429.20619,17.81443299,0.103092784,99990.11856,0.994033317,0.000190615,1.74876E-06,0,0.019631902,26,21
D:0| T0: 0.10| T1: 40.00| R0: 0.0| R1: 0.0| WTP: 0,0,0.096153846,40,0,0,0,0,0,-2715436198,772037341,1516.694091,2639601493,263960149.3,1,10466,464,251,252,1,251,10466,1,252,23.22222222,0.872427984,0.87654321,91911.48971,139.7942387,1.9218107,99816.16461,0.920893209,0.001396184,2.06399E-05,0.003968254,0.024082569,35,30
D:0| T0: 0.10| T1: 40.00| R0: 0.0| R1: 0.0| WTP: 0,0,0.096153846,40,0,0,0,0,0,-614302229.6,1543158763,12.0575549,613699351.8,61369935.18,1,88,7,2,2,0,2,88,0,2,0.957446809,0,0,99948.54255,4.223404255,0.021276596,99999.11702,0.999429028,4.89161E-05,4.8193E-07,0,0.022988506,12,7
D:0| T0: 0.10| T1: 40.00| R0: 0.0| R1: 0.0| WTP: 0,0,0.096153846,40,0,0,0,0,0,-2760809633,1604932531,6975.221668,2412048550,241204855,1,49590,2060,647,1159,512,647,49590,512,1159,108.7584746,2.63559322,4.775423729,63899.97034,616.2457627,7.504237288,99204.4322,0.617890544,0.006618689,8.22141E-05,0.441760138,0.023371648,32,27
D:0| T0: 0.10| T1: 40.00| R0: 0.0| R1: 0.0| WTP: 0,0,0.096153846,40,0,0,0,0,0,-4198617115,539051477,12046.64794,3596284718,359628471.8,2,92284,4102,1730,2001,271,1730,92284,271,2001,93.96125461,3.009225092,3.487084871,57466.42804,975.3136531,6.669741697,99131.92066,0.551854727,0.010428603,7.35808E-05,0.135432284,0.021683065,73,40
D:0| T0: 0.10| T1: 40.00| R0: 0.0| R1: 0.0| WTP: 0,0,0.096153846,40,0,0,0,0,0,-351017927.4,1743124675,6.041964265,350715829.2,35071582.92,1,67,6,1,1,0,1,67,0,1,1.044776119,0,0,99964.02985,3.119402985,0.014925373,99999.62687,0.999618251,3.49208E-05,3.1746E-07,0,0.015151515,9,4
D:0| T0: 0.10| T1: 40.00| R0: 0.0| R1: 0.0| WTP: 0,0,0.096153846,40,0,0,0,0,0,-4170478837,1965983789,11635.50704,3588703485,358870348.5,2,89511,3799,858,1933,1075,858,89511,1075,1933,82.73380035,1.437828371,3.295971979,74673.41506,907.9071804,4.789842382,99499.69352,0.744472079,0.009245881,4.9789E-05,0.556130367,0.021595111,81,40
D:0| T0: 0.10| T1: 40.00| R0: 0.0| R1: 0.0| WTP: 0,0,0.096153846,40,0,0,0,0,0,-1317483978,516774280,48.14581302,1315076687,131507668.7,1,422,13,8,8,0,8,422,0,8,1.315068493,0.01369863,0.01369863,99708.17123,17.60273973,0.054794521,99995.21918,0.997096431,0.000179454,1.10349E-06,0,0.018957346,20,15
D:0| T0: 0.10| T1: 40.00| R0: 0.0| R1: 0.0| WTP: 0,0,0.096153846,40,0,0,0,0,0,-2178897392,86603142,10427.39956,1657527414,165752741.4,1,82662,3563,504,1732,1228,504,82662,1228,1732,273.1005917,2.917159763,10.14792899,41358.82249,1269.260355,13.13017751,98857.53254,0.376476684,0.013599575,0.000141862,0.709006928,0.020952796,23,18
D:0| T0: 0.10| T1: 40.00| R0: 0.0| R1: 0.0| WTP: 0,0,0.096153846,40,0,0,0,0,0,-1052438462,1431870609,12.02063183,1051837430,105183743,1,103,3,2,2,0,2,103,0,2,0.175438596,0,0,99929.74561,5.99122807,0.01754386,99998.69298,0.999313467,6.16529E-05,3.47828E-07,0,0.019417476,17,12
D:0| T0: 0.10| T1: 40.00| R0: 0.0| R1: 0.0| WTP: 0,0,0.096153846,40,0,0,0,0,0,-4156055867,1592383984,11264.42052,3592834841,359283484.1,2,90720,4015,748,1871,1123,748,90720,1123,1871,101.8089431,1.349593496,3.609756098,74460.14228,535.695122,5.142276423,99503.81098,0.743691929,0.005429365,5.39337E-05,0.600213789,0.020624125,70,40
D:0| T0: 0.10| T1: 40.00| R0: 0.0| R1: 0.0| WTP: 0,0,0.096153846,40,0,0,0,0,0,-1845386120,1440183867,84.24197223,1841174021,184117402.1,1,562,23,14,14,0,14,562,0,14,1.653846154,0.032967033,0.032967033,99580.32967,14.44505495,0.104395604,99990.38462,0.995907812,0.00014591,1.53015E-06,0,0.024911032,26,21
D:0| T0: 0.10| T1: 40.00| R0: 0.0| R1: 0.0| WTP: 0,0,0.096153846,40,0,0,0,0,0,-1228510203,1696510588,24.08557134,1227305925,122730592.5,1,185,7,4,4,0,4,185,0,4,0.939393939,0,0,99886.80303,6.424242424,0.03030303,99998.94697,0.998873696,6.65158E-05,6.0607E-07,0,0.016304348,19,14
D:0| T0: 0.10| T1: 40.00| R0: 0.0| R1: 0.0| WTP: 0,0,0.096153846,40,0,0,0,0,0,-4243053067,895039877,12911.62583,3597471776,359747177.6,2,95910,4090,1247,2145,898,1247,95910,898,2145,104.8951613,2.334677419,4.120967742,63761.9879,1017.508065,6.633064516,99244.98589,0.629326234,0.010560629,7.09306E-05,0.418648019,0.022364717,69,40
D:0| T0: 0.10| T1: 40.00| R0: 0.0| R1: 0.0| WTP: 0,0,0.096153846,40,0,0,0,0,0,-3075530149,129565953,132.4911479,3068905591,306890559.1,1,1064,47,22,22,0,22,1064,0,22,2.336805556,0.041666667,0.041666667,99188.68056,26.70138889,0.114583333,99983.85764,0.99200247,0.000270307,1.53326E-06,0,0.020735156,40,35
D:0| T0: 0.10| T1: 40.00| R0: 0.0| R1: 0.0| WTP: 0,0,0.096153846,40,0,0,0,0,0,-614205817.2,1902565669,12.02590655,613604521.8,61360452.18,1,159,7,2,2,0,2,159,0,2,0.337078652,0,0,99909.01124,6.584269663,0.02247191,99999.30337,0.999048342,7.11768E-05,4.70591E-07,0,0.012578616,12,7
D:0| T0: 0.10| T1: 40.00| R0: 0.0| R1: 0.0| WTP: 0,0,0.096153846,40,0,0,0,0,0,-1491498301,1984179288,24.09664827,1490293468,149029346.8,1,236,13,4,4,0,4,236,0,4,0.852941176,0,0,99849.64118,10.67058824,0.023529412,99997.91176,0.998310015,0.000121613,5.36921E-07,0,0.016949153,22,17
D:0| T0: 0.10| T1: 40.00| R0: 0.0| R1: 0.0| WTP: 0,0,0.096153846,40,0,0,0,0,0,-4170186658,677377223,11541.0959,3593131863,359313186.3,2,90657,3966,1547,1917,370,1547,90657,370,1917,89.16636528,2.616636528,3.265822785,58892.51356,1333.576854,6.061482821,99180.67812,0.591012201,0.013439651,6.31048E-05,0.193009911,0.021145637,78,40
D:0| T0: 0.10| T1: 40.00| R0: 0.0| R1: 0.0| WTP: 0,0,0.096153846,40,0,0,0,0,0,-4156126149,973583301,11199.55541,3596148378,359614837.8,2,94501,4130,1002,1860,858,1002,94501,858,1860,98.55513308,1.758555133,3.363117871,65854.9943,1457.34981,5.281368821,99377.15399,0.657943271,0.014735965,5.50056E-05,0.461290323,0.019682331,75,40
D:0| T0: 0.10| T1: 40.00| R0: 0.0| R1: 0.0| WTP: 0,0,0.096153846,40,0,0,0,0,0,-1934003567,781062938,96.36862604,1929185135,192918513.5,1,768,40,16,16,0,16,768,0,16,2.836956522,0.032608696,0.032608696,99436.40761,20.13043478,0.114130435,99989.17391,0.994483096,0.000202611,1.72986E-06,0,0.020833333,27,22
D:0| T0: 0.10| T1: 40.00| R0: 0.0| R1: 0.0| WTP: 0,0,0.096153846,40,0,0,0,0,0,-4167267682,338783425,11392.15472,3597659947,359765994.7,2,95250,4322,816,1892,1076,816,95250,1076,1892,94.80789946,1.400359066,3.312387792,74186.72711,1393.971275,4.76481149,99542.12567,0.738142503,0.014245852,4.97018E-05,0.568710359,0.019863517,79,40
D:0| T0: 0.10| T1: 44.00| R0: 0.0| R1: 0.0| WTP: 0,0,0.096153846,44,0,0,0,0,0,-3245512837,650073325,42.1450026,3243405587,324340558.7,1,585,23,7,7,0,7,585,0,7,0.543062201,0,0,99699.44976,8.892344498,0.0215311,99996.10287,0.995767895,0.000122661,4.82773E-07,0,0.011965812,42,37
D:0| T0: 0.10| T1: 44.00| R0: 0.0| R1: 0.0| WTP: 0,0,0.096153846,44,0,0,0,0,0,-3924873036,2029998696,4202.830046,3714731534,371473153.4,1,34345,1498,690,698,8,690,34345,8,698,56.56586826,1.904191617,1.928143713,75365.20359,346.6826347,3.991017964,99519.18563,0.749716457,0.00357737,4.28548E-05,0.011461318,0.020323191,47,42
D:0| T0: 0.10| T1: 44.00| R0: 0.0| R1: 0.0| WTP: 0,0,0.096153846,44,0,0,0,0,0,-4539096808,776062361,12025.7127,3937811173,393781117.3,2,85374,3584,1780,1998,218,1780,85374,218,1998,58.00255754,2.121483376,2.393861893,42928.91432,677.4846547,4.670076726,98709.2532,0.41448179,0.007060533,5.03514E-05,0.109109109,0.02340291,108,44
D:0| T0: 0.10| T1: 44.00| R0: 0.0| R1: 0.0| WTP: 0,0,0.096153846,44,0,0,0,0,0,-790143259.7,1813046880,24.0502197,788940748.7,78894074.87,1,100,3,4,4,0,4,100,0,4,0.505154639,0.020618557,0.020618557,99933.56701,5.783505155,0.06185567,99997.71134,0.999361715,5.9491E-05,8.16337E-07,0,0.04,14,9
D:0| T0: 0.10| T1: 44.00| R0: 0.0| R1: 0.0| WTP: 0,0,0.096153846,44,0,0,0,0,0,-969116302.8,2032407216,84.31581289,964900512.2,96490051.22,1,779,40,14,14,0,14,779,0,14,3.552845528,0.056910569,0.056910569,99539.73171,21.43902439,0.162601626,99992.72358,0.994948703,0.000239204,2.52268E-06,0,0.018018018,16,11
D:0| T0: 0.10| T1: 44.00| R0: 0.0| R1: 0.0| WTP: 0,0,0.096153846,44,0,0,0,0,0,-613612900.2,1507873352,0.019516484,613611924.4,61361192.44,1,20,3,0,0,0,0,20,0,0,0.359223301,0,0,99989.39806,1.747572816,0,100000,0.999877209,2.0814E-05,0,0,0,12,7
D:0| T0: 0.10| T1: 44.00| R0: 0.0| R1: 0.0| WTP: 0,0,0.096153846,44,0,0,0,0,0,-613940692.7,1855899401,6.032997232,613639042.8,61363904.28,1,115,5,1,1,0,1,115,0,1,0.6625,0,0,99925.2875,4.475,0.0125,99999.425,0.999253494,4.67503E-05,0.00000025,0,0.008695652,12,7
D:0| T0: 0.10| T1: 44.00| R0: 0.0| R1: 0.0| WTP: 0,0,0.096153846,44,0,0,0,0,0,-3736266552,1819459251,980.8149334,3687225806,368722580.6,1,6818,273,163,163,0,163,6818,0,163,10.29102167,0.352941176,0.352941176,95168.03406,75.14241486,0.873065015,99888.87307,0.952770082,0.000752258,1.00698E-05,0,0.023907304,47,42
D:0| T0: 0.10| T1: 44.00| R0: 0.0| R1: 0.0| WTP: 0,0,0.096153846,44,0,0,0,0,0,-350960853.1,909791748,6.024030199,350659651.6,35065965.16,1,60,2,1,1,0,1,60,0,1,0.590163934,0,0,99965.06557,2.770491803,0.016393443,99999.70492,0.999655805,3.03226E-05,3.22581E-07,0,0.016949153,9,4
D:0| T0: 0.10| T1: 44.00| R0: 0.0| R1: 0.0| WTP: 0,0,0.096153846,44,0,0,0,0,0,-4562265137,1339092841,12505.48362,3936990956,393699095.6,2,87492,3704,806,2078,1272,806,87492,1272,2078,88.46615087,1.433268859,3.866537718,79246.9207,605.9555126,5.425531915,99537.00774,0.793300866,0.006112085,5.62428E-05,0.612127045,0.023750743,74,44
D:0| T0: 0.10| T1: 44.00| R0: 0.0| R1: 0.0| WTP: 0,0,0.096153846,44,0,0,0,0,0,-3781688591,1365866345,3316.332629,3615871959,361587195.9,1,24196,1027,537,551,14,537,24196,14,551,33.60869565,1.3125,1.350543478,83595.75272,206.0054348,2.831521739,99638.55435,0.813640508,0.002383834,3.41997E-05,0.025408348,0.0227733,46,41
D:0| T0: 0.10| T1: 44.00| R0: 0.0| R1: 0.0| WTP: 0,0,0.096153846,44,0,0,0,0,0,-4530920066,825453433,11656.31603,3948104265,394810426.5,2,93567,4209,761,1936,1175,761,93567,1175,1936,103.7504912,1.381139489,3.662082515,76895.6169,932.9430255,5.149312377,99574.19057,0.769139214,0.009397314,5.33858E-05,0.606921488,0.020691056,73,44
D:0| T0: 0.10| T1: 44.00| R0: 0.0| R1: 0.0| WTP: 0,0,0.096153846,44,0,0,0,0,0,-4138720897,939711378,4877.026703,3894869562,389486956.2,2,38780,1720,756,810,54,756,38780,54,810,62.88953488,2.034883721,2.197674419,70467.60756,443.6918605,4.395348837,99408.74419,0.70877946,0.004443848,4.55748E-05,0.066666667,0.020887055,50,44
D:0| T0: 0.10| T1: 44.00| R0: 0.0| R1: 0.0| WTP: 0,0,0.096153846,44,0,0,0,0,0,-2898786607,638950699,108.386626,2893367276,289336727.6,1,920,43,18,18,0,18,920,0,18,2.080769231,0.019230769,0.019230769,99325.93462,21.71153846,0.092307692,99987.01538,0.993398099,0.000218606,1.37943E-06,0,0.019565217,38,33
D:0| T0: 0.10| T1: 44.00| R0: 0.0| R1: 0.0| WTP: 0,0,0.096153846,44,0,0,0,0,0,-1141838461,938699148,42.12651908,1139732135,113973213.5,1,448,21,7,7,0,7,448,0,7,1.104895105,0.027972028,0.027972028,99750.46154,10.41958042,0.083916084,99996.03497,0.997085929,0.000124468,1.15705E-06,0,0.015625,18,13
D:0| T0: 0.10| T1: 44.00| R0: 0.0| R1: 0.0| WTP: 0,0,0.096153846,44,0,0,0,0,0,-1608662468,1412065496,524.0343361,1582460751,158246075.1,1,4166,192,87,87,0,87,4166,0,87,11.96566524,0.296137339,0.296137339,97987.71245,52.7167382,0.665236052,99961.07725,0.971141792,0.000765818,1.08795E-05,0,0.020888355,23,18
D:0| T0: 0.10| T1: 44.00| R0: 0.0| R1: 0.0| WTP: 0,0,0.096153846,44,0,0,0,0,0,-4543124926,1331335240,11991.5748,3943546186,394354618.6,2,88806,3866,1872,1992,120,1872,88806,120,1992,72.05022157,2.583456425,2.756277696,46464.03102,863.042836,5.52437223,98870.32939,0.457509023,0.008872547,5.86851E-05,0.060240964,0.022430917,95,44
D:0| T0: 0.10| T1: 44.00| R0: 0.0| R1: 0.0| WTP: 0,0,0.096153846,44,0,0,0,0,0,-2256898098,470935411,10400.72688,1736861754,173686175.4,1,76553,3241,665,1728,1063,665,76553,1063,1728,218.4385027,3.470588235,9.080213904,51483.99465,1060.395722,12.61497326,98995.65241,0.457515785,0.011972692,0.000144568,0.615162037,0.022572892,24,19
D:0| T0: 0.10| T1: 44.00| R0: 0.0| R1: 0.0| WTP: 0,0,0.096153846,44,0,0,0,0,0,-1580920072,823434397,60.11843935,1577914150,157791415,1,521,14,10,10,0,10,521,0,10,0.73125,0.01875,0.01875,99655.375,15.425,0.075,99994.88125,0.996611501,0.00015603,1.24229E-06,0,0.019230769,23,18
D:0| T0: 0.10| T1: 44.00| R0: 0.0| R1: 0.0| WTP: 0,0,0.096153846,44,0,0,0,0,0,-525966716.9,493045351,0.020043956,525965714.7,52596571.47,1,140,7,0,0,0,0,140,0,0,0.493506494,0,0,99918.5974,4.74025974,0,100000,0.999168158,5.05263E-05,0,0,0,11,6
D:0| T0: 0.10| T1: 44.00| R0: 0.0| R1: 0.0| WTP: 0,0,0.096153846,44,0,0,0,0,0,-1666457118,1700216563,18.07842027,1665553197,166555319.7,1,285,12,3,3,0,3,285,0,3,0.727272727,0,0,99812.71515,8.690909091,0.018181818,99998.15152,0.998150074,8.88566E-05,3.61449E-07,0,0.01056338,24,19
D:0| T0: 0.10| T1: 44.00| R0: 0.0| R1: 0.0| WTP: 0,0,0.096153846,44,0,0,0,0,0,-1325431175,1744119059,180.6954829,1316396400,131639640,1,1555,78,30,30,0,30,1555,0,30,6.927536232,0.137681159,0.137681159,98907.02899,29.65217391,0.34057971,99980.17391,0.989289112,0.000296518,4.31714E-06,0,0.019292605,20,15
D:0| T0: 0.10| T1: 44.00| R0: 0.0| R1: 0.0| WTP: 0,0,0.096153846,44,0,0,0,0,0,-701896219.8,2036906360,12.03909336,701294265.1,70129426.51,1,90,7,2,2,0,2,90,0,2,0.5,0,0,99953.46364,5.272727273,0.018181818,99998.94545,0.999462571,6.35494E-05,4.3011E-07,0,0.022222222,13,8
D:0| T0: 0.10| T1: 44.00| R0: 0.0| R1: 0.0| WTP: 0,0,0.096153846,44,0,0,0,0,0,-3248723308,809704121,102.2623815,3243610189,324361018.9,1,681,38,17,17,0,17,681,0,17,1.059800664,0.013289037,0.013289037,99526.12957,11.79401993,0.07641196,99987.95349,0.995356487,0.000120778,1.13342E-06,0,0.025,42,37
D:0| T0: 0.10| T1: 44.00| R0: 0.0| R1: 0.0| WTP: 0,0,0.096153846,44,0,0,0,0,0,-4565456592,1219866412,12311.72604,3949870291,394987029.1,2,95436,4229,1415,2045,630,1415,95436,630,2045,93.41901408,2.322183099,3.413732394,56644.96655,1381.551056,5.889084507,99126.17606,0.568673292,0.013932479,6.13957E-05,0.30806846,0.021427973,82,44
D:0| T0: 0.10| T1: 44.00| R0: 0.0| R1: 0.0| WTP: 0,0,0.096153846,44,0,0,0,0,0,-527532089.2,843498920,30.06529385,526028824.5,52602882.45,1,89,7,5,5,0,5,89,0,5,1.013333333,0,0,99943.44,5.053333333,0.08,99997.84,0.999459456,5.19746E-05,1.31582E-06,0,0.057471264,11,6
D:0| T0: 0.10| T1: 44.00| R0: 0.0| R1: 0.0| WTP: 0,0,0.096153846,44,0,0,0,0,0,-1056001584,107351963,78.1609805,1052093535,105209353.5,1,429,18,13,13,0,13,429,0,13,1.387931034,0.043103448,0.043103448,99715.08621,23.24137931,0.155172414,99993.66379,0.997198116,0.000234582,2.24151E-06,0,0.03030303,17,12
D:0| T0: 0.10| T1: 44.00| R0: 0.0| R1: 0.0| WTP: 0,0,0.096153846,44,0,0,0,0,0,-1229355149,773789021,42.0817004,1227251064,122725106.4,1,333,12,7,7,0,7,333,0,7,0.622222222,0.007407407,0.007407407,99783.48148,16.42222222,0.059259259,99996.36296,0.997845037,0.000167467,1.04481E-06,0,0.021021021,19,14
D:0| T0: 0.10| T1: 44.00| R0: 0.0| R1: 0.0| WTP: 0,0,0.096153846,44,0,0,0,0,0,-3163350586,850936611,138.4445462,3156428359,315642835.9,1,1310,49,23,23,0,23,1310,0,23,2.043478261,0.010033445,0.010033445,99140.18395,23.34782609,0.100334448,99987.19398,0.991124267,0.000246315,1.60857E-06,0,0.017570665,41,36
D:0| T0: 0.10| T1: 44.00| R0: 0.0| R1: 0.0| WTP: 0,0,0.096153846,44,0,0,0,0,0,-2216888293,1701318364,433.6792622,2195204330,219520433,1,3844,167,72,72,0,72,3844,0,72,10.58064516,0.230414747,0.230414747,97320.96774,75.29493088,0.562211982,99952.08756,0.972178328,0.00079515,6.99271E-06,0,0.018730489,30,25
D:0| T0: 0.10| T1: 44.00| R0: 0.0| R1: 0.0| WTP: 0,0,0.096153846,44,0,0,0,0,0,-701235203.9,778708269,0.010549451,701234676.5,70123467.65,1,42,2,0,0,0,0,42,0,0,0.224719101,0,0,99973.55056,3.516853933,0,100000,0.99972908,3.7931E-05,0,0,0,13,8
D:0| T0: 0.10| T1: 44.00| R0: 0.0| R1: 0.0| WTP: 0,0,0.096153846,44,0,0,0,0,0,-1149072005,1391938506,174.4410021,1140349954,114034995.4,1,765,35,29,29,0,29,765,0,29,4.184,0.072,0.072,99465.488,22.664,0.328,99983.104,0.994835265,0.000227169,4.60381E-06,0,0.037908497,18,13
D:0| T0: 0.10| T1: 44.00| R0: 0.0| R1: 0.0| WTP: 0,0,0.096153846,44,0,0,0,0,0,-789483172.3,43418681,12.01852194,788882246.2,78888224.62,1,96,6,2,2,0,2,96,0,2,0.173913043,0,0,99939.82609,6.27173913,0.02173913,99998.92391,0.999412034,6.43017E-05,4.3011E-07,0,0.020833333,14,9
D:0| T0: 0.10| T1: 44.00| R0: 0.0| R1: 0.0| WTP: 0,0,0.096153846,44,0,0,0,0,0,-1933022618,817384966,4700.967959,1697974220,169797422,1,35075,1454,502,781,279,502,35075,279,781,109.7559524,2.880952381,4.5,74182.78571,570.8452381,7.494047619,99474.94048,0.741220086,0.005799161,7.75974E-05,0.357234315,0.022266572,24,19
D:0| T0: 0.10| T1: 44.00| R0: 0.0| R1: 0.0| WTP: 0,0,0.096153846,44,0,0,0,0,0,-2060199363,762053968,2270.112325,1946693747,194669374.7,1,18589,805,352,377,25,352,18589,25,377,54.70157068,1.680628272,1.806282723,86422.54974,305.2356021,3.638743455,99746.60209,0.865141197,0.003076137,3.84398E-05,0.066312997,0.020280811,27,22
D:0| T0: 0.10| T1: 44.00| R0: 0.0| R1: 0.0| WTP: 0,0,0.096153846,44,0,0,0,0,0,-2022117363,1692506311,114.2434419,2016405191,201640519.1,1,554,21,19,19,0,19,554,0,19,1.185185185,0.027777778,0.027777778,99635.78241,17.24537037,0.115740741,99988.91667,0.996212583,0.000186105,1.88135E-06,0,0.03442029,28,23
D:0| T0: 0.10| T1: 44.00| R0: 0.0| R1: 0.0| WTP: 0,0,0.096153846,44,0,0,0,0,0,-2529871727,883828863,8869.02478,2086420488,208642048.8,1,72399,3225,693,1473,780,693,72399,780,1473,127.8454259,2.129337539,4.545741325,68328.85174,597.7917981,6.738170347,99401.89905,0.481055828,0.00987943,0.000113073,0.529531568,0.020345866,28,23
D:0| T0: 0.10| T1: 44.00| R0: 0.0| R1: 0.0| WTP: 0,0,0.096153846,44,0,0,0,0,0,-879289142.1,301400999,48.16217016,876881033.6,87688103.36,1,430,19,8,8,0,8,430,0,8,2.203883495,0.009708738,0.009708738,99719.3301,17.98058252,0.077669903,99996.08738,0.997240136,0.000180391,1.53851E-06,0,0.01627907,15,10
D:0| T0: 0.10| T1: 44.00| R0: 0.0| R1: 0.0| WTP: 0,0,0.096153846,44,0,0,0,0,0,-4540000575,1868336855,11866.09904,3946695623,394669562.3,2,95585,4143,966,1971,1005,966,95585,1005,1971,97.41619586,1.640301318,3.510357815,66130.03955,703.3163842,5.34086629,99331.7081,0.662580829,0.007090122,5.57177E-05,0.509893455,0.02062039,76,44
D:0| T0: 0.10| T1: 44.00| R0: 0.0| R1: 0.0| WTP: 0,0,0.096153846,44,0,0,0,0,0,-4563366023,1868498144,12346.32638,3946049704,394604970.4,2,94698,4142,1000,2051,1051,1000,94698,1051,2051,100.5284872,1.777996071,3.817288802,70071.81729,774.2907662,5.774066798,99383.12574,0.702112844,0.007808152,6.04033E-05,0.51243296,0.021658324,73,44
D:0| T0: 0.10| T1: 44.00| R0: 0.0| R1: 0.0| WTP: 0,0,0.096153846,44,0,0,0,0,0,-1316208864,2101566889,24.10086805,1315003820,131500382,1,197,10,4,4,0,4,197,0,4,1.092857143,0,0,99871.20714,8.478571429,0.028571429,99998.49286,0.998730896,8.63841E-05,5.67384E-07,0,0.020304569,20,15
D:0| T0: 0.10| T1: 44.00| R0: 0.0| R1: 0.0| WTP: 0,0,0.096153846,44,0,0,0,0,0,-2506479601,1665097450,8601.545333,2076402335,207640233.5,1,65856,2797,727,1429,702,727,65856,702,1429,150.0829694,3.091703057,6.091703057,59978.36681,986.6637555,9.279475983,99187.04803,0.531996643,0.011669175,0.000111386,0.491252624,0.021699188,28,23
D:0| T0: 0.10| T1: 44.00| R0: 0.0| R1: 0.0| WTP: 0,0,0.096153846,44,0,0,0,0,0,-3134140790,1716179948,7100.749478,2779103316,277910331.6,1,62522,2888,904,1179,275,904,62522,275,1179,143.4939271,3.530364372,4.591093117,55256.96761,870.6153846,8.255060729,99212.95951,0.556409872,0.008722186,8.44886E-05,0.233248516,0.018857362,36,31
D:0| T0: 0.10| T1: 44.00| R0: 0.0| R1: 0.0| WTP: 0,0,0.096153846,44,0,0,0,0,0,-968211161.5,1560278715,72.20920854,964600701.1,96460070.11,1,378,20,12,12,0,12,378,0,12,1.911111111,0.044444444,0.044444444,99801.24444,9.266666667,0.140740741,99995.45926,0.997746913,0.000108893,2.05139E-06,0,0.031830239,16,11
D:0| T0: 0.10| T1: 44.00| R0: 0.0| R1: 0.0| WTP: 0,0,0.096153846,44,0,0,0,0,0,-4609156922,991019385,13265.17178,3945898333,394589833.3,2,96268,4051,1157,2204,1047,1157,96268,1047,2204,101.6613226,2.106212425,4.184368737,66523.8497,1145.845691,6.509018036,99294.03206,0.666991404,0.011559489,6.79106E-05,0.475045372,0.02289442,72,44
D:0| T0: 0.10| T1: 44.00| R0: 0.0| R1: 0.0| WTP: 0,0,0.096153846,44,0,0,0,0,0,-4563405363,118052103,12352.53753,3945778486,394577848.6,2,90652,3968,1615,2052,437,1615,90652,437,2052,92.85055351,2.811808118,3.592250923,66243.59041,845.5147601,6.584870849,99282.50185,0.651468147,0.008854145,7.08026E-05,0.212962963,0.022636264,75,44
D:0| T0: 0.10| T1: 44.00| R0: 0.0| R1: 0.0| WTP: 0,0,0.096153846,44,0,0,0,0,0,-3739276661,1209758844,5669.548903,3455799216,345579921.6,1,39802,1632,912,942,30,912,39802,30,942,62.55421687,2.59939759,2.68373494,74012.20181,350.5481928,5.40060241,99421.42771,0.722330104,0.003809646,6.06732E-05,0.031847134,0.023668342,44,39
D:0| T0: 0.10| T1: 44.00| R0: 0.0| R1: 0.0| WTP: 0,0,0.096153846,44,0,0,0,0,0,-1052947058,70671723,18.09266202,1052042425,105204242.5,1,127,9,3,3,0,3,127,0,3,1.204918033,0,0,99909.68033,6.418032787,0.024590164,99998.28689,0.999087878,6.70596E-05,5.04207E-07,0,0.023622047,17,12
D:0| T0: 0.10| T1: 44.00| R0: 0.0| R1: 0.0| WTP: 0,0,0.096153846,44,0,0,0,0,0,-1052433031,1722612191,12.01904941,1051832078,105183207.8,1,52,2,2,2,0,2,52,0,2,0.137096774,0,0,99968.91129,2.266129032,0.016129032,99999.69355,0.999688942,2.43903E-05,3.25205E-07,0,0.019230769,17,12
D:0| T0: 0.10| T1: 44.00| R0: 0.0| R1: 0.0| WTP: 0,0,0.096153846,44,0,0,0,0,0,-1315580982,1968291596,12.08340106,1314976812,131497681.2,1,74,4,2,2,0,2,74,0,2,0.939189189,0,0,99953.10135,2.054054054,0.013513514,99999.31757,0.999506154,2.30435E-05,2.89857E-07,0,0.027027027,20,15
D:0| T0: 0.10| T1: 44.00| R0: 0.0| R1: 0.0| WTP: 0,0,0.096153846,44,0,0,0,0,0,-2786191699,1877569084,7379.32745,2417225327,241722532.7,1,54489,2272,800,1226,426,800,54489,426,1226,124.8384279,3.384279476,5.19650655,62121.41048,760.4061135,8.681222707,99200.20961,0.608616732,0.007964239,9.26726E-05,0.347471452,0.022499954,32,27
D:0| T0: 0.10| T1: 44.00| R0: 0.0| R1: 0.0| WTP: 0,0,0.096153846,44,0,0,0,0,0,-3282427743,1726322189,8331.581836,2865848652,286584865.2,1,64430,2780,922,1384,462,922,64430,462,1384,132.0343511,3.423664122,5.129770992,53690.77099,834.2099237,8.65648855,99069.10687,0.530405135,0.008561652,9.03579E-05,0.333815029,0.021480677,37,32
D:0| T0: 0.10| T1: 44.00| R0: 0.0| R1: 0.0| WTP: 0,0,0.096153846,44,0,0,0,0,0,-4538550315,307848836,11877.64741,3944667945,394466794.5,2,92047,4012,1379,1973,594,1379,92047,594,1973,91.17335766,2.370437956,3.434306569,56306.30474,588.540146,5.945255474,99123.74818,0.566178806,0.00593265,6.16204E-05,0.301064369,0.021434702,79,44
D:0| T0: 0.10| T1: 44.00| R0: 0.0| R1: 0.0| WTP: 0,0,0.096153846,44,0,0,0,0,0,-2428005378,1154000220,8622.134929,1996898631,199689863.1,1,70493,3203,573,1432,859,573,70493,859,1432,213.7567568,2.978378378,7.589189189,45278.82162,991.427027,10.7027027,98967.50811,0.457113026,0.009926297,0.000108592,0.599860335,0.020314074,27,22
D:0| T0: 0.10| T1: 44.00| R0: 0.0| R1: 0.0| WTP: 0,0,0.096153846,44,0,0,0,0,0,-1052833485,2028661055,18.05783785,1051930593,105193059.3,1,112,6,3,3,0,3,112,0,3,0.629310345,0.017241379,0.017241379,99925.72414,5.24137931,0.043103448,99998.93103,0.999270844,5.44448E-05,5.12824E-07,0,0.026785714,17,12
D:0| T0: 0.10| T1: 44.00| R0: 0.0| R1: 0.0| WTP: 0,0,0.096153846,44,0,0,0,0,0,-3873870371,1629114640,306.8810017,3858526320,385852632,2,2111,109,51,51,0,51,2111,0,51,3.220289855,0.052173913,0.052173913,98518.90145,37.92173913,0.205797101,99965.54203,0.98554119,0.000380588,2.9487E-06,0,0.024159166,50,44
D:0| T0: 0.10| T1: 44.00| R0: 0.0| R1: 0.0| WTP: 0,0,0.096153846,44,0,0,0,0,0,-3698190873,1439048174,7958.027189,3300289513,330028951.3,1,58598,2586,952,1322,370,952,58598,370,1322,110.6643836,3.157534247,4.386986301,56460.59247,852.8356164,7.657534247,99064.69178,0.564867544,0.00864515,7.89396E-05,0.279878971,0.022560497,42,37
D:0| T0: 0.10| T1: 44.00| R0: 0.0| R1: 0.0| WTP: 0,0,0.096153846,44,0,0,0,0,0,-2429458360,865227006,10387.96343,1910060189,191006018.9,1,77049,3206,516,1726,1210,516,77049,1210,1726,192.7427184,2.432038835,8.266990291,47539.26699,1004.548544,10.77669903,98903.93689,0.397248879,0.011652111,0.000126356,0.701042874,0.022401329,26,21
D:0| T0: 0.10| T1: 44.00| R0: 0.0| R1: 0.0| WTP: 0,0,0.096153846,44,0,0,0,0,0,-4503644550,890479738,11133.87205,3946950947,394695094.7,2,88891,4031,1770,1849,79,1770,88891,79,1849,75.15565345,2.419970631,2.540381791,47338.49192,933.6240822,5.13215859,98937.46549,0.476483637,0.009411515,5.3555E-05,0.042725798,0.020800756,98,44
D:0| T0: 0.10| T1: 44.00| R0: 0.0| R1: 0.0| WTP: 0,0,0.096153846,44,0,0,0,0,0,-527585116.1,1017049163,30.08270044,526080981,52608098.1,1,206,7,5,5,0,5,206,0,5,1.415584416,0,0,99874.22078,8.922077922,0.077922078,99997.54545,0.998771236,9.08995E-05,1.28208E-06,0,0.024271845,11,6
D:0| T0: 0.10| T1: 44.00| R0: 0.0| R1: 0.0| WTP: 0,0,0.096153846,44,0,0,0,0,0,-525937956.2,1707305064,0.011604396,525937375.9,52593737.59,1,42,2,0,0,0,0,42,0,0,0.258823529,0,0,99976.75294,2.105882353,0,100000,0.999740263,2.59211E-05,0,0,0,11,6
D:0| T0: 0.10| T1: 44.00| R0: 0.0| R1: 0.0| WTP: 0,0,0.096153846,44,0,0,0,0,0,-2139519155,400145663,9835.667205,1647735795,164773579.5,1,73632,3191,470,1634,1164,470,73632,1164,1634,251.75,2.86875,10.1,43556.6625,1234.725,13.04375,98834.25,0.440080531,0.01236459,0.000131774,0.712362301,0.022191439,23,18
D:0| T0: 0.10| T1: 44.00| R0: 0.0| R1: 0.0| WTP: 0,0,0.096153846,44,0,0,0,0,0,-525941393.5,1662654181,0.012131868,525940786.9,52594078.69,1,82,5,0,0,0,0,82,0,0,0.319444444,0,0,99949.04167,4.236111111,0,100000,0.999493151,4.41096E-05,0,0,0,11,6
D:0| T0: 0.10| T1: 44.00| R0: 0.0| R1: 0.0| WTP: 0,0,0.096153846,44,0,0,0,0,0,-2913521010,182136456,4924.857848,2667278117,266727811.7,1,40686,1786,622,818,196,622,40686,196,818,85.93975904,2.381526104,3.140562249,68996.13655,567.313253,5.614457831,99406.85944,0.687811385,0.005790945,5.90202E-05,0.239608802,0.02010569,35,30
D:0| T0: 0.10| T1: 44.00| R0: 0.0| R1: 0.0| WTP: 0,0,0.096153846,44,0,0,0,0,0,-526250066.5,979575387,6.020337891,525949049.6,52594904.96,1,39,2,1,1,0,1,39,0,1,0.397260274,0,0,99973.34247,3.178082192,0.01369863,99999.63014,0.999739188,3.32433E-05,2.7027E-07,0,0.025641026,11,6
D:0| T0: 0.10| T1: 44.00| R0: 0.0| R1: 0.0| WTP: 0,0,0.096153846,44,0,0,0,0,0,-4544574032,2142525414,12062.88338,3941429863,394142986.3,2,90520,3893,1723,2004,281,1723,90520,281,2004,82.54513889,2.819444444,3.288194444,54652.08854,613.9184028,6.277777778,99030.12674,0.539612697,0.006335282,6.67284E-05,0.140219561,0.022138998,81,44
D:0| T0: 0.10| T1: 44.00| R0: 0.0| R1: 0.0| WTP: 0,0,0.096153846,44,0,0,0,0,0,-4503725826,1464057597,11251.94505,3941128573,394112857.3,2,87992,3816,1433,1869,436,1433,87992,436,1869,91.83716475,2.540229885,3.352490421,66707.31609,630.743295,6.120689655,99340.09004,0.668458806,0.006367092,6.382E-05,0.233279829,0.021240567,75,44
D:0| T0: 0.10| T1: 44.00| R0: 0.0| R1: 0.0| WTP: 0,0,0.096153846,44,0,0,0,0,0,-4037261739,364562610,6200.763066,3727223586,372722358.6,1,47107,2076,927,1030,103,927,47107,103,1030,77.54054054,2.636636637,2.930930931,66038.46246,475.987988,5.708708709,99294.42342,0.659587666,0.004843514,5.97884E-05,0.1,0.02186558,47,42
D:0| T0: 0.10| T1: 44.00| R0: 0.0| R1: 0.0| WTP: 0,0,0.096153846,44,0,0,0,0,0,-4508917752,40350784,11413.26908,3938254298,393825429.8,2,86247,3700,1717,1896,179,1717,86247,179,1896,75.07704918,2.629508197,2.908196721,51779.33607,542.757377,5.736065574,98993.1,0.521452474,0.00547081,5.96854E-05,0.094409283,0.021983373,88,44
D:0| T0: 0.10| T1: 44.00| R0: 0.0| R1: 0.0| WTP: 0,0,0.096153846,44,0,0,0,0,0,-2505830727,804064356,873.3914557,2462161154,246216115.4,1,8065,346,145,145,0,145,8065,0,145,19.31512605,0.470588235,0.470588235,94387.64286,97.62184874,1.067226891,99905.22269,0.941649961,0.001031097,1.28409E-05,0,0.017978921,33,28
D:0| T0: 0.10| T1: 44.00| R0: 0.0| R1: 0.0| WTP: 0,0,0.096153846,44,0,0,0,0,0,-1591445843,2125493986,246.6775898,1579111963,157911196.3,1,1624,65,41,41,0,41,1624,0,41,4.919753086,0.148148148,0.148148148,98779.08642,31.29012346,0.388888889,99971.61111,0.988023329,0.000315492,5.06271E-06,0,0.025246305,23,18
D:0| T0: 0.10| T1: 44.00| R0: 0.0| R1: 0.0| WTP: 0,0,0.096153846,44,0,0,0,0,0,-4445060939,23154253,10062.96111,3941912884,394191288.4,2,87689,3965,1029,1671,642,1029,87689,642,1671,90.92777778,1.737037037,2.905555556,68107.19444,432.3055556,4.798148148,99427.25,0.677603344,0.004426068,5.11537E-05,0.384201077,0.019055982,76,44
D:0| T0: 0.10| T1: 44.00| R0: 0.0| R1: 0.0| WTP: 0,0,0.096153846,44,0,0,0,0,0,-1142623034,1391367689,54.19463992,1139913302,113991330.2,1,338,17,9,9,0,9,338,0,9,2.113636364,0.007575758,0.007575758,99793.95455,9.575757576,0.068181818,99995.55303,0.99782669,0.000104557,1.46347E-06,0,0.026627219,18,13
D:0| T0: 0.10| T1: 44.00| R0: 0.0| R1: 0.0| WTP: 0,0,0.096153846,44,0,0,0,0,0,-2373249439,574142276,120.3212743,2367233375,236723337.5,1,904,35,20,20,0,20,904,0,20,1.743362832,0.026548673,0.026548673,99415.21239,18.70353982,0.119469027,99988.92478,0.994167234,0.00019208,1.79389E-06,0,0.022197558,32,27
D:0| T0: 0.10| T1: 44.00| R0: 0.0| R1: 0.0| WTP: 0,0,0.096153846,44,0,0,0,0,0,-789165407.6,898736779,6.008733495,788864970.9,78886497.09,1,24,2,1,1,0,1,24,0,1,0.061946903,0,0,99986.50442,1.566371681,0.017699115,99999.30088,0.999855611,1.85716E-05,2.04082E-07,0,0.041666667,14,9
D:0| T0: 0.10| T1: 44.00| R0: 0.0| R1: 0.0| WTP: 0,0,0.096153846,44,0,0,0,0,0,-4460395181,346473503,10073.63822,3956713270,395671327,2,97272,4713,715,1672,957,715,97272,957,1672,93.77403846,1.025641026,2.544871795,72034.34936,891.5176282,3.708333333,99554.24359,0.684110284,0.010140731,4.35159E-05,0.572368421,0.017188914,79,44
D:0| T0: 0.10| T1: 44.00| R0: 0.0| R1: 0.0| WTP: 0,0,0.096153846,44,0,0,0,0,0,-3522565671,445552282,294.8487435,3507823234,350782323.4,1,1897,71,49,49,0,49,1897,0,49,2.808,0.058666667,0.058666667,98828.98933,29.76266667,0.184,99970.36267,0.986723145,0.000346249,3.03477E-06,0,0.025830258,45,40
D:0| T0: 0.10| T1: 44.00| R0: 0.0| R1: 0.0| WTP: 0,0,0.096153846,44,0,0,0,0,0,-2011827938,911758476,8977.866356,1562934620,156293462,1,73322,3308,588,1491,903,588,73322,903,1491,232.6961326,3.132596685,8.071823204,54995.9779,1135.596685,11.35359116,99165.98895,0.475027389,0.013352622,0.000135158,0.605633803,0.020334961,22,17
D:0| T0: 0.10| T1: 44.00| R0: 0.0| R1: 0.0| WTP: 0,0,0.096153846,44,0,0,0,0,0,-3763347592,1464197940,7436.756996,3391509742,339150974.2,1,60745,2707,1049,1235,186,1049,60745,186,1235,117.1423729,3.406779661,4.013559322,57814.15593,1202.549153,7.566101695,99188.85424,0.582136824,0.012061021,7.76397E-05,0.150729335,0.020314429,43,38
D:0| T0: 0.10| T1: 44.00| R0: 0.0| R1: 0.0| WTP: 0,0,0.096153846,44,0,0,0,0,0,-1846187106,500405854,96.31167549,1841371522,184137152.2,1,815,38,16,16,0,16,815,0,16,2.195876289,0.015463918,0.015463918,99429.20619,17.81443299,0.103092784,99990.11856,0.994033317,0.000190615,1.74876E-06,0,0.019631902,26,21
D:0| T0: 0.10| T1: 44.00| R0: 0.0| R1: 0.0| WTP: 0,0,0.096153846,44,0,0,0,0,0,-2715436198,772037341,1516.694091,2639601493,263960149.3,1,10466,464,251,252,1,251,10466,1,252,23.22222222,0.872427984,0.87654321,91911.48971,139.7942387,1.9218107,99816.16461,0.920893209,0.001396184,2.06399E-05,0.003968254,0.024082569,35,30
D:0| T0: 0.10| T1: 44.00| R0: 0.0| R1: 0.0| WTP: 0,0,0.096153846,44,0,0,0,0,0,-614302229.6,1543158763,12.0575549,613699351.8,61369935.18,1,88,7,2,2,0,2,88,0,2,0.957446809,0,0,99948.54255,4.223404255,0.021276596,99999.11702,0.999429028,4.89161E-05,4.8193E-07,0,0.022988506,12,7
D:0| T0: 0.10| T1: 44.00| R0: 0.0| R1: 0.0| WTP: 0,0,0.096153846,44,0,0,0,0,0,-2760809633,1604932531,6975.221668,2412048550,241204855,1,49590,2060,647,1159,512,647,49590,512,1159,108.7584746,2.63559322,4.775423729,63899.97034,616.2457627,7.504237288,99204.4322,0.617890544,0.006618689,8.22141E-05,0.441760138,0.023371648,32,27
D:0| T0: 0.10| T1: 44.00| R0: 0.0| R1: 0.0| WTP: 0,0,0.096153846,44,0,0,0,0,0,-4540930543,539051477,11896.25829,3946117629,394611762.9,2,92192,4064,1723,1976,253,1723,92192,253,1976,81.72977346,2.618122977,3.012944984,54771.33172,854.1941748,5.807443366,99070.65372,0.526988526,0.009068459,6.35136E-05,0.128036437,0.02143353,84,44
D:0| T0: 0.10| T1: 44.00| R0: 0.0| R1: 0.0| WTP: 0,0,0.096153846,44,0,0,0,0,0,-351017927.4,1743124675,6.041964265,350715829.2,35071582.92,1,67,6,1,1,0,1,67,0,1,1.044776119,0,0,99964.02985,3.119402985,0.014925373,99999.62687,0.999618251,3.49208E-05,3.1746E-07,0,0.015151515,9,4
D:0| T0: 0.10| T1: 44.00| R0: 0.0| R1: 0.0| WTP: 0,0,0.096153846,44,0,0,0,0,0,-3861979852,1965983789,96.25998868,3857166853,385716685.3,2,727,25,16,16,0,16,727,0,16,0.937853107,0.005649718,0.005649718,99584.13277,11.43220339,0.053672316,99992.27684,0.995851768,0.000118346,9.16974E-07,0,0.022008253,50,44
D:0| T0: 0.10| T1: 44.00| R0: 0.0| R1: 0.0| WTP: 0,0,0.096153846,44,0,0,0,0,0,-1317483978,516774280,48.14581302,1315076687,131507668.7,1,422,13,8,8,0,8,422,0,8,1.315068493,0.01369863,0.01369863,99708.17123,17.60273973,0.054794521,99995.21918,0.997096431,0.000179454,1.10349E-06,0,0.018957346,20,15
D:0| T0: 0.10| T1: 44.00| R0: 0.0| R1: 0.0| WTP: 0,0,0.096153846,44,0,0,0,0,0,-2178897392,86603142,10427.39956,1657527414,165752741.4,1,82662,3563,504,1732,1228,504,82662,1228,1732,273.1005917,2.917159763,10.14792899,41358.82249,1269.260355,13.13017751,98857.53254,0.376476684,0.013599575,0.000141862,0.709006928,0.020952796,23,18
D:0| T0: 0.10| T1: 44.00| R0: 0.0| R1: 0.0| WTP: 0,0,0.096153846,44,0,0,0,0,0,-1052438462,1431870609,12.02063183,1051837430,105183743,1,103,3,2,2,0,2,103,0,2,0.175438596,0,0,99929.74561,5.99122807,0.01754386,99998.69298,0.999313467,6.16529E-05,3.47828E-07,0,0.019417476,17,12
D:0| T0: 0.10| T1: 44.00| R0: 0.0| R1: 0.0| WTP: 0,0,0.096153846,44,0,0,0,0,0,-4510105726,1592383984,11300.98869,3945056292,394505629.2,2,90999,4102,789,1877,1088,789,90999,1088,1877,96.29056604,1.322641509,3.352830189,74384.26981,503.5075472,4.866037736,99500.58679,0.743081875,0.005101572,5.09511E-05,0.579648375,0.0206266,76,44
D:0| T0: 0.10| T1: 44.00| R0: 0.0| R1: 0.0| WTP: 0,0,0.096153846,44,0,0,0,0,0,-1845386120,1440183867,84.24197223,1841174021,184117402.1,1,562,23,14,14,0,14,562,0,14,1.653846154,0.032967033,0.032967033,99580.32967,14.44505495,0.104395604,99990.38462,0.995907812,0.00014591,1.53015E-06,0,0.024911032,26,21
D:0| T0: 0.10| T1: 44.00| R0: 0.0| R1: 0.0| WTP: 0,0,0.096153846,44,0,0,0,0,0,-1228510203,1696510588,24.08557134,1227305925,122730592.5,1,185,7,4,4,0,4,185,0,4,0.939393939,0,0,99886.80303,6.424242424,0.03030303,99998.94697,0.998873696,6.65158E-05,6.0607E-07,0,0.016304348,19,14
D:0| T0: 0.10| T1: 44.00| R0: 0.0| R1: 0.0| WTP: 0,0,0.096153846,44,0,0,0,0,0,-4594984880,895039877,12923.8696,3948791400,394879140,2,95827,4107,1241,2147,906,1241,95827,906,2147,95.42363636,2.090909091,3.72,62019.09091,909.4781818,5.969090909,99201.15091,0.612612311,0.009412775,6.37226E-05,0.421984164,0.022404959,77,44
D:0| T0: 0.10| T1: 44.00| R0: 0.0| R1: 0.0| WTP: 0,0,0.096153846,44,0,0,0,0,0,-3075530149,129565953,132.4911479,3068905591,306890559.1,1,1064,47,22,22,0,22,1064,0,22,2.336805556,0.041666667,0.041666667,99188.68056,26.70138889,0.114583333,99983.85764,0.99200247,0.000270307,1.53326E-06,0,0.020735156,40,35
D:0| T0: 0.10| T1: 44.00| R0: 0.0| R1: 0.0| WTP: 0,0,0.096153846,44,0,0,0,0,0,-614205817.2,1902565669,12.02590655,613604521.8,61360452.18,1,159,7,2,2,0,2,159,0,2,0.337078652,0,0,99909.01124,6.584269663,0.02247191,99999.30337,0.999048342,7.11768E-05,4.70591E-07,0,0.012578616,12,7
D:0| T0: 0.10| T1: 44.00| R0: 0.0| R1: 0.0| WTP: 0,0,0.096153846,44,0,0,0,0,0,-1491498301,1984179288,24.09664827,1490293468,149029346.8,1,236,13,4,4,0,4,236,0,4,0.852941176,0,0,99849.64118,10.67058824,0.023529412,99997.91176,0.998310015,0.000121613,5.36921E-07,0,0.016949153,22,17
D:0| T0: 0.10| T1: 44.00| R0: 0.0| R1: 0.0| WTP: 0,0,0.096153846,44,0,0,0,0,0,-4517743366,677377223,11504.69046,3942508843,394250884.3,2,89913,3918,1630,1911,281,1630,89913,281,1911,85.35915493,2.674295775,3.153169014,61033.88028,1290.103873,6.022887324,99216.97007,0.612650104,0.013004858,6.28108E-05,0.147043433,0.021253879,81,44
D:0| T0: 0.10| T1: 44.00| R0: 0.0| R1: 0.0| WTP: 0,0,0.096153846,44,0,0,0,0,0,-4525504556,973583301,11536.51046,3948679033,394867903.3,2,94201,4194,1067,1916,849,1067,94201,849,1916,98.85981308,1.837383178,3.409345794,69136.5028,1431.749533,5.409345794,99423.63925,0.690975657,0.014480791,5.6377E-05,0.443110647,0.020339487,77,44
D:0| T0: 0.10| T1: 44.00| R0: 0.0| R1: 0.0| WTP: 0,0,0.096153846,44,0,0,0,0,0,-1934003567,781062938,96.36862604,1929185135,192918513.5,1,768,40,16,16,0,16,768,0,16,2.836956522,0.032608696,0.032608696,99436.40761,20.13043478,0.114130435,99989.17391,0.994483096,0.000202611,1.72986E-06,0,0.020833333,27,22
D:0| T0: 0.10| T1: 44.00| R0: 0.0| R1: 0.0| WTP: 0,0,0.096153846,44,0,0,0,0,0,-4554237807,338783425,12136.55949,3947409833,394740983.3,2,95344,4232,843,2016,1173,843,95344,1173,2016,89.23458904,1.373287671,3.359589041,74084.9589,1336.871575,4.806506849,99509.49658,0.737315454,0.013662209,5.00505E-05,0.581845238,0.021144487,83,44
D:0| T0: 0.10| T1: 48.00| R0: 0.0| R1: 0.0| WTP: 0,0,0.096153846,48,0,0,0,0,0,-3245512837,650073325,42.1450026,3243405587,324340558.7,1,585,23,7,7,0,7,585,0,7,0.543062201,0,0,99699.44976,8.892344498,0.0215311,99996.10287,0.995767895,0.000122661,4.82773E-07,0,0.011965812,42,37
D:0| T0: 0.10| T1: 48.00| R0: 0.0| R1: 0.0| WTP: 0,0,0.096153846,48,0,0,0,0,0,-3924873036,2029998696,4202.830046,3714731534,371473153.4,1,34345,1498,690,698,8,690,34345,8,698,56.56586826,1.904191617,1.928143713,75365.20359,346.6826347,3.991017964,99519.18563,0.749716457,0.00357737,4.28548E-05,0.011461318,0.020323191,47,42
D:0| T0: 0.10| T1: 48.00| R0: 0.0| R1: 0.0| WTP: 0,0,0.096153846,48,0,0,0,0,0,-4888419668,776062361,12013.47741,4287745797,428774579.7,2,85625,3584,1777,1996,219,1777,85625,219,1996,57.99354839,2.135483871,2.411612903,43992.5071,686.5174194,4.707096774,98733.99742,0.425378763,0.007157169,5.07527E-05,0.109719439,0.023310949,107,48
D:0| T0: 0.10| T1: 48.00| R0: 0.0| R1: 0.0| WTP: 0,0,0.096153846,48,0,0,0,0,0,-790143259.7,1813046880,24.0502197,788940748.7,78894074.87,1,100,3,4,4,0,4,100,0,4,0.505154639,0.020618557,0.020618557,99933.56701,5.783505155,0.06185567,99997.71134,0.999361715,5.9491E-05,8.16337E-07,0,0.04,14,9
D:0| T0: 0.10| T1: 48.00| R0: 0.0| R1: 0.0| WTP: 0,0,0.096153846,48,0,0,0,0,0,-969116302.8,2032407216,84.31581289,964900512.2,96490051.22,1,779,40,14,14,0,14,779,0,14,3.552845528,0.056910569,0.056910569,99539.73171,21.43902439,0.162601626,99992.72358,0.994948703,0.000239204,2.52268E-06,0,0.018018018,16,11
D:0| T0: 0.10| T1: 48.00| R0: 0.0| R1: 0.0| WTP: 0,0,0.096153846,48,0,0,0,0,0,-613612900.2,1507873352,0.019516484,613611924.4,61361192.44,1,20,3,0,0,0,0,20,0,0,0.359223301,0,0,99989.39806,1.747572816,0,100000,0.999877209,2.0814E-05,0,0,0,12,7
D:0| T0: 0.10| T1: 48.00| R0: 0.0| R1: 0.0| WTP: 0,0,0.096153846,48,0,0,0,0,0,-613940692.7,1855899401,6.032997232,613639042.8,61363904.28,1,115,5,1,1,0,1,115,0,1,0.6625,0,0,99925.2875,4.475,0.0125,99999.425,0.999253494,4.67503E-05,0.00000025,0,0.008695652,12,7
D:0| T0: 0.10| T1: 48.00| R0: 0.0| R1: 0.0| WTP: 0,0,0.096153846,48,0,0,0,0,0,-3736266552,1819459251,980.8149334,3687225806,368722580.6,1,6818,273,163,163,0,163,6818,0,163,10.29102167,0.352941176,0.352941176,95168.03406,75.14241486,0.873065015,99888.87307,0.952770082,0.000752258,1.00698E-05,0,0.023907304,47,42
D:0| T0: 0.10| T1: 48.00| R0: 0.0| R1: 0.0| WTP: 0,0,0.096153846,48,0,0,0,0,0,-350960853.1,909791748,6.024030199,350659651.6,35065965.16,1,60,2,1,1,0,1,60,0,1,0.590163934,0,0,99965.06557,2.770491803,0.016393443,99999.70492,0.999655805,3.03226E-05,3.22581E-07,0,0.016949153,9,4
D:0| T0: 0.10| T1: 48.00| R0: 0.0| R1: 0.0| WTP: 0,0,0.096153846,48,0,0,0,0,0,-4896446822,1339092841,12222.47625,4285323009,428532300.9,2,87518,3645,778,2031,1253,778,87518,1253,2031,77.79334501,1.248686515,3.423817863,76839.28371,549.6532399,4.784588441,99487.82487,0.76933706,0.005543509,4.95929E-05,0.616937469,0.023206655,82,48
D:0| T0: 0.10| T1: 48.00| R0: 0.0| R1: 0.0| WTP: 0,0,0.096153846,48,0,0,0,0,0,-3781688591,1365866345,3316.332629,3615871959,361587195.9,1,24196,1027,537,551,14,537,24196,14,551,33.60869565,1.3125,1.350543478,83595.75272,206.0054348,2.831521739,99638.55435,0.813640508,0.002383834,3.41997E-05,0.025408348,0.0227733,46,41
D:0| T0: 0.10| T1: 48.00| R0: 0.0| R1: 0.0| WTP: 0,0,0.096153846,48,0,0,0,0,0,-4855465617,825453433,11216.58741,4294636246,429463624.6,2,93271,4056,736,1863,1127,736,93271,1127,1863,89.56483126,1.202486679,3.18294849,74446.58615,841.5435169,4.477797513,99533.73357,0.744767177,0.008476585,4.65054E-05,0.604938272,0.019974054,81,48
D:0| T0: 0.10| T1: 48.00| R0: 0.0| R1: 0.0| WTP: 0,0,0.096153846,48,0,0,0,0,0,-4226371128,939711378,4877.026703,3982519793,398251979.3,1,38780,1720,756,810,54,756,38780,54,810,62.88953488,2.034883721,2.197674419,70467.60756,443.6918605,4.395348837,99408.74419,0.70877946,0.004443848,4.55748E-05,0.066666667,0.020887055,50,45
D:0| T0: 0.10| T1: 48.00| R0: 0.0| R1: 0.0| WTP: 0,0,0.096153846,48,0,0,0,0,0,-2898786607,638950699,108.386626,2893367276,289336727.6,1,920,43,18,18,0,18,920,0,18,2.080769231,0.019230769,0.019230769,99325.93462,21.71153846,0.092307692,99987.01538,0.993398099,0.000218606,1.37943E-06,0,0.019565217,38,33
D:0| T0: 0.10| T1: 48.00| R0: 0.0| R1: 0.0| WTP: 0,0,0.096153846,48,0,0,0,0,0,-1141838461,938699148,42.12651908,1139732135,113973213.5,1,448,21,7,7,0,7,448,0,7,1.104895105,0.027972028,0.027972028,99750.46154,10.41958042,0.083916084,99996.03497,0.997085929,0.000124468,1.15705E-06,0,0.015625,18,13
D:0| T0: 0.10| T1: 48.00| R0: 0.0| R1: 0.0| WTP: 0,0,0.096153846,48,0,0,0,0,0,-1608662468,1412065496,524.0343361,1582460751,158246075.1,1,4166,192,87,87,0,87,4166,0,87,11.96566524,0.296137339,0.296137339,97987.71245,52.7167382,0.665236052,99961.07725,0.971141792,0.000765818,1.08795E-05,0,0.020888355,23,18
D:0| T0: 0.10| T1: 48.00| R0: 0.0| R1: 0.0| WTP: 0,0,0.096153846,48,0,0,0,0,0,-4855292040,1331335240,11281.92769,4291195655,429119565.5,2,88488,3809,1785,1874,89,1785,88488,89,1874,69.12445095,2.423133236,2.554904832,49133.81259,852.8872621,5.172767204,98960.98097,0.485016521,0.008765253,5.50444E-05,0.047491996,0.021178252,96,48
D:0| T0: 0.10| T1: 48.00| R0: 0.0| R1: 0.0| WTP: 0,0,0.096153846,48,0,0,0,0,0,-2256898098,470935411,10400.72688,1736861754,173686175.4,1,76553,3241,665,1728,1063,665,76553,1063,1728,218.4385027,3.470588235,9.080213904,51483.99465,1060.395722,12.61497326,98995.65241,0.457515785,0.011972692,0.000144568,0.615162037,0.022572892,24,19
D:0| T0: 0.10| T1: 48.00| R0: 0.0| R1: 0.0| WTP: 0,0,0.096153846,48,0,0,0,0,0,-1580920072,823434397,60.11843935,1577914150,157791415,1,521,14,10,10,0,10,521,0,10,0.73125,0.01875,0.01875,99655.375,15.425,0.075,99994.88125,0.996611501,0.00015603,1.24229E-06,0,0.019230769,23,18
D:0| T0: 0.10| T1: 48.00| R0: 0.0| R1: 0.0| WTP: 0,0,0.096153846,48,0,0,0,0,0,-525966716.9,493045351,0.020043956,525965714.7,52596571.47,1,140,7,0,0,0,0,140,0,0,0.493506494,0,0,99918.5974,4.74025974,0,100000,0.999168158,5.05263E-05,0,0,0,11,6
D:0| T0: 0.10| T1: 48.00| R0: 0.0| R1: 0.0| WTP: 0,0,0.096153846,48,0,0,0,0,0,-1666457118,1700216563,18.07842027,1665553197,166555319.7,1,285,12,3,3,0,3,285,0,3,0.727272727,0,0,99812.71515,8.690909091,0.018181818,99998.15152,0.998150074,8.88566E-05,3.61449E-07,0,0.01056338,24,19
D:0| T0: 0.10| T1: 48.00| R0: 0.0| R1: 0.0| WTP: 0,0,0.096153846,48,0,0,0,0,0,-1325431175,1744119059,180.6954829,1316396400,131639640,1,1555,78,30,30,0,30,1555,0,30,6.927536232,0.137681159,0.137681159,98907.02899,29.65217391,0.34057971,99980.17391,0.989289112,0.000296518,4.31714E-06,0,0.019292605,20,15
D:0| T0: 0.10| T1: 48.00| R0: 0.0| R1: 0.0| WTP: 0,0,0.096153846,48,0,0,0,0,0,-701896219.8,2036906360,12.03909336,701294265.1,70129426.51,1,90,7,2,2,0,2,90,0,2,0.5,0,0,99953.46364,5.272727273,0.018181818,99998.94545,0.999462571,6.35494E-05,4.3011E-07,0,0.022222222,13,8
D:0| T0: 0.10| T1: 48.00| R0: 0.0| R1: 0.0| WTP: 0,0,0.096153846,48,0,0,0,0,0,-3248723308,809704121,102.2623815,3243610189,324361018.9,1,681,38,17,17,0,17,681,0,17,1.059800664,0.013289037,0.013289037,99526.12957,11.79401993,0.07641196,99987.95349,0.995356487,0.000120778,1.13342E-06,0,0.025,42,37
D:0| T0: 0.10| T1: 48.00| R0: 0.0| R1: 0.0| WTP: 0,0,0.096153846,48,0,0,0,0,0,-4908509119,1219866412,12179.30766,4299543736,429954373.6,2,95392,4196,1430,2023,593,1430,95392,593,2023,87.515,2.218333333,3.186666667,57173.78333,1305.041667,5.548333333,99140.99667,0.574086212,0.01316163,5.8004E-05,0.293129016,0.021207229,86,48
D:0| T0: 0.10| T1: 48.00| R0: 0.0| R1: 0.0| WTP: 0,0,0.096153846,48,0,0,0,0,0,-527532089.2,843498920,30.06529385,526028824.5,52602882.45,1,89,7,5,5,0,5,89,0,5,1.013333333,0,0,99943.44,5.053333333,0.08,99997.84,0.999459456,5.19746E-05,1.31582E-06,0,0.057471264,11,6
D:0| T0: 0.10| T1: 48.00| R0: 0.0| R1: 0.0| WTP: 0,0,0.096153846,48,0,0,0,0,0,-1056001584,107351963,78.1609805,1052093535,105209353.5,1,429,18,13,13,0,13,429,0,13,1.387931034,0.043103448,0.043103448,99715.08621,23.24137931,0.155172414,99993.66379,0.997198116,0.000234582,2.24151E-06,0,0.03030303,17,12
D:0| T0: 0.10| T1: 48.00| R0: 0.0| R1: 0.0| WTP: 0,0,0.096153846,48,0,0,0,0,0,-1229355149,773789021,42.0817004,1227251064,122725106.4,1,333,12,7,7,0,7,333,0,7,0.622222222,0.007407407,0.007407407,99783.48148,16.42222222,0.059259259,99996.36296,0.997845037,0.000167467,1.04481E-06,0,0.021021021,19,14
D:0| T0: 0.10| T1: 48.00| R0: 0.0| R1: 0.0| WTP: 0,0,0.096153846,48,0,0,0,0,0,-3163350586,850936611,138.4445462,3156428359,315642835.9,1,1310,49,23,23,0,23,1310,0,23,2.043478261,0.010033445,0.010033445,99140.18395,23.34782609,0.100334448,99987.19398,0.991124267,0.000246315,1.60857E-06,0,0.017570665,41,36
D:0| T0: 0.10| T1: 48.00| R0: 0.0| R1: 0.0| WTP: 0,0,0.096153846,48,0,0,0,0,0,-2216888293,1701318364,433.6792622,2195204330,219520433,1,3844,167,72,72,0,72,3844,0,72,10.58064516,0.230414747,0.230414747,97320.96774,75.29493088,0.562211982,99952.08756,0.972178328,0.00079515,6.99271E-06,0,0.018730489,30,25
D:0| T0: 0.10| T1: 48.00| R0: 0.0| R1: 0.0| WTP: 0,0,0.096153846,48,0,0,0,0,0,-701235203.9,778708269,0.010549451,701234676.5,70123467.65,1,42,2,0,0,0,0,42,0,0,0.224719101,0,0,99973.55056,3.516853933,0,100000,0.99972908,3.7931E-05,0,0,0,13,8
D:0| T0: 0.10| T1: 48.00| R0: 0.0| R1: 0.0| WTP: 0,0,0.096153846,48,0,0,0,0,0,-1149072005,1391938506,174.4410021,1140349954,114034995.4,1,765,35,29,29,0,29,765,0,29,4.184,0.072,0.072,99465.488,22.664,0.328,99983.104,0.994835265,0.000227169,4.60381E-06,0,0.037908497,18,13
D:0| T0: 0.10| T1: 48.00| R0: 0.0| R1: 0.0| WTP: 0,0,0.096153846,48,0,0,0,0,0,-789483172.3,43418681,12.01852194,788882246.2,78888224.62,1,96,6,2,2,0,2,96,0,2,0.173913043,0,0,99939.82609,6.27173913,0.02173913,99998.92391,0.999412034,6.43017E-05,4.3011E-07,0,0.020833333,14,9
D:0| T0: 0.10| T1: 48.00| R0: 0.0| R1: 0.0| WTP: 0,0,0.096153846,48,0,0,0,0,0,-1933022618,817384966,4700.967959,1697974220,169797422,1,35075,1454,502,781,279,502,35075,279,781,109.7559524,2.880952381,4.5,74182.78571,570.8452381,7.494047619,99474.94048,0.741220086,0.005799161,7.75974E-05,0.357234315,0.022266572,24,19
D:0| T0: 0.10| T1: 48.00| R0: 0.0| R1: 0.0| WTP: 0,0,0.096153846,48,0,0,0,0,0,-2060199363,762053968,2270.112325,1946693747,194669374.7,1,18589,805,352,377,25,352,18589,25,377,54.70157068,1.680628272,1.806282723,86422.54974,305.2356021,3.638743455,99746.60209,0.865141197,0.003076137,3.84398E-05,0.066312997,0.020280811,27,22
D:0| T0: 0.10| T1: 48.00| R0: 0.0| R1: 0.0| WTP: 0,0,0.096153846,48,0,0,0,0,0,-2022117363,1692506311,114.2434419,2016405191,201640519.1,1,554,21,19,19,0,19,554,0,19,1.185185185,0.027777778,0.027777778,99635.78241,17.24537037,0.115740741,99988.91667,0.996212583,0.000186105,1.88135E-06,0,0.03442029,28,23
D:0| T0: 0.10| T1: 48.00| R0: 0.0| R1: 0.0| WTP: 0,0,0.096153846,48,0,0,0,0,0,-2529871727,883828863,8869.02478,2086420488,208642048.8,1,72399,3225,693,1473,780,693,72399,780,1473,127.8454259,2.129337539,4.545741325,68328.85174,597.7917981,6.738170347,99401.89905,0.481055828,0.00987943,0.000113073,0.529531568,0.020345866,28,23
D:0| T0: 0.10| T1: 48.00| R0: 0.0| R1: 0.0| WTP: 0,0,0.096153846,48,0,0,0,0,0,-879289142.1,301400999,48.16217016,876881033.6,87688103.36,1,430,19,8,8,0,8,430,0,8,2.203883495,0.009708738,0.009708738,99719.3301,17.98058252,0.077669903,99996.08738,0.997240136,0.000180391,1.53851E-06,0,0.01627907,15,10
D:0| T0: 0.10| T1: 48.00| R0: 0.0| R1: 0.0| WTP: 0,0,0.096153846,48,0,0,0,0,0,-4898136747,1868336855,12016.25605,4297323944,429732394.4,2,95400,4124,1003,1996,993,1003,95400,993,1996,95.01286765,1.65625,3.463235294,69178.9614,683.3400735,5.319852941,99386.85294,0.693147585,0.006889165,5.55446E-05,0.49749499,0.020922432,78,48
D:0| T0: 0.10| T1: 48.00| R0: 0.0| R1: 0.0| WTP: 0,0,0.096153846,48,0,0,0,0,0,-4929307434,1868498144,12717.62225,4293426321,429342632.1,2,94668,3999,1027,2113,1086,1027,94668,1086,2113,88.57039711,1.680505415,3.61732852,69025.55054,711.2129964,5.458483755,99341.58664,0.6917712,0.007174851,5.71379E-05,0.513961193,0.022320108,80,48
D:0| T0: 0.10| T1: 48.00| R0: 0.0| R1: 0.0| WTP: 0,0,0.096153846,48,0,0,0,0,0,-1316208864,2101566889,24.10086805,1315003820,131500382,1,197,10,4,4,0,4,197,0,4,1.092857143,0,0,99871.20714,8.478571429,0.028571429,99998.49286,0.998730896,8.63841E-05,5.67384E-07,0,0.020304569,20,15
D:0| T0: 0.10| T1: 48.00| R0: 0.0| R1: 0.0| WTP: 0,0,0.096153846,48,0,0,0,0,0,-2506479601,1665097450,8601.545333,2076402335,207640233.5,1,65856,2797,727,1429,702,727,65856,702,1429,150.0829694,3.091703057,6.091703057,59978.36681,986.6637555,9.279475983,99187.04803,0.531996643,0.011669175,0.000111386,0.491252624,0.021699188,28,23
D:0| T0: 0.10| T1: 48.00| R0: 0.0| R1: 0.0| WTP: 0,0,0.096153846,48,0,0,0,0,0,-3134140790,1716179948,7100.749478,2779103316,277910331.6,1,62522,2888,904,1179,275,904,62522,275,1179,143.4939271,3.530364372,4.591093117,55256.96761,870.6153846,8.255060729,99212.95951,0.556409872,0.008722186,8.44886E-05,0.233248516,0.018857362,36,31
D:0| T0: 0.10| T1: 48.00| R0: 0.0| R1: 0.0| WTP: 0,0,0.096153846,48,0,0,0,0,0,-968211161.5,1560278715,72.20920854,964600701.1,96460070.11,1,378,20,12,12,0,12,378,0,12,1.911111111,0.044444444,0.044444444,99801.24444,9.266666667,0.140740741,99995.45926,0.997746913,0.000108893,2.05139E-06,0,0.031830239,16,11
D:0| T0: 0.10| T1: 48.00| R0: 0.0| R1: 0.0| WTP: 0,0,0.096153846,48,0,0,0,0,0,-4952349251,991019385,13103.24665,4297186919,429718691.9,2,96217,4159,1192,2177,985,1192,96217,985,2177,99.26796117,2.106796117,3.994174757,68859.91456,1110.32233,6.316504854,99349.92039,0.690480798,0.011201795,6.59563E-05,0.45245751,0.022625939,74,48
D:0| T0: 0.10| T1: 48.00| R0: 0.0| R1: 0.0| WTP: 0,0,0.096153846,48,0,0,0,0,0,-4898653202,118052103,12111.251,4293090652,429309065.2,2,90076,3824,1624,2012,388,1624,90076,388,2012,84.69702277,2.670753065,3.325744308,66402.30123,798.3064799,6.189141856,99288.08932,0.654026271,0.00834374,6.65047E-05,0.192842942,0.022336941,79,48
D:0| T0: 0.10| T1: 48.00| R0: 0.0| R1: 0.0| WTP: 0,0,0.096153846,48,0,0,0,0,0,-3739276661,1209758844,5669.548903,3455799216,345579921.6,1,39802,1632,912,942,30,912,39802,30,942,62.55421687,2.59939759,2.68373494,74012.20181,350.5481928,5.40060241,99421.42771,0.722330104,0.003809646,6.06732E-05,0.031847134,0.023668342,44,39
D:0| T0: 0.10| T1: 48.00| R0: 0.0| R1: 0.0| WTP: 0,0,0.096153846,48,0,0,0,0,0,-1052947058,70671723,18.09266202,1052042425,105204242.5,1,127,9,3,3,0,3,127,0,3,1.204918033,0,0,99909.68033,6.418032787,0.024590164,99998.28689,0.999087878,6.70596E-05,5.04207E-07,0,0.023622047,17,12
D:0| T0: 0.10| T1: 48.00| R0: 0.0| R1: 0.0| WTP: 0,0,0.096153846,48,0,0,0,0,0,-1052433031,1722612191,12.01904941,1051832078,105183207.8,1,52,2,2,2,0,2,52,0,2,0.137096774,0,0,99968.91129,2.266129032,0.016129032,99999.69355,0.999688942,2.43903E-05,3.25205E-07,0,0.019230769,17,12
D:0| T0: 0.10| T1: 48.00| R0: 0.0| R1: 0.0| WTP: 0,0,0.096153846,48,0,0,0,0,0,-1315580982,1968291596,12.08340106,1314976812,131497681.2,1,74,4,2,2,0,2,74,0,2,0.939189189,0,0,99953.10135,2.054054054,0.013513514,99999.31757,0.999506154,2.30435E-05,2.89857E-07,0,0.027027027,20,15
D:0| T0: 0.10| T1: 48.00| R0: 0.0| R1: 0.0| WTP: 0,0,0.096153846,48,0,0,0,0,0,-2786191699,1877569084,7379.32745,2417225327,241722532.7,1,54489,2272,800,1226,426,800,54489,426,1226,124.8384279,3.384279476,5.19650655,62121.41048,760.4061135,8.681222707,99200.20961,0.608616732,0.007964239,9.26726E-05,0.347471452,0.022499954,32,27
D:0| T0: 0.10| T1: 48.00| R0: 0.0| R1: 0.0| WTP: 0,0,0.096153846,48,0,0,0,0,0,-3282427743,1726322189,8331.581836,2865848652,286584865.2,1,64430,2780,922,1384,462,922,64430,462,1384,132.0343511,3.423664122,5.129770992,53690.77099,834.2099237,8.65648855,99069.10687,0.530405135,0.008561652,9.03579E-05,0.333815029,0.021480677,37,32
D:0| T0: 0.10| T1: 48.00| R0: 0.0| R1: 0.0| WTP: 0,0,0.096153846,48,0,0,0,0,0,-4466399021,307848836,4521.035759,4240347233,424034723.3,1,36532,1516,748,751,3,748,36532,3,751,50.8739726,1.890410959,1.898630137,73418.70685,351.4767123,3.931506849,99480.70137,0.737887092,0.003519923,4.11088E-05,0.003994674,0.02055732,53,48
D:0| T0: 0.10| T1: 48.00| R0: 0.0| R1: 0.0| WTP: 0,0,0.096153846,48,0,0,0,0,0,-2428005378,1154000220,8622.134929,1996898631,199689863.1,1,70493,3203,573,1432,859,573,70493,859,1432,213.7567568,2.978378378,7.589189189,45278.82162,991.427027,10.7027027,98967.50811,0.457113026,0.009926297,0.000108592,0.599860335,0.020314074,27,22
D:0| T0: 0.10| T1: 48.00| R0: 0.0| R1: 0.0| WTP: 0,0,0.096153846,48,0,0,0,0,0,-1052833485,2028661055,18.05783785,1051930593,105193059.3,1,112,6,3,3,0,3,112,0,3,0.629310345,0.017241379,0.017241379,99925.72414,5.24137931,0.043103448,99998.93103,0.999270844,5.44448E-05,5.12824E-07,0,0.026785714,17,12
D:0| T0: 0.10| T1: 48.00| R0: 0.0| R1: 0.0| WTP: 0,0,0.096153846,48,0,0,0,0,0,-3961520601,1629114640,306.8810017,3946176551,394617655.1,1,2111,109,51,51,0,51,2111,0,51,3.220289855,0.052173913,0.052173913,98518.90435,37.92173913,0.205797101,99965.54203,0.985541248,0.000380588,2.9487E-06,0,0.024159166,50,45
D:0| T0: 0.10| T1: 48.00| R0: 0.0| R1: 0.0| WTP: 0,0,0.096153846,48,0,0,0,0,0,-3698190873,1439048174,7958.027189,3300289513,330028951.3,1,58598,2586,952,1322,370,952,58598,370,1322,110.6643836,3.157534247,4.386986301,56460.59247,852.8356164,7.657534247,99064.69178,0.564867544,0.00864515,7.89396E-05,0.279878971,0.022560497,42,37
D:0| T0: 0.10| T1: 48.00| R0: 0.0| R1: 0.0| WTP: 0,0,0.096153846,48,0,0,0,0,0,-2429458360,865227006,10387.96343,1910060189,191006018.9,1,77049,3206,516,1726,1210,516,77049,1210,1726,192.7427184,2.432038835,8.266990291,47539.26699,1004.548544,10.77669903,98903.93689,0.397248879,0.011652111,0.000126356,0.701042874,0.022401329,26,21
D:0| T0: 0.10| T1: 48.00| R0: 0.0| R1: 0.0| WTP: 0,0,0.096153846,48,0,0,0,0,0,-4877900447,890479738,11649.67007,4295416944,429541694.4,2,88778,3948,1847,1935,88,1847,88778,88,1935,77.33489097,2.691588785,2.825545171,51754.15732,989.0545171,5.699376947,99010.78037,0.520855684,0.009970267,5.93872E-05,0.045478036,0.021796186,92,48
D:0| T0: 0.10| T1: 48.00| R0: 0.0| R1: 0.0| WTP: 0,0,0.096153846,48,0,0,0,0,0,-527585116.1,1017049163,30.08270044,526080981,52608098.1,1,206,7,5,5,0,5,206,0,5,1.415584416,0,0,99874.22078,8.922077922,0.077922078,99997.54545,0.998771236,9.08995E-05,1.28208E-06,0,0.024271845,11,6
D:0| T0: 0.10| T1: 48.00| R0: 0.0| R1: 0.0| WTP: 0,0,0.096153846,48,0,0,0,0,0,-525937956.2,1707305064,0.011604396,525937375.9,52593737.59,1,42,2,0,0,0,0,42,0,0,0.258823529,0,0,99976.75294,2.105882353,0,100000,0.999740263,2.59211E-05,0,0,0,11,6
D:0| T0: 0.10| T1: 48.00| R0: 0.0| R1: 0.0| WTP: 0,0,0.096153846,48,0,0,0,0,0,-2139519155,400145663,9835.667205,1647735795,164773579.5,1,73632,3191,470,1634,1164,470,73632,1164,1634,251.75,2.86875,10.1,43556.6625,1234.725,13.04375,98834.25,0.440080531,0.01236459,0.000131774,0.712362301,0.022191439,23,18
D:0| T0: 0.10| T1: 48.00| R0: 0.0| R1: 0.0| WTP: 0,0,0.096153846,48,0,0,0,0,0,-525941393.5,1662654181,0.012131868,525940786.9,52594078.69,1,82,5,0,0,0,0,82,0,0,0.319444444,0,0,99949.04167,4.236111111,0,100000,0.999493151,4.41096E-05,0,0,0,11,6
D:0| T0: 0.10| T1: 48.00| R0: 0.0| R1: 0.0| WTP: 0,0,0.096153846,48,0,0,0,0,0,-2913521010,182136456,4924.857848,2667278117,266727811.7,1,40686,1786,622,818,196,622,40686,196,818,85.93975904,2.381526104,3.140562249,68996.13655,567.313253,5.614457831,99406.85944,0.687811385,0.005790945,5.90202E-05,0.239608802,0.02010569,35,30
D:0| T0: 0.10| T1: 48.00| R0: 0.0| R1: 0.0| WTP: 0,0,0.096153846,48,0,0,0,0,0,-526250066.5,979575387,6.020337891,525949049.6,52594904.96,1,39,2,1,1,0,1,39,0,1,0.397260274,0,0,99973.34247,3.178082192,0.01369863,99999.63014,0.999739188,3.32433E-05,2.7027E-07,0,0.025641026,11,6
D:0| T0: 0.10| T1: 48.00| R0: 0.0| R1: 0.0| WTP: 0,0,0.096153846,48,0,0,0,0,0,-4573770200,2142525414,6458.270093,4250856696,425085669.6,2,48039,2034,1033,1073,40,1033,48039,40,1073,60.655,2.4,2.5025,69874.7375,469.0625,5.075,99356.59,0.692618773,0.004863436,5.45688E-05,0.037313433,0.022315202,56,48
D:0| T0: 0.10| T1: 48.00| R0: 0.0| R1: 0.0| WTP: 0,0,0.096153846,48,0,0,0,0,0,-4866184182,1464057597,11444.85574,4293941395,429394139.5,2,88030,3865,1476,1901,425,1476,88030,425,1901,87.92857143,2.432142857,3.167857143,66196.575,590.725,5.823214286,99318.75893,0.663580992,0.005964501,6.08529E-05,0.223566544,0.021595156,80,48
D:0| T0: 0.10| T1: 48.00| R0: 0.0| R1: 0.0| WTP: 0,0,0.096153846,48,0,0,0,0,0,-4037261739,364562610,6200.763066,3727223586,372722358.6,1,47107,2076,927,1030,103,927,47107,103,1030,77.54054054,2.636636637,2.930930931,66038.46246,475.987988,5.708708709,99294.42342,0.659587666,0.004843514,5.97884E-05,0.1,0.02186558,47,42
D:0| T0: 0.10| T1: 48.00| R0: 0.0| R1: 0.0| WTP: 0,0,0.096153846,48,0,0,0,0,0,-4850483442,40350784,11221.26985,4289419949,428941994.9,2,86445,3723,1694,1864,170,1694,86445,170,1864,72.56200942,2.477237049,2.733124019,53608.13344,523.2731554,5.411302983,99038.12088,0.539901229,0.005275275,5.62804E-05,0.091201717,0.021562843,91,48
D:0| T0: 0.10| T1: 48.00| R0: 0.0| R1: 0.0| WTP: 0,0,0.096153846,48,0,0,0,0,0,-2505830727,804064356,873.3914557,2462161154,246216115.4,1,8065,346,145,145,0,145,8065,0,145,19.31512605,0.470588235,0.470588235,94387.64286,97.62184874,1.067226891,99905.22269,0.941649961,0.001031097,1.28409E-05,0,0.017978921,33,28
D:0| T0: 0.10| T1: 48.00| R0: 0.0| R1: 0.0| WTP: 0,0,0.096153846,48,0,0,0,0,0,-1591445843,2125493986,246.6775898,1579111963,157911196.3,1,1624,65,41,41,0,41,1624,0,41,4.919753086,0.148148148,0.148148148,98779.08642,31.29012346,0.388888889,99971.61111,0.988023329,0.000315492,5.06271E-06,0,0.025246305,23,18
D:0| T0: 0.10| T1: 48.00| R0: 0.0| R1: 0.0| WTP: 0,0,0.096153846,48,0,0,0,0,0,-4796645263,23154253,10021.91593,4295549467,429554946.7,2,87778,4051,1026,1664,638,1026,87778,638,1664,93.24680073,1.70749543,2.850091408,70805.22669,427.8756856,4.720292505,99481.03108,0.705096615,0.004379228,5.02978E-05,0.383413462,0.01895713,77,48
D:0| T0: 0.10| T1: 48.00| R0: 0.0| R1: 0.0| WTP: 0,0,0.096153846,48,0,0,0,0,0,-1142623034,1391367689,54.19463992,1139913302,113991330.2,1,338,17,9,9,0,9,338,0,9,2.113636364,0.007575758,0.007575758,99793.95455,9.575757576,0.068181818,99995.55303,0.99782669,0.000104557,1.46347E-06,0,0.026627219,18,13
D:0| T0: 0.10| T1: 48.00| R0: 0.0| R1: 0.0| WTP: 0,0,0.096153846,48,0,0,0,0,0,-2373249439,574142276,120.3212743,2367233375,236723337.5,1,904,35,20,20,0,20,904,0,20,1.743362832,0.026548673,0.026548673,99415.21239,18.70353982,0.119469027,99988.92478,0.994167234,0.00019208,1.79389E-06,0,0.022197558,32,27
D:0| T0: 0.10| T1: 48.00| R0: 0.0| R1: 0.0| WTP: 0,0,0.096153846,48,0,0,0,0,0,-789165407.6,898736779,6.008733495,788864970.9,78886497.09,1,24,2,1,1,0,1,24,0,1,0.061946903,0,0,99986.50442,1.566371681,0.017699115,99999.30088,0.999855611,1.85716E-05,2.04082E-07,0,0.041666667,14,9
D:0| T0: 0.10| T1: 48.00| R0: 0.0| R1: 0.0| WTP: 0,0,0.096153846,48,0,0,0,0,0,-4804872908,346473503,9959.398559,4306902980,430690298,2,97256,4658,700,1653,953,700,97256,953,1653,94.69480519,1.00974026,2.534090909,76685.87013,900.4383117,3.691558442,99639.53896,0.736164752,0.010256594,4.3521E-05,0.576527526,0.016996381,78,48
D:0| T0: 0.10| T1: 48.00| R0: 0.0| R1: 0.0| WTP: 0,0,0.096153846,48,0,0,0,0,0,-3522565671,445552282,294.8487435,3507823234,350782323.4,1,1897,71,49,49,0,49,1897,0,49,2.808,0.058666667,0.058666667,98828.98933,29.76266667,0.184,99970.36267,0.986723145,0.000346249,3.03477E-06,0,0.025830258,45,40
D:0| T0: 0.10| T1: 48.00| R0: 0.0| R1: 0.0| WTP: 0,0,0.096153846,48,0,0,0,0,0,-2011827938,911758476,8977.866356,1562934620,156293462,1,73322,3308,588,1491,903,588,73322,903,1491,232.6961326,3.132596685,8.071823204,54995.9779,1135.596685,11.35359116,99165.98895,0.475027389,0.013352622,0.000135158,0.605633803,0.020334961,22,17
D:0| T0: 0.10| T1: 48.00| R0: 0.0| R1: 0.0| WTP: 0,0,0.096153846,48,0,0,0,0,0,-3763347592,1464197940,7436.756996,3391509742,339150974.2,1,60745,2707,1049,1235,186,1049,60745,186,1235,117.1423729,3.406779661,4.013559322,57814.15593,1202.549153,7.566101695,99188.85424,0.582136824,0.012061021,7.76397E-05,0.150729335,0.020314429,43,38
D:0| T0: 0.10| T1: 48.00| R0: 0.0| R1: 0.0| WTP: 0,0,0.096153846,48,0,0,0,0,0,-1846187106,500405854,96.31167549,1841371522,184137152.2,1,815,38,16,16,0,16,815,0,16,2.195876289,0.015463918,0.015463918,99429.20619,17.81443299,0.103092784,99990.11856,0.994033317,0.000190615,1.74876E-06,0,0.019631902,26,21
D:0| T0: 0.10| T1: 48.00| R0: 0.0| R1: 0.0| WTP: 0,0,0.096153846,48,0,0,0,0,0,-2715436198,772037341,1516.694091,2639601493,263960149.3,1,10466,464,251,252,1,251,10466,1,252,23.22222222,0.872427984,0.87654321,91911.48971,139.7942387,1.9218107,99816.16461,0.920893209,0.001396184,2.06399E-05,0.003968254,0.024082569,35,30
D:0| T0: 0.10| T1: 48.00| R0: 0.0| R1: 0.0| WTP: 0,0,0.096153846,48,0,0,0,0,0,-614302229.6,1543158763,12.0575549,613699351.8,61369935.18,1,88,7,2,2,0,2,88,0,2,0.957446809,0,0,99948.54255,4.223404255,0.021276596,99999.11702,0.999429028,4.89161E-05,4.8193E-07,0,0.022988506,12,7
D:0| T0: 0.10| T1: 48.00| R0: 0.0| R1: 0.0| WTP: 0,0,0.096153846,48,0,0,0,0,0,-2760809633,1604932531,6975.221668,2412048550,241204855,1,49590,2060,647,1159,512,647,49590,512,1159,108.7584746,2.63559322,4.775423729,63899.97034,616.2457627,7.504237288,99204.4322,0.617890544,0.006618689,8.22141E-05,0.441760138,0.023371648,32,27
D:0| T0: 0.10| T1: 48.00| R0: 0.0| R1: 0.0| WTP: 0,0,0.096153846,48,0,0,0,0,0,-4903657062,539051477,12101.05674,4298604225,429860422.5,2,92152,4139,1736,2010,274,1736,92152,274,2010,82.063593,2.588235294,3.007949126,56136.86645,836.9570747,5.777424483,99088.05405,0.541952108,0.008879066,6.31479E-05,0.136318408,0.021811789,86,48
D:0| T0: 0.10| T1: 48.00| R0: 0.0| R1: 0.0| WTP: 0,0,0.096153846,48,0,0,0,0,0,-351017927.4,1743124675,6.041964265,350715829.2,35071582.92,1,67,6,1,1,0,1,67,0,1,1.044776119,0,0,99964.02985,3.119402985,0.014925373,99999.62687,0.999618251,3.49208E-05,3.1746E-07,0,0.015151515,9,4
D:0| T0: 0.10| T1: 48.00| R0: 0.0| R1: 0.0| WTP: 0,0,0.096153846,48,0,0,0,0,0,-4212580775,1965983789,96.25998868,4207767776,420776777.6,2,731,25,16,16,0,16,731,0,16,0.866840731,0.005221932,0.005221932,99560.22193,10.67101828,0.049608355,99991.65013,0.995620883,0.000110405,8.46624E-07,0,0.021887825,54,48
D:0| T0: 0.10| T1: 48.00| R0: 0.0| R1: 0.0| WTP: 0,0,0.096153846,48,0,0,0,0,0,-1317483978,516774280,48.14581302,1315076687,131507668.7,1,422,13,8,8,0,8,422,0,8,1.315068493,0.01369863,0.01369863,99708.17123,17.60273973,0.054794521,99995.21918,0.997096431,0.000179454,1.10349E-06,0,0.018957346,20,15
D:0| T0: 0.10| T1: 48.00| R0: 0.0| R1: 0.0| WTP: 0,0,0.096153846,48,0,0,0,0,0,-2178897392,86603142,10427.39956,1657527414,165752741.4,1,82662,3563,504,1732,1228,504,82662,1228,1732,273.1005917,2.917159763,10.14792899,41358.82249,1269.260355,13.13017751,98857.53254,0.376476684,0.013599575,0.000141862,0.709006928,0.020952796,23,18
D:0| T0: 0.10| T1: 48.00| R0: 0.0| R1: 0.0| WTP: 0,0,0.096153846,48,0,0,0,0,0,-1052438462,1431870609,12.02063183,1051837430,105183743,1,103,3,2,2,0,2,103,0,2,0.175438596,0,0,99929.74561,5.99122807,0.01754386,99998.69298,0.999313467,6.16529E-05,3.47828E-07,0,0.019417476,17,12
D:0| T0: 0.10| T1: 48.00| R0: 0.0| R1: 0.0| WTP: 0,0,0.096153846,48,0,0,0,0,0,-4850251789,1592383984,11090.80973,4295711302,429571130.2,2,90685,4135,775,1842,1067,775,90685,1067,1842,96.43962264,1.303773585,3.29245283,79546.03208,498.6433962,4.760377358,99610.13774,0.794876883,0.005052468,5.00081E-05,0.579261672,0.020312069,76,48
D:0| T0: 0.10| T1: 48.00| R0: 0.0| R1: 0.0| WTP: 0,0,0.096153846,48,0,0,0,0,0,-1845386120,1440183867,84.24197223,1841174021,184117402.1,1,562,23,14,14,0,14,562,0,14,1.653846154,0.032967033,0.032967033,99580.32967,14.44505495,0.104395604,99990.38462,0.995907812,0.00014591,1.53015E-06,0,0.024911032,26,21
D:0| T0: 0.10| T1: 48.00| R0: 0.0| R1: 0.0| WTP: 0,0,0.096153846,48,0,0,0,0,0,-1228510203,1696510588,24.08557134,1227305925,122730592.5,1,185,7,4,4,0,4,185,0,4,0.939393939,0,0,99886.80303,6.424242424,0.03030303,99998.94697,0.998873696,6.65158E-05,6.0607E-07,0,0.016304348,19,14
D:0| T0: 0.10| T1: 48.00| R0: 0.0| R1: 0.0| WTP: 0,0,0.096153846,48,0,0,0,0,0,-4950316154,895039877,13055.37594,4297547357,429754735.7,2,95906,4095,1260,2169,909,1260,95906,909,2169,89.96666667,2.042105263,3.614035088,64027.00702,882.3017544,5.824561404,99239.15965,0.633675972,0.009125904,6.2186E-05,0.419087137,0.022615895,80,48
D:0| T0: 0.10| T1: 48.00| R0: 0.0| R1: 0.0| WTP: 0,0,0.096153846,48,0,0,0,0,0,-3075530149,129565953,132.4911479,3068905591,306890559.1,1,1064,47,22,22,0,22,1064,0,22,2.336805556,0.041666667,0.041666667,99188.68056,26.70138889,0.114583333,99983.85764,0.99200247,0.000270307,1.53326E-06,0,0.020735156,40,35
D:0| T0: 0.10| T1: 48.00| R0: 0.0| R1: 0.0| WTP: 0,0,0.096153846,48,0,0,0,0,0,-614205817.2,1902565669,12.02590655,613604521.8,61360452.18,1,159,7,2,2,0,2,159,0,2,0.337078652,0,0,99909.01124,6.584269663,0.02247191,99999.30337,0.999048342,7.11768E-05,4.70591E-07,0,0.012578616,12,7
D:0| T0: 0.10| T1: 48.00| R0: 0.0| R1: 0.0| WTP: 0,0,0.096153846,48,0,0,0,0,0,-1491498301,1984179288,24.09664827,1490293468,149029346.8,1,236,13,4,4,0,4,236,0,4,0.852941176,0,0,99849.64118,10.67058824,0.023529412,99997.91176,0.998310015,0.000121613,5.36921E-07,0,0.016949153,22,17
D:0| T0: 0.10| T1: 48.00| R0: 0.0| R1: 0.0| WTP: 0,0,0.096153846,48,0,0,0,0,0,-4882496875,677377223,11798.81055,4292556347,429255634.7,2,89155,3855,1721,1960,239,1721,89155,239,1960,77.2979066,2.576489533,2.948470209,59766.93559,1162.37037,5.724637681,99173.13688,0.60021083,0.011717619,5.97476E-05,0.121938776,0.021984185,88,48
D:0| T0: 0.10| T1: 48.00| R0: 0.0| R1: 0.0| WTP: 0,0,0.096153846,48,0,0,0,0,0,-4888039502,973583301,11782.63837,4298907584,429890758.4,2,93710,4083,1104,1957,853,1104,93710,853,1957,86.2442623,1.663934426,3.045901639,65030.14262,1248.414754,4.849180328,99318.31475,0.650163424,0.012624752,5.07333E-05,0.435871231,0.020883577,87,48
D:0| T0: 0.10| T1: 48.00| R0: 0.0| R1: 0.0| WTP: 0,0,0.096153846,48,0,0,0,0,0,-1934003567,781062938,96.36862604,1929185135,192918513.5,1,768,40,16,16,0,16,768,0,16,2.836956522,0.032608696,0.032608696,99436.40761,20.13043478,0.114130435,99989.17391,0.994483096,0.000202611,1.72986E-06,0,0.020833333,27,22
D:0| T0: 0.10| T1: 48.00| R0: 0.0| R1: 0.0| WTP: 0,0,0.096153846,48,0,0,0,0,0,-4895250862,338783425,11891.23271,4300689227,430068922.7,2,95177,4252,853,1975,1122,853,95177,1122,1975,80.01040119,1.205052006,2.852897474,69366.46657,1151.356612,4.121842496,99413.60624,0.690202524,0.011744316,4.28831E-05,0.568101266,0.020750812,95,48
D:1| T0: 0.10| T1: 515.00| I0: 300.00| I1: 75.00| WTP: 0,1,0.096153846,515,0,0,0,300,75,-7187531870,1178568022,7710.17508,6802023116,680202311.6,34,57838,2469,1281,1281,0,1281,57838,0,1281,13.76551095,0.390510949,0.390510949,66190.79699,135.4361314,0.977645985,99261.88276,0.666082496,0.001365036,1.17579E-05,0,0.022148069,313,77
D:1| T0: 0.10| T1: 515.00| I0: 300.00| I1: 75.00| WTP: 0,1,0.096153846,515,0,0,0,300,75,-7566168835,2029998696,9549.792088,7088679230,708867923,22,79673,3440,1578,1586,8,1578,79673,8,1586,31.29369628,0.934813754,0.940544413,43057.1755,193.3316619,2.074498567,98867.63754,0.43063512,0.001964072,2.29941E-05,0.005044136,0.019906367,198,80
D:1| T0: 0.10| T1: 515.00| I0: 300.00| I1: 75.00| WTP: 0,1,0.096153846,515,0,0,0,300,75,-5093783196,776062361,11002.14645,4543675874,454367587.4,10,77286,3268,1568,1828,260,1568,77286,260,1828,32.84792994,1.098726115,1.299363057,36636.14172,380.0859873,2.555732484,98522.98806,0.358115141,0.003912103,2.7822E-05,0.142231947,0.023653326,175,51
D:1| T0: 0.10| T1: 515.00| I0: 300.00| I1: 75.00| WTP: 0,1,0.096153846,515,0,0,0,300,75,-9837307543,1813046880,8065.273818,9434043852,943404385.2,38,57370,2530,1340,1340,0,1340,57370,0,1340,11.51577802,0.305404425,0.305404425,65606.07218,132.3133841,0.79724338,99206.03772,0.660571506,0.001334064,9.78276E-06,0,0.023357155,394,107
D:1| T0: 0.10| T1: 515.00| I0: 300.00| I1: 75.00| WTP: 0,1,0.096153846,515,0,0,0,300,75,-6059354370,2032407216,7725.682827,5673070229,567307022.9,30,64803,2949,1283,1283,0,1283,64803,0,1283,23.27028754,0.608945687,0.608945687,61839.30288,144.3936102,1.426837061,99261.82173,0.619035497,0.001466698,1.66295E-05,0,0.019799383,222,64
D:1| T0: 0.10| T1: 515.00| I0: 300.00| I1: 75.00| WTP: 0,1,0.096153846,515,0,0,0,300,75,-7393584697,1507873352,6811.358872,7053016754,705301675.4,34,47208,1960,1132,1132,0,1132,47208,0,1132,6.938781575,0.188707281,0.188707281,70876.68499,101.5316493,0.519465082,99310.82259,0.711591983,0.001028712,6.80074E-06,0,0.023978987,478,80
D:1| T0: 0.10| T1: 515.00| I0: 300.00| I1: 75.00| WTP: 0,1,0.096153846,515,0,0,0,300,75,-4211735683,1855899401,6117.558742,3905857746,390585774.6,20,50855,2264,1016,1016,0,1016,50855,0,1016,16.37745665,0.40982659,0.40982659,67008.89942,109.7566474,0.994797688,99351.16301,0.673785424,0.001105656,1.18056E-05,0,0.01997837,247,44
D:1| T0: 0.10| T1: 515.00| I0: 300.00| I1: 75.00| WTP: 0,1,0.096153846,515,0,0,0,300,75,-8569007726,1819459251,8842.627411,8126876356,812687635.6,28,68604,2907,1469,1469,0,1469,68604,0,1469,19.56876712,0.620821918,0.620821918,52455.69151,134.4958904,1.434520548,99015.37863,0.528908095,0.001356209,1.62088E-05,0,0.021412746,261,92
D:1| T0: 0.10| T1: 515.00| I0: 300.00| I1: 75.00| WTP: 0,1,0.096153846,515,0,0,0,300,75,-3564594188,909791748,7127.688074,3208209784,320820978.4,22,54469,2406,1184,1184,0,1184,54469,0,1184,20.04663558,0.584943371,0.584943371,68157.39507,117.2884744,1.372418388,99321.62358,0.685651428,0.001181533,1.58594E-05,0,0.021737135,215,36
D:1| T0: 0.10| T1: 515.00| I0: 300.00| I1: 75.00| WTP: 0,1,0.096153846,515,0,0,0,300,75,-6899771240,1339092841,8788.254859,6460358497,646035849.7,20,64974,2741,1460,1460,0,1460,64974,0,1460,22.21269841,0.736507937,0.736507937,56183.02667,148.3180952,1.661587302,99016.51556,0.56666702,0.001495734,1.86641E-05,0,0.022470527,225,73
D:1| T0: 0.10| T1: 515.00| I0: 300.00| I1: 75.00| WTP: 0,1,0.096153846,515,0,0,0,300,75,-7526296412,1365866345,10421.9608,7005198372,700519837.2,24,82411,3644,1717,1731,14,1717,82411,14,1731,36.55652866,1.135350318,1.146496815,48522.82245,204.9171975,2.534235669,98912.30096,0.468233789,0.002153666,2.88167E-05,0.008087811,0.021004478,173,79
D:1| T0: 0.10| T1: 515.00| I0: 300.00| I1: 75.00| WTP: 0,1,0.096153846,515,0,0,0,300,75,-12146601276,825453433,8335.091443,11729846704,1172984670,30,71310,3264,1384,1384,0,1384,71310,0,1384,18.09464131,0.416594641,0.416594641,53464.44252,156.8344857,1.015989628,99101.8764,0.538650168,0.001581085,1.20401E-05,0,0.019408218,331,133
D:1| T0: 0.10| T1: 515.00| I0: 300.00| I1: 75.00| WTP: 0,1,0.096153846,515,0,0,0,300,75,-7938313358,939711378,9911.221108,7442752303,744275230.3,26,82039,3662,1592,1646,54,1592,82039,54,1646,33.59588538,0.958853784,1,41179.66569,236.7876561,2.180749449,98821.35121,0.416009313,0.002388342,2.39728E-05,0.032806804,0.020063873,195,84
D:1| T0: 0.10| T1: 515.00| I0: 300.00| I1: 75.00| WTP: 0,1,0.096153846,515,0,0,0,300,75,-14159133469,638950699,8392.970767,13739484931,1373948493,38,68675,3127,1394,1394,0,1394,68675,0,1394,14.42133132,0.329046899,0.329046899,57519.69327,165.5767776,0.866490166,99165.63956,0.579221226,0.001668927,1.06147E-05,0,0.020298507,378,156
D:1| T0: 0.10| T1: 515.00| I0: 300.00| I1: 75.00| WTP: 0,1,0.096153846,515,0,0,0,300,75,-6075255703,938699148,8079.465005,5671282453,567128245.3,28,64957,2861,1342,1342,0,1342,64957,0,1342,21.7749535,0.640421575,0.640421575,61956.47737,135.8927464,1.466212027,99221.47861,0.618094428,0.001389425,1.69838E-05,0,0.020659821,228,64
D:1| T0: 0.10| T1: 515.00| I0: 300.00| I1: 75.00| WTP: 0,1,0.096153846,515,0,0,0,300,75,-9944479997,121790188,6690.165402,9609971727,960997172.7,38,55277,2565,1111,1111,0,1111,55277,0,1111,11.46353436,0.219845722,0.219845722,67852.09818,139.5992286,0.608695652,99365.9453,0.682246528,0.001405628,7.83179E-06,0,0.020098775,407,109
D:1| T0: 0.10| T1: 515.00| I0: 300.00| I1: 75.00| WTP: 0,1,0.096153846,515,0,0,0,300,75,-6719276044,1331335240,10114.73205,6213539442,621353944.2,14,78448,3483,1569,1680,111,1569,78448,111,1680,23.45512144,0.681626188,0.738648363,34414.31362,274.1694826,1.565469905,98612.64203,0.343878177,0.0027844,1.74109E-05,0.066071429,0.021415733,269,70
D:1| T0: 0.10| T1: 515.00| I0: 300.00| I1: 75.00| WTP: 0,1,0.096153846,515,0,0,0,300,75,-1692567502,470935411,11267.42086,1129196459,112919645.9,2,81933,3478,809,1872,1063,809,81933,1063,1872,93.52219873,1.553911205,3.77167019,32056.34672,448.94926,5.477801268,98496.28118,0.293070121,0.004731398,5.97695E-05,0.56784188,0.022848773,65,12
D:1| T0: 0.10| T1: 515.00| I0: 300.00| I1: 75.00| WTP: 0,1,0.096153846,515,0,0,0,300,75,-11564950072,823434397,9208.080232,11104546061,1110454606,38,65803,2760,1530,1530,0,1530,65803,0,1530,14.40436242,0.449244966,0.449244966,58464.10109,141.5927013,1.097734899,99041.82466,0.589301498,0.001428625,1.29291E-05,0,0.023251573,341,126
D:1| T0: 0.10| T1: 515.00| I0: 300.00| I1: 75.00| WTP: 0,1,0.096153846,515,0,0,0,300,75,-3451063293,493045351,6587.576362,3121684475,312168447.5,20,55760,2498,1094,1094,0,1094,55760,0,1094,22.88954781,0.624907339,0.624907339,65131.17643,104.6041512,1.414381023,99337.7828,0.65453251,0.001054926,1.63206E-05,0,0.019620151,193,35
D:1| T0: 0.10| T1: 515.00| I0: 300.00| I1: 75.00| WTP: 0,1,0.096153846,515,0,0,0,300,75,-11129812707,1700216563,7419.968694,10758814272,1075881427,28,65290,3050,1232,1232,0,1232,65290,0,1232,17.98011364,0.388731061,0.388731061,61375.29025,166.795928,0.964962121,99269.36837,0.617560169,0.001680094,1.17334E-05,0,0.018870236,302,122
D:1| T0: 0.10| T1: 515.00| I0: 300.00| I1: 75.00| WTP: 0,1,0.096153846,515,0,0,0,300,75,-4564344505,1744119059,7611.917347,4183748637,418374863.7,20,63881,2903,1264,1264,0,1264,63881,0,1264,32.88898836,0.922112802,0.922112802,61683.45389,157.9534467,2.064458371,99252.61325,0.620782522,0.001590699,2.27554E-05,0,0.01978803,160,47
D:1| T0: 0.10| T1: 515.00| I0: 300.00| I1: 75.00| WTP: 0,1,0.096153846,515,0,0,0,300,75,-12100963649,2036906360,7800.297726,11710948763,1171094876,38,58850,2549,1296,1296,0,1296,58850,0,1296,9.055145975,0.219699204,0.219699204,62644.76939,120.7829549,0.604246535,99179.75081,0.628895864,0.001224369,7.7324E-06,0,0.022022464,481,133
D:1| T0: 0.10| T1: 515.00| I0: 300.00| I1: 75.00| WTP: 0,1,0.096153846,515,0,0,0,300,75,-11791101482,809704121,8368.956965,11372653634,1137265363,32,68239,3066,1390,1390,0,1390,68239,0,1390,17.97478592,0.456707897,0.456707897,61723.4824,167.9738344,1.118934348,99219.37298,0.620855578,0.001694993,1.33244E-05,0,0.020369583,299,129
D:1| T0: 0.10| T1: 515.00| I0: 300.00| I1: 75.00| WTP: 0,1,0.096153846,515,0,0,0,300,75,-16961120104,1219866412,9897.579944,16466241107,1646624111,34,79368,3535,1644,1644,0,1644,79368,0,1644,13.43406764,0.361774744,0.361774744,40603.75799,202.8926466,0.874650946,98773.41266,0.410272612,0.002047774,1.02831E-05,0,0.020713638,461,187
D:1| T0: 0.10| T1: 515.00| I0: 300.00| I1: 75.00| WTP: 0,1,0.096153846,515,0,0,0,300,75,-5635337000,843498920,6579.32704,5306370648,530637064.8,32,52626,2211,1093,1093,0,1093,52626,0,1093,14.37898089,0.385350318,0.385350318,70251.50849,134.4336518,0.975583864,99382.19904,0.706339379,0.001353616,1.16605E-05,0,0.020769202,270,60
D:1| T0: 0.10| T1: 515.00| I0: 300.00| I1: 75.00| WTP: 0,1,0.096153846,515,0,0,0,300,75,-15215140351,107351963,10325.24602,14698878050,1469887805,52,69757,2783,1716,1716,0,1716,69757,0,1716,10.99777354,0.356234097,0.356234097,57691.26908,154.6984733,0.902035623,98971.99205,0.581674556,0.00156275,1.10106E-05,0,0.024599682,449,167
D:1| T0: 0.10| T1: 515.00| I0: 300.00| I1: 75.00| WTP: 0,1,0.096153846,515,0,0,0,300,75,-14885769122,773789021,8968.429936,14437347625,1443734762,44,70109,2957,1490,1490,0,1490,70109,0,1490,12.90824037,0.341489745,0.341489745,59641.70061,171.1032746,0.876574307,99159.88953,0.60023801,0.001726791,1.08077E-05,0,0.021252621,397,164
D:1| T0: 0.10| T1: 515.00| I0: 300.00| I1: 75.00| WTP: 0,1,0.096153846,515,0,0,0,300,75,-11472535348,850936611,9070.635334,11019003582,1101900358,38,67494,2854,1507,1507,0,1507,67494,0,1507,15.44266551,0.455214193,0.455214193,58736.43531,154.7022934,1.10990913,99084.86413,0.589419526,0.001570138,1.32154E-05,0,0.022327911,329,125
D:1| T0: 0.10| T1: 515.00| I0: 300.00| I1: 75.00| WTP: 0,1,0.096153846,515,0,0,0,300,75,-9539438664,1701318364,8903.678208,9094254754,909425475.4,38,68083,3021,1479,1479,0,1479,68083,0,1479,19.34782609,0.551918159,0.551918159,57858.91867,147.2209719,1.308439898,99086.49974,0.580464492,0.001494193,1.53294E-05,0,0.021723804,278,103
D:1| T0: 0.10| T1: 515.00| I0: 300.00| I1: 75.00| WTP: 0,1,0.096153846,515,0,0,0,300,75,-10833181702,778708269,7072.231929,10479570105,1047957011,36,53585,2358,1175,1175,0,1175,53585,0,1175,9.096950241,0.207704655,0.207704655,68869.58427,132.5393258,0.580738363,99334.15987,0.692395999,0.001336363,7.59361E-06,0,0.021927778,445,119
D:1| T0: 0.10| T1: 515.00| I0: 300.00| I1: 75.00| WTP: 0,1,0.096153846,515,0,0,0,300,75,-5179785855,1391938506,7919.759406,4783797884,478379788.4,30,56076,2312,1316,1316,0,1316,56076,0,1316,19.11148422,0.674949631,0.674949631,65164.22498,133.7347213,1.550705171,99200.09134,0.656205117,0.001347714,1.77813E-05,0,0.023468569,213,54
D:1| T0: 0.10| T1: 515.00| I0: 300.00| I1: 75.00| WTP: 0,1,0.096153846,515,0,0,0,300,75,-5511922736,43418681,5976.888845,5213078294,521307829.4,26,46395,1978,993,993,0,993,46395,0,993,11.42052506,0.286396181,0.286396181,72476.36325,125.0119332,0.761813842,99424.75131,0.728516884,0.001258068,9.52244E-06,0,0.02140363,300,59
D:1| T0: 0.10| T1: 515.00| I0: 300.00| I1: 75.00| WTP: 0,1,0.096153846,515,0,0,0,300,75,-4570226076,817384966,11026.52899,4018899626,401889962.6,22,80017,3329,1553,1832,279,1553,80017,279,1832,45.30021598,1.478401728,1.772138229,42619.56371,234.9902808,3.438444924,98718.84449,0.429185185,0.002378468,3.69903E-05,0.152292576,0.022895707,132,45
D:1| T0: 0.10| T1: 515.00| I0: 300.00| I1: 75.00| WTP: 0,1,0.096153846,515,0,0,0,300,75,-6531557860,762053968,9850.763905,6039019664,603901966.4,26,80536,3576,1611,1636,25,1611,80536,25,1636,37.17729909,1.111019056,1.130903065,47738.92792,208.4051367,2.463960232,98953.61143,0.480646281,0.002105286,2.7147E-05,0.015281174,0.020313897,173,68
D:1| T0: 0.10| T1: 515.00| I0: 300.00| I1: 75.00| WTP: 0,1,0.096153846,515,0,0,0,300,75,-13078623052,1692506311,7857.830975,12685731503,1268573150,44,67388,3084,1305,1305,0,1305,67388,0,1305,13.39458484,0.288447653,0.288447653,61204.49242,161.6823105,0.759205776,99260.35343,0.61370982,0.00163815,9.53247E-06,0,0.019365466,393,144
D:1| T0: 0.10| T1: 515.00| I0: 300.00| I1: 75.00| WTP: 0,1,0.096153846,515,0,0,0,300,75,-4842418067,1037620300,6489.416395,4517947248,451794724.8,22,51129,2225,1078,1078,0,1078,51129,0,1078,14.73085221,0.40399137,0.40399137,70255.45254,115.864617,0.984358145,99391.40723,0.697791979,0.001199967,1.20226E-05,0,0.021083925,258,51
D:1| T0: 0.10| T1: 515.00| I0: 300.00| I1: 75.00| WTP: 0,1,0.096153846,515,0,0,0,300,75,-6634701964,301400999,7134.324637,6277985732,627798573.2,34,57121,2495,1185,1185,0,1185,57121,0,1185,16.36444213,0.444734098,0.444734098,63792.99739,124.0349322,1.058394161,99259.92701,0.642026487,0.001249447,1.24237E-05,0,0.020745435,274,71
D:1| T0: 0.10| T1: 515.00| I0: 300.00| I1: 75.00| WTP: 0,1,0.096153846,515,0,0,0,300,75,-10462832600,1868336855,9681.085598,9978778321,997877832.1,26,76311,3407,1608,1608,0,1608,76311,0,1608,25.05631298,0.75577949,0.75577949,50580.24541,176.7338471,1.69887374,98968.65679,0.510090221,0.001783178,1.92066E-05,0,0.021071667,241,113
D:1| T0: 0.10| T1: 515.00| I0: 300.00| I1: 75.00| WTP: 0,1,0.096153846,515,0,0,0,300,75,-9759354990,1868498144,9668.548126,9275927584,927592758.4,24,73812,3227,1606,1606,0,1606,73812,0,1606,21.4924597,0.655226209,0.655226209,48161.4051,159.1534061,1.48673947,98881.82891,0.486100735,0.001605971,1.68295E-05,0,0.021744726,275,105
D:1| T0: 0.10| T1: 515.00| I0: 300.00| I1: 75.00| WTP: 0,1,0.096153846,515,0,0,0,300,75,-8029483143,2101566889,7049.036264,7677031330,767703133,30,54809,2425,1171,1171,0,1171,54809,0,1171,11.99229209,0.296957404,0.296957404,65458.07221,125.0872211,0.776064909,99252.14402,0.658934714,0.001260436,9.55308E-06,0,0.021365104,353,87
D:1| T0: 0.10| T1: 515.00| I0: 300.00| I1: 75.00| WTP: 0,1,0.096153846,515,0,0,0,300,75,-2536501334,1665097450,10654.31773,2003785448,200378544.8,6,82013,3474,1068,1770,702,1068,82013,702,1770,65.12898331,1.46585736,2.508345979,35458.42489,425.3915023,4.127465857,98632.37329,0.322543914,0.004526873,4.58417E-05,0.396610169,0.021581944,90,22
D:1| T0: 0.10| T1: 515.00| I0: 300.00| I1: 75.00| WTP: 0,1,0.096153846,515,0,0,0,300,75,-3541009639,1716179948,9557.835821,3063117848,306311784.8,8,84026,3890,1312,1587,275,1312,84026,275,1587,65.14657534,1.610958904,1.969863014,33505.06849,395.969863,3.782191781,98780.41781,0.338622939,0.003987193,3.99829E-05,0.173282924,0.018887011,105,34
D:1| T0: 0.10| T1: 515.00| I0: 300.00| I1: 75.00| WTP: 0,1,0.096153846,515,0,0,0,300,75,-4487224888,1560278715,8129.378551,4080755960,408075596,22,54734,2239,1351,1351,0,1351,54734,0,1351,20.05383481,0.779498525,0.779498525,69296.5767,137.6327434,1.78539823,99233.08333,0.693250329,0.00140701,2.03316E-05,0,0.024683012,190,46
D:1| T0: 0.10| T1: 515.00| I0: 300.00| I1: 75.00| WTP: 0,1,0.096153846,515,0,0,0,300,75,-12955026675,991019385,10473.2438,12431364485,1243136448,32,79071,3391,1739,1740,1,1739,79071,1,1740,18.72640219,0.60875513,0.609211126,45135.97492,213.6972184,1.398084815,98796.2093,0.455969688,0.002157341,1.59961E-05,0.000574713,0.022005539,314,141
D:1| T0: 0.10| T1: 515.00| I0: 300.00| I1: 75.00| WTP: 0,1,0.096153846,515,0,0,0,300,75,-7389577658,118052103,9643.888071,6907383254,690738325.4,16,74354,3180,1564,1602,38,1564,74354,38,1602,19.12070611,0.598282443,0.615458015,39543.19084,178.3764313,1.364026718,98716.14074,0.394132508,0.001816827,1.53667E-05,0.02372035,0.021545869,297,78
D:1| T0: 0.10| T1: 515.00| I0: 300.00| I1: 75.00| WTP: 0,1,0.096153846,515,0,0,0,300,75,-5309910329,1209758844,10171.70662,4801324998,480132499.8,14,73332,3048,1660,1690,30,1660,73332,30,1690,31.69883527,1.209650582,1.232945092,44572.23128,178.4101498,2.608985025,98730.43594,0.43845565,0.001839895,2.87051E-05,0.017751479,0.023045874,168,54
D:1| T0: 0.10| T1: 515.00| I0: 300.00| I1: 75.00| WTP: 0,1,0.096153846,515,0,0,0,300,75,-8015322445,70671723,6879.048506,7671370020,767137002,38,51625,2178,1143,1143,0,1143,51625,0,1143,9.676176362,0.266024454,0.266024454,67561.94702,117.7276769,0.687662097,99280.48981,0.679455006,0.001187945,8.52795E-06,0,0.022140436,385,87
D:1| T0: 0.10| T1: 515.00| I0: 300.00| I1: 75.00| WTP: 0,1,0.096153846,515,0,0,0,300,75,-7872561664,1722612191,5762.251422,7584449093,758444909.3,28,48565,2197,957,957,0,957,48565,0,957,10.75,0.2284689,0.2284689,69258.88995,107.2850877,0.61523126,99399.65112,0.696045937,0.001080873,7.6713E-06,0,0.019705549,357,86
D:1| T0: 0.10| T1: 515.00| I0: 300.00| I1: 75.00| WTP: 0,1,0.096153846,515,0,0,0,300,75,-4571957131,1968291596,6227.021264,4260606068,426060606.8,18,52828,2455,1034,1034,0,1034,52828,0,1034,19.31410658,0.464576803,0.464576803,69499.39122,132.2733542,1.105329154,99422.30533,0.696355946,0.001340205,1.3115E-05,0,0.019573324,227,48
D:1| T0: 0.10| T1: 515.00| I0: 300.00| I1: 75.00| WTP: 0,1,0.096153846,515,0,0,0,300,75,-4594203186,1877569084,11436.00217,4022403078,402240307.8,14,81533,3482,1474,1900,426,1474,81533,426,1900,46.71292373,1.372881356,1.8125,35361.68962,276.4555085,3.355932203,98528.27225,0.35133949,0.002819468,3.64511E-05,0.224210526,0.023304305,134,45
D:1| T0: 0.10| T1: 515.00| I0: 300.00| I1: 75.00| WTP: 0,1,0.096153846,515,0,0,0,300,75,-3032177050,1726322189,10083.32599,2528010750,252801075,6,77932,3380,1213,1675,462,1213,77932,462,1675,58.21974965,1.541029207,2.162726008,35034.33241,368.1349096,3.835883171,98632.5299,0.349161814,0.003739378,4.08015E-05,0.276150628,0.02146826,102,28
D:1| T0: 0.10| T1: 515.00| I0: 300.00| I1: 75.00| WTP: 0,1,0.096153846,515,0,0,0,300,75,-7040849812,307848836,9656.353513,6558032136,655803213.6,20,77683,3299,1601,1604,3,1601,77683,3,1604,30.87243736,1.016704632,1.018982536,44278.67957,206.7069096,2.225512528,98866.14047,0.447089454,0.002084383,2.45136E-05,0.001870324,0.020648018,189,74
D:1| T0: 0.10| T1: 515.00| I0: 300.00| I1: 75.00| WTP: 0,1,0.096153846,515,0,0,0,300,75,-1740860955,1154000220,10409.77525,1220372193,122037219.3,4,83903,3822,870,1729,859,870,83903,859,1729,103.0731707,1.729490022,3.620842572,29189.43681,484.7738359,5.55210643,98584.15743,0.295700585,0.00487807,5.80384E-05,0.496818971,0.020607375,65,13
D:1| T0: 0.10| T1: 515.00| I0: 300.00| I1: 75.00| WTP: 0,1,0.096153846,515,0,0,0,300,75,-6432204365,2028661055,6676.414749,6098383628,609838362.8,30,52727,2342,1109,1109,0,1109,52727,0,1109,13.10865645,0.318755636,0.318755636,68930.37872,124.2416592,0.822362489,99348.13075,0.693242938,0.001251425,1.00512E-05,0,0.021034463,317,69
D:1| T0: 0.10| T1: 515.00| I0: 300.00| I1: 75.00| WTP: 0,1,0.096153846,515,0,0,0,300,75,-15442250424,1629114640,9439.185203,14970291164,1497029116,42,74323,3238,1568,1568,0,1568,74323,0,1568,14.19630813,0.368832091,0.368832091,53658.68903,163.7660632,0.926517572,99027.83777,0.540828488,0.001652663,1.12165E-05,0,0.021097103,403,170
D:1| T0: 0.10| T1: 515.00| I0: 300.00| I1: 75.00| WTP: 0,1,0.096153846,515,0,0,0,300,75,-4583936860,1439048174,11231.79124,4022347299,402234729.9,12,82020,3581,1496,1866,370,1496,82020,370,1866,47.76789588,1.430585683,1.819956616,35045.70824,377.8817787,3.440347072,98540.55423,0.352885541,0.003824901,3.69006E-05,0.198285102,0.022750549,132,45
D:1| T0: 0.10| T1: 515.00| I0: 300.00| I1: 75.00| WTP: 0,1,0.096153846,515,0,0,0,300,75,-1416272826,865227006,11044.42522,864051565,86405156.5,2,82841,3471,625,1835,1210,625,82841,1210,1835,84.50784314,1.096078431,3.452941176,30336.21373,435.7568627,4.682352941,98486.00784,0.266874595,0.00464258,5.14228E-05,0.659400545,0.022150867,69,9
D:1| T0: 0.10| T1: 515.00| I0: 300.00| I1: 75.00| WTP: 0,1,0.096153846,515,0,0,0,300,75,-8734873297,890479738,10179.61483,8225892555,822589255.5,18,78457,3385,1669,1691,22,1669,78457,22,1691,23.6292765,0.758833427,0.769489624,39033.91587,315.1794728,1.708356702,98703.17835,0.394800581,0.003178785,1.89947E-05,0.013010053,0.021553207,255,93
D:1| T0: 0.10| T1: 515.00| I0: 300.00| I1: 75.00| WTP: 0,1,0.096153846,515,0,0,0,300,75,-4798506070,1017049163,7218.50573,4437580783,443758078.3,28,58553,2561,1199,1199,0,1199,58553,0,1199,19.06128641,0.545509709,0.545509709,62899.26638,125.7851942,1.26881068,99240.54187,0.633172381,0.00126723,1.46298E-05,0,0.020477175,236,50
D:1| T0: 0.10| T1: 515.00| I0: 300.00| I1: 75.00| WTP: 0,1,0.096153846,515,0,0,0,300,75,-7020909181,1707305064,6237.038654,6709057248,670905724.8,28,52555,2278,1036,1036,0,1036,52555,0,1036,10.98002397,0.250499401,0.250499401,67480.46464,109.76668,0.668797443,99361.47543,0.677320376,0.001109893,8.35117E-06,0,0.019712682,357,76
D:1| T0: 0.10| T1: 515.00| I0: 300.00| I1: 75.00| WTP: 0,1,0.096153846,515,0,0,0,300,75,-1345482937,400145663,11303.97131,780284371.7,78028437.17,2,83824,3616,714,1878,1164,714,83824,1164,1878,132.8621701,1.935483871,5.328445748,29338.54252,658.4252199,7.416422287,98471.60411,0.297454985,0.006624804,7.65575E-05,0.619808307,0.022404085,49,8
D:1| T0: 0.10| T1: 515.00| I0: 300.00| I1: 75.00| WTP: 0,1,0.096153846,515,0,0,0,300,75,-5965835898,1662654181,7706.079056,5580531946,558053194.6,34,61721,2659,1280,1280,0,1280,61721,0,1280,19.57777778,0.546783626,0.546783626,65367.16667,147.3964912,1.277777778,99302.65322,0.657528056,0.001484845,1.50583E-05,0,0.020738484,245,63
D:1| T0: 0.10| T1: 515.00| I0: 300.00| I1: 75.00| WTP: 0,1,0.096153846,515,0,0,0,300,75,-6274701810,182136456,10041.76172,5772613724,577261372.4,24,80353,3552,1472,1668,196,1472,80353,196,1668,31.26627652,0.90709583,1.045354792,36438.86394,204.0841258,2.134601317,98697.65252,0.366289583,0.002066064,2.32382E-05,0.117505995,0.020758404,195,65
D:1| T0: 0.10| T1: 515.00| I0: 300.00| I1: 75.00| WTP: 0,1,0.096153846,515,0,0,0,300,75,-7465416174,979575387,6315.868992,7149622724,714962272.4,26,51781,2330,1049,1049,0,1049,51781,0,1049,12.05546289,0.263969975,0.263969975,71055.25563,144.7577148,0.697664721,99426.87907,0.714131981,0.001456947,8.7914E-06,0,0.020258396,343,81
D:1| T0: 0.10| T1: 515.00| I0: 300.00| I1: 75.00| WTP: 0,1,0.096153846,515,0,0,0,300,75,-5958161543,2142525414,10696.87894,5423317596,542331759.6,14,79671,3513,1694,1777,83,1694,79671,83,1777,36.0375626,1.216193656,1.28130217,39903.25292,261.1444073,2.697829716,98672.58431,0.397042956,0.002663847,2.95306E-05,0.046707935,0.022304226,170,61
D:1| T0: 0.10| T1: 515.00| I0: 300.00| I1: 75.00| WTP: 0,1,0.096153846,515,0,0,0,300,75,-6474365093,1464057597,8922.384636,6028245862,602824586.2,14,72054,3115,1471,1482,11,1471,72054,11,1482,24.72709801,0.775144138,0.779628443,44176.87572,172.7059577,1.728379244,98861.0993,0.445851026,0.001742409,1.90586E-05,0.007422402,0.020568478,223,68
D:1| T0: 0.10| T1: 515.00| I0: 300.00| I1: 75.00| WTP: 0,1,0.096153846,515,0,0,0,300,75,-4678846251,364562610,9764.18779,4190636861,419063686.1,12,74782,3285,1519,1622,103,1519,74782,103,1622,37.43323996,1.225023343,1.316526611,41906.20915,234.914099,2.736694678,98761.85434,0.420970528,0.002379242,2.96807E-05,0.06350185,0.021689711,153,47
D:1| T0: 0.10| T1: 515.00| I0: 300.00| I1: 75.00| WTP: 0,1,0.096153846,515,0,0,0,300,75,-5286109439,40350784,9691.30223,4801544327,480154432.7,12,73355,3096,1518,1610,92,1518,73355,92,1610,38.14980159,1.324404762,1.411706349,43646.0377,279.5396825,2.901785714,98770.06944,0.441224717,0.002817799,3.12542E-05,0.057142857,0.021948061,144,54
D:1| T0: 0.10| T1: 515.00| I0: 300.00| I1: 75.00| WTP: 0,1,0.096153846,515,0,0,0,300,75,-6890707302,804064356,8348.031136,6473305746,647330574.6,26,76701,3468,1386,1386,0,1386,76701,0,1386,34.85818476,0.906807131,0.906807131,53841.19449,179.0502431,2.016207455,99183.47326,0.537009474,0.001822904,2.28422E-05,0,0.018070875,175,73
D:1| T0: 0.10| T1: 515.00| I0: 300.00| I1: 75.00| WTP: 0,1,0.096153846,515,0,0,0,300,75,-5824999409,2125493986,8373.109402,5406343939,540634393.9,32,63444,2722,1391,1391,0,1391,63444,0,1391,20.20322773,0.644351464,0.644351464,58009.422,120.0191273,1.469814704,99092.38852,0.584369947,0.001211021,1.67452E-05,0,0.021926575,239,61
D:1| T0: 0.10| T1: 515.00| I0: 300.00| I1: 75.00| WTP: 0,1,0.096153846,515,0,0,0,300,75,-5200855012,23154253,7962.001846,4802754920,480275492,14,69282,3189,1318,1322,4,1318,69282,4,1322,35.02103418,0.939526731,0.943032428,51424.32515,162.3943909,2.11305872,99086.00175,0.514515221,0.00164864,2.34558E-05,0.003025719,0.019081711,162,54
D:1| T0: 0.10| T1: 515.00| I0: 300.00| I1: 75.00| WTP: 0,1,0.096153846,515,0,0,0,300,75,-4172555620,1391367689,7025.476731,3821281783,382128178.3,20,53258,2342,1167,1167,0,1167,53258,0,1167,21.17780939,0.637980085,0.637980085,68344.84211,127.3755334,1.470128023,99308.30583,0.685387916,0.001292051,1.68052E-05,0,0.021912201,200,43
D:1| T0: 0.10| T1: 515.00| I0: 300.00| I1: 75.00| WTP: 0,1,0.096153846,515,0,0,0,300,75,-9325031812,574142276,8312.062836,8909428671,890942867.1,34,62818,2627,1381,1381,0,1381,62818,0,1381,17.09483218,0.550879062,0.550879062,59984.66063,153.3574853,1.277037826,99130.12733,0.603471099,0.001549161,1.4841E-05,0,0.021984495,268,101
D:1| T0: 0.10| T1: 515.00| I0: 300.00| I1: 75.00| WTP: 0,1,0.096153846,515,0,0,0,300,75,-8550302206,898736779,6982.36975,8201183718,820118371.8,34,52511,2334,1160,1160,0,1160,52511,0,1160,10.15477458,0.241746539,0.241746539,71109.07348,137.2758253,0.653887114,99363.43912,0.713423646,0.00139072,8.32811E-06,0,0.02209061,401,93
D:1| T0: 0.10| T1: 515.00| I0: 300.00| I1: 75.00| WTP: 0,1,0.096153846,515,0,0,0,300,75,-14077943813,346473503,8265.105653,13664688530,1366468853,34,78607,3671,1372,1372,0,1372,78607,0,1372,19.56369834,0.398806988,0.398806988,53274.62804,189.4448232,0.978270132,99182.88709,0.52147267,0.001969254,1.21395E-05,0,0.017453916,325,155
D:1| T0: 0.10| T1: 515.00| I0: 300.00| I1: 75.00| WTP: 0,1,0.096153846,515,0,0,0,300,75,-13259219038,445552282,9577.778618,12780330107,1278033011,40,74203,3349,1591,1591,0,1591,74203,0,1591,16.9332499,0.465581977,0.465581977,57164.36295,177.4609929,1.12640801,99071.69462,0.566338202,0.001831143,1.36782E-05,0,0.02144176,334,145
D:1| T0: 0.10| T1: 515.00| I0: 300.00| I1: 75.00| WTP: 0,1,0.096153846,515,0,0,0,300,75,-1816996692,911758476,10157.88091,1309102647,130910264.7,4,83153,3769,784,1687,903,784,83153,903,1687,77.26101142,1.127243067,2.585644372,29488.03426,380.3980424,3.895595432,98596.47798,0.266014771,0.00400616,4.24747E-05,0.53526971,0.020288147,84,14
D:1| T0: 0.10| T1: 515.00| I0: 300.00| I1: 75.00| WTP: 0,1,0.096153846,515,0,0,0,300,75,-5311848858,1464197940,9965.38196,4813579760,481357976,12,82187,3696,1469,1655,186,1469,82187,186,1655,39.65198618,1.079447323,1.23402418,33674.6943,413.1753022,2.511226252,98675.27375,0.340711403,0.004165229,2.71824E-05,0.112386707,0.020137005,166,54
D:1| T0: 0.10| T1: 515.00| I0: 300.00| I1: 75.00| WTP: 0,1,0.096153846,515,0,0,0,300,75,-7337286467,500405854,8782.05067,6898183934,689818393.4,32,64229,2823,1459,1459,0,1459,64229,0,1459,20.36241218,0.653981265,0.653981265,63688.4034,152.6094848,1.512295082,99191.6692,0.638667449,0.001549684,1.73214E-05,0,0.022715949,243,78
D:1| T0: 0.10| T1: 515.00| I0: 300.00| I1: 75.00| WTP: 0,1,0.096153846,515,0,0,0,300,75,-8045274793,772037341,10514.26699,7519561444,751956144.4,32,76482,3141,1746,1747,1,1746,76482,1,1747,23.85082873,0.864947821,0.865561694,48974.69859,153.9300184,1.934315531,98845.32474,0.494299793,0.001554423,2.16183E-05,0.00057241,0.022842275,233,85
D:1| T0: 0.10| T1: 515.00| I0: 300.00| I1: 75.00| WTP: 0,1,0.096153846,515,0,0,0,300,75,-4542332505,1543158763,5839.272754,4250368867,425036886.7,24,47070,2069,970,970,0,970,47070,0,970,12.96540881,0.332285115,0.332285115,71838.98637,118.9753669,0.83490566,99422.11006,0.720357022,0.001204869,1.02765E-05,0,0.020608481,271,48
D:1| T0: 0.10| T1: 515.00| I0: 300.00| I1: 75.00| WTP: 0,1,0.096153846,515,0,0,0,300,75,-3992797724,1604932531,11705.79638,3407507905,340750790.5,16,83427,3485,1433,1945,512,1433,83427,512,1945,50.81058824,1.497647059,2.091764706,36337.27647,288.5341176,3.78,98536.19882,0.355855768,0.002967775,4.08824E-05,0.263239075,0.023313795,120,38
D:1| T0: 0.10| T1: 515.00| I0: 300.00| I1: 75.00| WTP: 0,1,0.096153846,515,0,0,0,300,75,-8745459014,539051477,10342.55889,8228331070,822833107,20,79037,3511,1670,1718,48,1670,79037,48,1718,25.75295508,0.807919622,0.832742317,40618.27541,266.6140662,1.817966903,98713.52719,0.399711503,0.002740135,2.05626E-05,0.027939464,0.021736655,238,93
D:1| T0: 0.10| T1: 515.00| I0: 300.00| I1: 75.00| WTP: 0,1,0.096153846,515,0,0,0,300,75,-3878595335,1743124675,6418.638049,3557663432,355766343.2,26,52538,2397,1066,1066,0,1066,52538,0,1066,20.00134953,0.522267206,0.522267206,69920.2058,120.4021592,1.250337382,99400.7807,0.701892992,0.001216146,1.45021E-05,0,0.020290076,211,40
D:1| T0: 0.10| T1: 515.00| I0: 300.00| I1: 75.00| WTP: 0,1,0.096153846,515,0,0,0,300,75,-13482365412,1965983789,8956.345243,13034548150,1303454815,30,66225,2876,1488,1488,0,1488,66225,0,1488,13.81468531,0.385392385,0.385392385,60168.06721,149.2090132,0.966200466,99108.95843,0.605272796,0.001508841,1.16712E-05,0,0.022468856,367,148
D:1| T0: 0.10| T1: 515.00| I0: 300.00| I1: 75.00| WTP: 0,1,0.096153846,515,0,0,0,300,75,-10887641870,516774280,7893.409074,10492971416,1049297142,44,64214,2921,1311,1311,0,1311,64214,0,1311,12.33208319,0.278895329,0.278895329,61215.68394,140.633822,0.724855097,99211.78213,0.615953513,0.001418676,9.00172E-06,0,0.020416109,418,119
D:1| T0: 0.10| T1: 515.00| I0: 300.00| I1: 75.00| WTP: 0,1,0.096153846,515,0,0,0,300,75,-1306194288,86603142,10493.61535,781513521,78151352.1,2,83064,3579,515,1743,1228,515,83064,1228,1743,229.9306931,2.455445545,8.504950495,37292.29208,1066.920792,11.04950495,98757.9604,0.340566859,0.011316743,0.000118645,0.704936854,0.020971781,28,8
D:1| T0: 0.10| T1: 515.00| I0: 300.00| I1: 75.00| WTP: 0,1,0.096153846,515,0,0,0,300,75,-9819723666,1431870609,7699.091465,9434769093,943476909.3,48,60204,2595,1279,1279,0,1279,60204,0,1279,10.76823607,0.238395225,0.238395225,66072.90915,137.3975464,0.662135279,99286.39357,0.664753287,0.001384816,8.53322E-06,0,0.021244436,431,107
D:1| T0: 0.10| T1: 515.00| I0: 300.00| I1: 75.00| WTP: 0,1,0.096153846,515,0,0,0,300,75,-6630472076,1592383984,8549.85925,6202979113,620297911.3,18,69039,3066,1419,1420,1,1419,69039,1,1420,31.33795918,0.951020408,0.951020408,56785.65714,163.8653061,2.120816327,99126.54694,0.570956934,0.001655538,2.33792E-05,0.000704225,0.020568085,175,70
D:1| T0: 0.10| T1: 515.00| I0: 300.00| I1: 75.00| WTP: 0,1,0.096153846,515,0,0,0,300,75,-9834462311,1440183867,7833.96469,9442764077,944276407.7,32,67041,3047,1301,1301,0,1301,67041,0,1301,18.13660934,0.452579853,0.452579853,59702.1145,158.9847666,1.092383292,99216.97887,0.600957144,0.001602069,1.28636E-05,0,0.019406325,291,107
D:1| T0: 0.10| T1: 515.00| I0: 300.00| I1: 75.00| WTP: 0,1,0.096153846,515,0,0,0,300,75,-9860643550,1696510588,8421.484594,9439569320,943956932,40,65117,2849,1399,1399,0,1399,65117,0,1399,16.01013358,0.459235375,0.459235375,59273.31644,141.180562,1.097190235,99127.10456,0.596881679,0.001424296,1.29789E-05,0,0.021484405,310,107
D:1| T0: 0.10| T1: 515.00| I0: 300.00| I1: 75.00| WTP: 0,1,0.096153846,515,0,0,0,300,75,-12885812660,895039877,10762.79858,12347672731,1234767273,32,78393,3446,1788,1788,0,1788,78393,0,1788,18.78324698,0.582469775,0.582469775,44900.99352,177.7875648,1.35880829,98757.55872,0.450277616,0.001806285,1.56677E-05,0,0.022808741,329,140
D:1| T0: 0.10| T1: 515.00| I0: 300.00| I1: 75.00| WTP: 0,1,0.096153846,515,0,0,0,300,75,-15510918924,129565953,9214.394048,15050199222,1505019922,46,66618,2909,1531,1531,0,1531,66618,0,1531,11.43373105,0.30248307,0.30248307,60114.31506,150.6697839,0.801999355,99104.17124,0.605348134,0.001521167,9.95369E-06,0,0.022966766,442,171
D:1| T0: 0.10| T1: 515.00| I0: 300.00| I1: 75.00| WTP: 0,1,0.096153846,515,0,0,0,300,75,-6486446809,1902565669,7544.828537,6109205382,610920538.2,30,65751,2908,1253,1253,0,1253,65751,0,1253,20.97492537,0.561791045,0.561791045,60640.31343,149.8,1.300298507,99263.04119,0.608972348,0.001513585,1.50915E-05,0,0.019056744,239,69
D:1| T0: 0.10| T1: 515.00| I0: 300.00| I1: 75.00| WTP: 0,1,0.096153846,515,0,0,0,300,75,-11666057424,1984179288,7866.378975,11272738475,1127273848,50,59677,2520,1307,1307,0,1307,59677,0,1307,8.439285714,0.207142857,0.207142857,62694.81896,124.4554945,0.559615385,99197.84945,0.629023884,0.001262336,7.27053E-06,0,0.021901235,517,128
D:1| T0: 0.10| T1: 515.00| I0: 300.00| I1: 75.00| WTP: 0,1,0.096153846,515,0,0,0,300,75,-12071050558,677377223,10275.81947,11557259584,1155725958,24,76331,3373,1707,1707,0,1707,76331,0,1707,17.34807302,0.512373225,0.512373225,43694.63732,251.6032454,1.204868154,98756.29533,0.441754642,0.002538907,1.39634E-05,0,0.022363129,352,131
D:1| T0: 0.10| T1: 515.00| I0: 300.00| I1: 75.00| WTP: 0,1,0.096153846,515,0,0,0,300,75,-16042746564,973583301,9145.459449,15585473591,1558547359,28,74669,3298,1519,1519,0,1519,74669,0,1519,15.02084857,0.371982443,0.371982443,49683.01463,220.9147769,0.92355523,98982.02524,0.500852186,0.00222952,1.12011E-05,0,0.020343114,391,177
D:1| T0: 0.10| T1: 515.00| I0: 300.00| I1: 75.00| WTP: 0,1,0.096153846,515,0,0,0,300,75,-9831871953,781062938,7756.292841,9444057311,944405731.1,38,66471,3084,1288,1288,0,1288,66471,0,1288,16.31865285,0.382556131,0.382556131,56900.68998,131.8855786,0.934801382,99168.58074,0.57294351,0.001329335,1.11899E-05,0,0.019376871,331,107
D:1| T0: 0.10| T1: 515.00| I0: 300.00| I1: 75.00| WTP: 0,1,0.096153846,515,0,0,0,300,75,-21026532129,338783425,8840.046612,20584529799,2058452980,40,73133,3404,1468,1468,0,1468,73133,0,1468,12.364,0.247142857,0.247142857,56075.46971,170.9922857,0.663142857,99113.77486,0.563825709,0.001728774,8.46759E-06,0,0.020073292,499,234
D:1| T0: 0.10| T1: 515.00| I0: 300.00| I1: 100.00| WTP: 0,1,0.096153846,515,0,0,0,300,100,-6843882644,1178568022,7753.80527,6456192381,645619238.1,36,59173,2596,1288,1288,0,1288,59173,0,1288,16.59307577,0.445559458,0.445559458,67053.13698,152.8554942,1.091821375,99297.55645,0.674528869,0.001540112,1.30025E-05,0,0.021767052,284,73
D:1| T0: 0.10| T1: 515.00| I0: 300.00| I1: 100.00| WTP: 0,1,0.096153846,515,0,0,0,300,100,-6953241213,2029998696,9526.355302,6476923447,647692344.7,24,80194,3527,1574,1582,8,1574,80194,8,1582,37.5738255,1.095637584,1.102348993,44830.72315,227.3598993,2.434563758,98920.83054,0.44773785,0.002311588,2.68905E-05,0.00505689,0.019727654,169,73
D:1| T0: 0.10| T1: 515.00| I0: 300.00| I1: 100.00| WTP: 0,1,0.096153846,515,0,0,0,300,100,-4995576864,776062361,10780.10469,4456571629,445657162.9,10,77813,3285,1531,1791,260,1531,77813,260,1791,36.90884956,1.182300885,1.405309735,37758.44513,426.9442478,2.771681416,98584.9708,0.368022677,0.004403644,3.03102E-05,0.145170296,0.02301672,157,50
D:1| T0: 0.10| T1: 515.00| I0: 300.00| I1: 100.00| WTP: 0,1,0.096153846,515,0,0,0,300,100,-8863984158,1813046880,7890.990953,8469434610,846943461,40,59354,2528,1311,1311,0,1311,59354,0,1311,11.9536298,0.323831243,0.323831243,64007.57773,143.0277461,0.810718358,99211.37552,0.644415902,0.00144174,1.00278E-05,0,0.022087812,376,96
D:1| T0: 0.10| T1: 515.00| I0: 300.00| I1: 100.00| WTP: 0,1,0.096153846,515,0,0,0,300,100,-5513452767,2032407216,7417.931469,5142556193,514255619.3,32,62301,2718,1232,1232,0,1232,62301,0,1232,22.75845737,0.635994587,0.635994587,60734.46549,148.0534506,1.467523681,99230.47294,0.607855784,0.001504318,1.69117E-05,0,0.019775281,210,58
D:1| T0: 0.10| T1: 515.00| I0: 300.00| I1: 100.00| WTP: 0,1,0.096153846,515,0,0,0,300,100,-6339683960,1507873352,6769.353534,6001216283,600121628.3,34,46781,1921,1125,1125,0,1125,46781,0,1125,8.590055249,0.241620626,0.241620626,72389.03831,124.3060773,0.662615101,99335.73775,0.726359135,0.001260454,8.38668E-06,0,0.024048225,385,68
D:1| T0: 0.10| T1: 515.00| I0: 300.00| I1: 100.00| WTP: 0,1,0.096153846,515,0,0,0,300,100,-3689773254,1855899401,6172.051141,3381170697,338117069.7,20,51823,2277,1025,1025,0,1025,51823,0,1025,22.52136752,0.588966589,0.588966589,70033.67988,150.3131313,1.383838384,99410.17483,0.703746657,0.001513523,1.60104E-05,0,0.019780008,184,38
D:1| T0: 0.10| T1: 515.00| I0: 300.00| I1: 100.00| WTP: 0,1,0.096153846,515,0,0,0,300,100,-7545849353,1819459251,9312.781783,7080210264,708021026.4,24,72047,3104,1547,1547,0,1547,72047,0,1547,28.06468023,0.902616279,0.902616279,55112.23256,188.5922965,2.037063953,99059.84084,0.55540364,0.001901392,2.26442E-05,0,0.021473287,197,80
D:1| T0: 0.10| T1: 515.00| I0: 300.00| I1: 100.00| WTP: 0,1,0.096153846,515,0,0,0,300,100,-3296610155,909791748,7019.707624,2945624774,294562477.4,22,52710,2440,1166,1166,0,1166,52710,0,1166,20.96406358,0.600552868,0.600552868,66774.67519,117.9253628,1.417415342,99272.30062,0.672052727,0.001187828,1.61993E-05,0,0.022121879,207,33
D:1| T0: 0.10| T1: 515.00| I0: 300.00| I1: 100.00| WTP: 0,1,0.096153846,515,0,0,0,300,100,-5971966610,1339092841,9461.796126,5498876803,549887680.3,20,67846,2845,1572,1572,0,1572,67846,0,1572,28.2852689,1.010911925,1.010911925,57005.32034,190.6578332,2.240062354,99017.8979,0.574825711,0.001922453,2.46799E-05,0,0.023170121,184,62
D:1| T0: 0.10| T1: 515.00| I0: 300.00| I1: 100.00| WTP: 0,1,0.096153846,515,0,0,0,300,100,-6484017586,1365866345,10655.51508,5951241832,595124183.2,24,82953,3559,1754,1770,16,1754,82953,16,1770,36.73614557,1.23738627,1.250620347,45334.70968,215.1430935,2.713813069,98825.38213,0.434051662,0.002265057,3.06512E-05,0.009039548,0.021337898,166,67
D:1| T0: 0.10| T1: 515.00| I0: 300.00| I1: 100.00| WTP: 0,1,0.096153846,515,0,0,0,300,100,-11022281655,825453433,8682.718217,10588145744,1058814574,32,68863,3189,1442,1442,0,1442,68863,0,1442,19.74791564,0.514958313,0.514958313,54351.31927,172.5733203,1.219715547,99048.96224,0.547870892,0.00173981,1.42399E-05,0,0.020940127,292,120
D:1| T0: 0.10| T1: 515.00| I0: 300.00| I1: 100.00| WTP: 0,1,0.096153846,515,0,0,0,300,100,-6925359825,939711378,10644.67187,6393126231,639312623.1,22,83023,3703,1714,1768,54,1714,83023,54,1768,39.85153584,1.242320819,1.290102389,41390.64761,278.4215017,2.755119454,98772.94539,0.41822443,0.002808767,2.99516E-05,0.030542986,0.021295304,168,72
D:1| T0: 0.10| T1: 515.00| I0: 300.00| I1: 100.00| WTP: 0,1,0.096153846,515,0,0,0,300,100,-12693135121,638950699,8867.556192,12249757312,1224975731,40,69991,3178,1473,1473,0,1473,69991,0,1473,15.27791165,0.393975904,0.393975904,56557.61205,178.3598394,0.980722892,99102.65823,0.569771982,0.001798453,1.19144E-05,0,0.021045563,356,139
D:1| T0: 0.10| T1: 515.00| I0: 300.00| I1: 100.00| WTP: 0,1,0.096153846,515,0,0,0,300,100,-5410926577,938699148,7105.887865,5055632184,505563218.4,30,60906,2748,1180,1180,0,1180,60906,0,1180,24.96128561,0.664718773,0.664718773,63380.58656,150.0934989,1.529583638,99300.61651,0.631368506,0.001536825,1.76243E-05,0,0.019357699,193,57
D:1| T0: 0.10| T1: 515.00| I0: 300.00| I1: 100.00| WTP: 0,1,0.096153846,515,0,0,0,300,100,-9827701383,121790188,6196.270047,9517887880,951788788,44,54559,2473,1029,1029,0,1029,54559,0,1029,11.69937695,0.228582555,0.228582555,69225.38746,153.5996885,0.626557632,99427.98287,0.69567806,0.001545794,8.05232E-06,0,0.018861353,366,108
D:1| T0: 0.10| T1: 515.00| I0: 300.00| I1: 100.00| WTP: 0,1,0.096153846,515,0,0,0,300,100,-6197658177,1331335240,10222.50758,5686532798,568653279.8,14,79794,3461,1587,1698,111,1587,79794,111,1698,32.29851852,0.997777778,1.077777778,37305.04741,390.3748148,2.251851852,98696.41481,0.3711479,0.00397397,2.47635E-05,0.065371025,0.021279795,191,64
D:1| T0: 0.10| T1: 515.00| I0: 300.00| I1: 100.00| WTP: 0,1,0.096153846,515,0,0,0,300,100,-1600416408,470935411,11189.15966,1040958425,104095842.5,2,81563,3470,796,1859,1063,796,81563,1063,1859,96.23026316,1.603070175,3.903508772,32477.86623,463.2214912,5.649122807,98505.36184,0.296268851,0.00488949,6.14923E-05,0.571812803,0.022792197,63,11
D:1| T0: 0.10| T1: 515.00| I0: 300.00| I1: 100.00| WTP: 0,1,0.096153846,515,0,0,0,300,100,-10779796362,823434397,9244.7701,10317557857,1031755786,40,67051,2778,1536,1536,0,1536,67051,0,1536,17.13159168,0.539912917,0.539912917,59727.25738,166.5776488,1.283986454,99090.64635,0.601738789,0.001680307,1.497E-05,0,0.022893022,296,117
D:1| T0: 0.10| T1: 515.00| I0: 300.00| I1: 100.00| WTP: 0,1,0.096153846,515,0,0,0,300,100,-3199182302,493045351,6750.70388,2861647108,286164710.8,20,57585,2581,1121,1121,0,1121,57585,0,1121,27.99140893,0.762027491,0.762027491,66043.52234,125.7182131,1.716494845,99344.86082,0.663568455,0.001267857,1.93862E-05,0,0.019466875,166,32
D:1| T0: 0.10| T1: 515.00| I0: 300.00| I1: 100.00| WTP: 0,1,0.096153846,515,0,0,0,300,100,-9897733864,1700216563,7335.66648,9530950540,953095054,28,65221,3020,1218,1218,0,1218,65221,0,1218,19.5203125,0.434895833,0.434895833,61244.2125,183.6479167,1.06875,99278.05833,0.616189837,0.001849199,1.27586E-05,0,0.018674967,275,108
D:1| T0: 0.10| T1: 515.00| I0: 300.00| I1: 100.00| WTP: 0,1,0.096153846,515,0,0,0,300,100,-4205536898,1744119059,7467.451996,3832164298,383216429.8,22,63756,2942,1238,1240,2,1238,63756,2,1240,36.32160804,1.020100503,1.022110553,62398.20804,177.1417085,2.270351759,99282.67136,0.627817625,0.001783045,2.50345E-05,0.001612903,0.01944915,143,43
D:1| T0: 0.10| T1: 515.00| I0: 300.00| I1: 100.00| WTP: 0,1,0.096153846,515,0,0,0,300,100,-10695723045,2036906360,7716.705402,10309887775,1030988777,40,58535,2554,1282,1282,0,1282,58535,0,1282,10.94266852,0.269284225,0.269284225,63710.51737,140.8474635,0.71438499,99210.38707,0.639149846,0.001428465,9.01973E-06,0,0.021901426,408,117
D:1| T0: 0.10| T1: 515.00| I0: 300.00| I1: 100.00| WTP: 0,1,0.096153846,515,0,0,0,300,100,-11085426492,809704121,8284.793103,10671186837,1067118684,36,67588,3039,1376,1376,0,1376,67588,0,1376,17.18156934,0.431569343,0.431569343,59237.90192,158.9133212,1.064324818,99175.35401,0.596045672,0.001603485,1.26475E-05,0,0.020358945,312,121
D:1| T0: 0.10| T1: 515.00| I0: 300.00| I1: 100.00| WTP: 0,1,0.096153846,515,0,0,0,300,100,-16534213419,1219866412,10125.77929,16027924454,1602792445,38,79722,3458,1682,1682,0,1682,79722,0,1682,16.84372564,0.463367108,0.463367108,45328.01013,254.4894778,1.121590023,98861.51325,0.457668241,0.002567906,1.3216E-05,0,0.021098317,367,182
D:1| T0: 0.10| T1: 515.00| I0: 300.00| I1: 100.00| WTP: 0,1,0.096153846,515,0,0,0,300,100,-5192753835,843498920,6554.329315,4865037369,486503736.9,34,48875,2094,1089,1089,0,1089,48875,0,1089,12.96439628,0.389060888,0.389060888,68924.49948,121.0856553,0.956140351,99311.24768,0.693501526,0.001219318,1.1294E-05,0,0.02228133,277,55
D:1| T0: 0.10| T1: 515.00| I0: 300.00| I1: 100.00| WTP: 0,1,0.096153846,515,0,0,0,300,100,-13713291883,107351963,10120.58811,13207262477,1320726248,54,70494,2795,1682,1682,0,1682,70494,0,1682,11.99534884,0.41216458,0.41216458,57954.14597,175.5563506,1.013595707,98996.66869,0.584213227,0.001773095,1.2138E-05,0,0.023860187,400,150
D:1| T0: 0.10| T1: 515.00| I0: 300.00| I1: 100.00| WTP: 0,1,0.096153846,515,0,0,0,300,100,-13903600751,773789021,8596.294805,13473786011,1347378601,50,68878,2954,1428,1428,0,1428,68878,0,1428,12.87110482,0.323654391,0.323654391,57705.08676,164.8041785,0.819405099,99140.63031,0.580824723,0.001662724,1.01897E-05,0,0.020732309,404,153
D:1| T0: 0.10| T1: 515.00| I0: 300.00| I1: 100.00| WTP: 0,1,0.096153846,515,0,0,0,300,100,-10420367749,850936611,9088.28621,9965953438,996595343.8,40,66985,2841,1510,1510,0,1510,66985,0,1510,17.26352357,0.548387097,0.548387097,59909.95385,175.6858561,1.294292804,99103.29429,0.600789192,0.001784252,1.51997E-05,0,0.02254236,286,113
D:1| T0: 0.10| T1: 515.00| I0: 300.00| I1: 100.00| WTP: 0,1,0.096153846,515,0,0,0,300,100,-8224934539,1701318364,8927.443307,7778562373,777856237.3,34,70227,2981,1483,1483,0,1483,70227,0,1483,23.18925671,0.707682698,0.707682698,59057.13367,185.1255465,1.642723298,99135.06558,0.591751522,0.00188066,1.87934E-05,0,0.021117234,227,88
D:1| T0: 0.10| T1: 515.00| I0: 300.00| I1: 100.00| WTP: 0,1,0.096153846,515,0,0,0,300,100,-9844067295,778708269,6603.324134,9513901089,951390108.9,38,51591,2283,1097,1097,0,1097,51591,0,1097,9.492758621,0.20862069,0.20862069,68808.64897,135.8868966,0.59137931,99347.05517,0.691695725,0.001369631,7.61249E-06,0,0.021263811,414,108
D:1| T0: 0.10| T1: 515.00| I0: 300.00| I1: 100.00| WTP: 0,1,0.096153846,515,0,0,0,300,100,-4940659033,1391938506,8400.153817,4520651342,452065134.2,32,56618,2330,1396,1396,0,1396,56618,0,1396,18.70725216,0.72255489,0.72255489,63110.45842,134.172322,1.644710579,99098.65868,0.6361303,0.001352707,1.86942E-05,0,0.024657341,215,51
D:1| T0: 0.10| T1: 515.00| I0: 300.00| I1: 100.00| WTP: 0,1,0.096153846,515,0,0,0,300,100,-5005242671,43418681,6325.835816,4688950880,468895088,28,48638,2067,1051,1051,0,1051,48638,0,1051,12.89073881,0.363163371,0.363163371,72212.81426,141.8647242,0.911550468,99405.46254,0.725920972,0.001427881,1.09885E-05,0,0.021608619,275,53
D:1| T0: 0.10| T1: 515.00| I0: 300.00| I1: 100.00| WTP: 0,1,0.096153846,515,0,0,0,300,100,-4300285611,817384966,10917.91774,3754389724,375438972.4,22,79375,3255,1535,1814,279,1535,79375,279,1814,43.52173913,1.430540827,1.718981972,40651.48887,229.3510074,3.338282078,98663.73065,0.40946204,0.002321269,3.59323E-05,0.153803749,0.022853543,135,42
D:1| T0: 0.10| T1: 515.00| I0: 300.00| I1: 100.00| WTP: 0,1,0.096153846,515,0,0,0,300,100,-6353806902,762053968,9873.62568,5860125618,586012561.8,28,79277,3422,1615,1640,25,1615,79277,25,1640,32.94667697,1.044822257,1.063369397,45888.65997,190.8060278,2.309891808,98893.14915,0.46222664,0.001927825,2.53833E-05,0.015243902,0.020686958,185,66
D:1| T0: 0.10| T1: 515.00| I0: 300.00| I1: 100.00| WTP: 0,1,0.096153846,515,0,0,0,300,100,-12202962395,1692506311,7881.756113,11808874589,1180887459,46,67514,3035,1309,1309,0,1309,67514,0,1309,14.80441767,0.326907631,0.326907631,62362.24578,179.2220884,0.854216867,99290.32691,0.625020272,0.00181641,1.06432E-05,0,0.019388571,353,134
D:1| T0: 0.10| T1: 515.00| I0: 300.00| I1: 100.00| WTP: 0,1,0.096153846,515,0,0,0,300,100,-4226712285,1037620300,6506.485595,3901388005,390138800.5,22,50101,2077,1081,1081,0,1081,50101,0,1081,14.9840708,0.459587021,0.459587021,70483.36401,123.4690265,1.099115044,99379.66785,0.699411507,0.001281943,1.32223E-05,0,0.021577277,235,44
D:1| T0: 0.10| T1: 515.00| I0: 300.00| I1: 100.00| WTP: 0,1,0.096153846,515,0,0,0,300,100,-5612381646,301400999,7646.085023,5230077395,523007739.5,32,60002,2683,1270,1270,0,1270,60002,0,1270,21.56977492,0.608360129,0.608360129,65385.80707,159.1337621,1.421864952,99284.45723,0.657860339,0.001602669,1.64282E-05,0,0.021165961,223,59
D:1| T0: 0.10| T1: 515.00| I0: 300.00| I1: 100.00| WTP: 0,1,0.096153846,515,0,0,0,300,100,-9354899360,1868336855,10282.15929,8840791396,884079139.6,24,78885,3441,1708,1708,0,1708,78885,0,1708,29.89198606,0.967944251,0.967944251,52187.97213,213.9512195,2.154006969,98975.87735,0.526205635,0.00215901,2.39933E-05,0,0.021651772,205,100
D:1| T0: 0.10| T1: 515.00| I0: 300.00| I1: 100.00| WTP: 0,1,0.096153846,515,0,0,0,300,100,-9237497178,1868498144,9752.558993,8749869228,874986922.8,26,76109,3337,1620,1620,0,1620,76109,0,1620,27.10210804,0.842555995,0.842555995,52068.01186,208.7977602,1.905797101,98986.79908,0.525035748,0.002106095,2.1504E-05,0,0.021285542,217,99
D:1| T0: 0.10| T1: 515.00| I0: 300.00| I1: 100.00| WTP: 0,1,0.096153846,515,0,0,0,300,100,-8198117757,2101566889,6875.528438,7854341335,785434133.5,36,56395,2506,1142,1142,0,1142,56395,0,1142,11.41805401,0.262301147,0.262301147,63142.44321,117.8938217,0.682204957,99247.3522,0.635618182,0.001188042,8.49524E-06,0,0.020250022,387,89
D:1| T0: 0.10| T1: 515.00| I0: 300.00| I1: 100.00| WTP: 0,1,0.096153846,515,0,0,0,300,100,-2607561936,1665097450,10329.88022,2091067925,209106792.5,8,80136,3445,1014,1716,702,1014,80136,702,1716,54.04539723,1.138713745,2.005044136,33267.79445,346.1273644,3.288776797,98583.51198,0.306009224,0.003649512,3.63003E-05,0.409090909,0.021413597,109,23
D:1| T0: 0.10| T1: 515.00| I0: 300.00| I1: 100.00| WTP: 0,1,0.096153846,515,0,0,0,300,100,-3612853201,1716179948,9286.866462,3148509878,314850987.8,10,80455,3732,1267,1542,275,1267,80455,275,1542,52.888,1.307428571,1.606857143,31890.65486,315.6114286,3.054857143,98722.4,0.322569181,0.003178312,3.2321E-05,0.178339818,0.019165993,125,35
D:1| T0: 0.10| T1: 515.00| I0: 300.00| I1: 100.00| WTP: 0,1,0.096153846,515,0,0,0,300,100,-4043738709,1560278715,8039.065104,3641785454,364178545.4,22,55159,2192,1336,1336,0,1336,55159,0,1336,20.36958175,0.795437262,0.795437262,68470.76122,143.3840304,1.815209125,99250.80076,0.684548872,0.001465906,2.07398E-05,0,0.024220889,185,41
D:1| T0: 0.10| T1: 515.00| I0: 300.00| I1: 100.00| WTP: 0,1,0.096153846,515,0,0,0,300,100,-12337909055,991019385,10407.12082,11817553014,1181755301,36,77362,3317,1728,1729,1,1728,77362,1,1729,18.24019608,0.595811052,0.596256684,43773.69162,203.333779,1.364527629,98753.24866,0.442360142,0.002052556,1.5533E-05,0.000578369,0.022349474,321,134
D:1| T0: 0.10| T1: 515.00| I0: 300.00| I1: 100.00| WTP: 0,1,0.096153846,515,0,0,0,300,100,-6771144525,118052103,9530.070195,6294641015,629464101.5,16,74649,3221,1545,1583,38,1545,74649,38,1583,26.11204121,0.815840309,0.839021249,43196.41533,241.3670316,1.838377334,98801.6671,0.429092206,0.002465432,2.05544E-05,0.024005054,0.02120591,219,71
D:1| T0: 0.10| T1: 515.00| I0: 300.00| I1: 100.00| WTP: 0,1,0.096153846,515,0,0,0,300,100,-5072956862,1209758844,10682.32361,4538840682,453884068.2,16,74470,3089,1745,1775,30,1745,74470,30,1775,31.92314119,1.266499582,1.289891395,43663.72932,182.1963241,2.746867168,98675.28321,0.42916295,0.001879577,3.03036E-05,0.016901408,0.023835421,168,51
D:1| T0: 0.10| T1: 515.00| I0: 300.00| I1: 100.00| WTP: 0,1,0.096153846,515,0,0,0,300,100,-7152484007,70671723,7072.525242,6798857745,679885774.5,38,55041,2309,1175,1175,0,1175,55041,0,1175,10.55399408,0.272189349,0.272189349,64442.70747,125.254068,0.707840237,99239.19859,0.648208213,0.001263912,8.75189E-06,0,0.021347723,386,77
D:1| T0: 0.10| T1: 515.00| I0: 300.00| I1: 100.00| WTP: 0,1,0.096153846,515,0,0,0,300,100,-6332500683,1722612191,6388.901997,6013055583,601305558.3,26,53583,2397,1061,1061,0,1061,53583,0,1061,14.7829233,0.318379161,0.318379161,68731.8384,142.6980222,0.836468886,99386.08731,0.690662952,0.001437849,1.02959E-05,0,0.019801795,295,68
D:1| T0: 0.10| T1: 515.00| I0: 300.00| I1: 100.00| WTP: 0,1,0.096153846,515,0,0,0,300,100,-4208605924,1968291596,6022.020265,3907504911,390750491.1,20,51253,2368,1000,1000,0,1000,51253,0,1000,20.34489938,0.499653019,0.499653019,70842.6551,141.869535,1.199167245,99440.07842,0.709665442,0.001438102,1.40464E-05,0,0.019511053,205,44
D:1| T0: 0.10| T1: 515.00| I0: 300.00| I1: 100.00| WTP: 0,1,0.096153846,515,0,0,0,300,100,-4153211129,1877569084,11387.8516,3583818549,358381854.9,14,81838,3485,1466,1892,426,1466,81838,426,1892,49.59096045,1.46440678,1.933333333,34600.62486,296.0022599,3.593220339,98517.11073,0.343069542,0.003020598,3.87199E-05,0.225158562,0.023118845,125,40
D:1| T0: 0.10| T1: 515.00| I0: 300.00| I1: 100.00| WTP: 0,1,0.096153846,515,0,0,0,300,100,-2783907309,1726322189,10342.11604,2266801507,226680150.7,6,79555,3450,1256,1718,462,1256,79555,462,1718,59.47711512,1.558945908,2.178918169,34069.16782,374.1289875,3.94590846,98608.69487,0.339345809,0.003800851,4.19094E-05,0.268917346,0.021595123,103,25
D:1| T0: 0.10| T1: 515.00| I0: 300.00| I1: 100.00| WTP: 0,1,0.096153846,515,0,0,0,300,100,-6937058227,307848836,9391.18186,6467499134,646749913.4,22,75091,3167,1557,1560,3,1557,75091,3,1560,25.972,0.876,0.878,41992.77333,175.6653333,1.909333333,98810.924,0.424264161,0.001771547,2.09292E-05,0.00192431,0.020761753,215,73
D:1| T0: 0.10| T1: 515.00| I0: 300.00| I1: 100.00| WTP: 0,1,0.096153846,515,0,0,0,300,100,-1740860955,1154000220,10409.77525,1220372193,122037219.3,4,83903,3822,870,1729,859,870,83903,859,1729,103.0731707,1.729490022,3.620842572,29189.43681,484.7738359,5.55210643,98584.15743,0.295700585,0.00487807,5.80384E-05,0.496818971,0.020607375,65,13
D:1| T0: 0.10| T1: 515.00| I0: 300.00| I1: 100.00| WTP: 0,1,0.096153846,515,0,0,0,300,100,-5737068439,2028661055,6826.103789,5395763249,539576324.9,32,52739,2342,1134,1134,0,1134,52739,0,1134,14.49199793,0.387712958,0.387712958,68984.95405,142.4697987,0.971605576,99340.91017,0.693839024,0.001434502,1.17695E-05,0,0.021502114,277,61
D:1| T0: 0.10| T1: 515.00| I0: 300.00| I1: 100.00| WTP: 0,1,0.096153846,515,0,0,0,300,100,-14456127320,1629114640,9030.329848,14004610827,1400461083,44,72835,3194,1500,1500,0,1500,72835,0,1500,15.49584158,0.400792079,0.400792079,55098.4899,178.4887129,0.997227723,99093.21545,0.555011096,0.001800042,1.19663E-05,0,0.020594777,361,159
D:1| T0: 0.10| T1: 515.00| I0: 300.00| I1: 100.00| WTP: 0,1,0.096153846,515,0,0,0,300,100,-4491390384,1439048174,11141.57485,3934311642,393431164.2,14,81733,3600,1481,1851,370,1481,81733,370,1851,40.27849265,1.201286765,1.53125,32571.6875,319.4568015,2.886029412,98495.25827,0.328232231,0.003232379,3.09787E-05,0.19989195,0.022646911,155,44
D:1| T0: 0.10| T1: 515.00| I0: 300.00| I1: 100.00| WTP: 0,1,0.096153846,515,0,0,0,300,100,-1335401807,865227006,11176.59618,776571997.5,77657199.75,2,83612,3494,647,1857,1210,647,83612,1210,1857,115.4037433,1.529411765,4.743315508,33558.27807,600.7433155,6.529411765,98567.06684,0.285799847,0.006532813,7.28688E-05,0.651588584,0.022210262,50,8
D:1| T0: 0.10| T1: 515.00| I0: 300.00| I1: 100.00| WTP: 0,1,0.096153846,515,0,0,0,300,100,-8379954434,890479738,10107.31493,7874588687,787458868.7,20,78108,3365,1657,1679,22,1657,78108,22,1679,23.05248619,0.740883978,0.751381215,38029.1989,308.6265193,1.67679558,98676.19724,0.384718724,0.003112632,1.85767E-05,0.013103038,0.021495878,259,89
D:1| T0: 0.10| T1: 515.00| I0: 300.00| I1: 100.00| WTP: 0,1,0.096153846,515,0,0,0,300,100,-4381635252,1017049163,7644.939155,3999388294,399938829.4,30,59401,2600,1270,1270,0,1270,59401,0,1270,22.27175464,0.70042796,0.70042796,63782.44793,150.2168331,1.617689016,99221.73894,0.642129153,0.001513231,1.82196E-05,0,0.021380111,201,45
D:1| T0: 0.10| T1: 515.00| I0: 300.00| I1: 100.00| WTP: 0,1,0.096153846,515,0,0,0,300,100,-6141947929,1707305064,6206.743239,5831610767,583161076.7,28,50565,2183,1031,1031,0,1031,50565,0,1031,13.08033106,0.317916261,0.317916261,68283.56037,128.6669912,0.830087634,99365.14216,0.685143697,0.001301415,1.01353E-05,0,0.020389598,292,66
D:1| T0: 0.10| T1: 515.00| I0: 300.00| I1: 100.00| WTP: 0,1,0.096153846,515,0,0,0,300,100,-1345482937,400145663,11303.97131,780284371.7,78028437.17,2,83824,3616,714,1878,1164,714,83824,1164,1878,132.8621701,1.935483871,5.328445748,29338.54252,658.4252199,7.416422287,98471.60411,0.297454985,0.006624804,7.65575E-05,0.619808307,0.022404085,49,8
D:1| T0: 0.10| T1: 515.00| I0: 300.00| I1: 100.00| WTP: 0,1,0.096153846,515,0,0,0,300,100,-5714663982,1662654181,7922.599461,5318534009,531853400.9,36,62975,2724,1316,1316,0,1316,62975,0,1316,21.5660737,0.621982211,0.621982211,65233.49682,163.792249,1.459974587,99295.38437,0.656193223,0.00164997,1.68218E-05,0,0.020897513,225,60
D:1| T0: 0.10| T1: 515.00| I0: 300.00| I1: 100.00| WTP: 0,1,0.096153846,515,0,0,0,300,100,-5304166210,182136456,9897.892391,4809271590,480927159,22,81216,3622,1448,1644,196,1448,81216,196,1644,39.43299909,1.121239745,1.293527803,38028.34913,255.5496809,2.608933455,98760.74749,0.381609264,0.00258816,2.85321E-05,0.119221411,0.020242317,156,54
D:1| T0: 0.10| T1: 515.00| I0: 300.00| I1: 100.00| WTP: 0,1,0.096153846,515,0,0,0,300,100,-7367219364,979575387,6194.299805,7057504373,705750437.3,30,47959,2136,1029,1029,0,1029,47959,0,1029,11.09779848,0.258679086,0.258679086,70983.98688,136.5728196,0.698983912,99385.28662,0.713751072,0.001374563,8.75428E-06,0,0.021455827,338,80
D:1| T0: 0.10| T1: 515.00| I0: 300.00| I1: 100.00| WTP: 0,1,0.096153846,515,0,0,0,300,100,-5425067021,2142525414,10570.49252,4896542395,489654239.5,14,78200,3424,1673,1756,83,1673,78200,83,1756,33.32474629,1.12802498,1.18891491,38031.56284,238.8961749,2.50273224,98618.56362,0.378530386,0.002435111,2.72622E-05,0.047266515,0.022455243,182,55
D:1| T0: 0.10| T1: 515.00| I0: 300.00| I1: 100.00| WTP: 0,1,0.096153846,515,0,0,0,300,100,-5864848532,1464057597,8941.422425,5417777410,541777741,14,72781,3231,1474,1485,11,1474,72781,11,1485,34.28983051,1.041525424,1.047457627,47956.82119,231.0440678,2.305932203,98954.72458,0.483485824,0.002329965,2.52639E-05,0.007407407,0.020403677,169,61
D:1| T0: 0.10| T1: 515.00| I0: 300.00| I1: 100.00| WTP: 0,1,0.096153846,515,0,0,0,300,100,-4334576991,364562610,9860.807328,3841536625,384153662.5,12,73328,3249,1535,1638,103,1535,73328,103,1638,46.18827508,1.519729425,1.630214205,44445.86809,277.6786922,3.365276212,98795.49605,0.446049255,0.002813769,3.6234E-05,0.062881563,0.022337988,126,43
D:1| T0: 0.10| T1: 515.00| I0: 300.00| I1: 100.00| WTP: 0,1,0.096153846,515,0,0,0,300,100,-4962857734,40350784,10202.35178,4452740145,445274014.5,12,77097,3170,1603,1695,92,1603,77097,92,1695,37.99903568,1.342333655,1.427193828,41948.21119,285.3789778,2.982642237,98736.85632,0.424098382,0.00287761,3.20463E-05,0.054277286,0.021985291,149,50
D:1| T0: 0.10| T1: 515.00| I0: 300.00| I1: 100.00| WTP: 0,1,0.096153846,515,0,0,0,300,100,-6356827177,804064356,8191.855741,5947234390,594723439,30,74953,3447,1360,1360,0,1360,74953,0,1360,34.80859692,0.909975669,0.909975669,51780.65045,175.0583942,1.99594485,99137.92863,0.516263775,0.001782234,2.24291E-05,0,0.018144704,175,67
D:1| T0: 0.10| T1: 515.00| I0: 300.00| I1: 100.00| WTP: 0,1,0.096153846,515,0,0,0,300,100,-5115219097,2125493986,8216.718886,4704383153,470438315.3,36,63993,2718,1365,1365,0,1365,63993,0,1365,21.71875,0.693359375,0.693359375,56455.02799,131.5638021,1.590494792,99062.27214,0.568825157,0.001327459,1.78955E-05,0,0.021330458,220,53
D:1| T0: 0.10| T1: 515.00| I0: 300.00| I1: 100.00| WTP: 0,1,0.096153846,515,0,0,0,300,100,-4746720024,23154253,7708.736841,4361283182,436128318.2,14,68068,3051,1276,1280,4,1276,68068,4,1280,36.0436019,1.000947867,1.004739336,51819.22085,171.749763,2.222748815,99101.2673,0.518146961,0.001744214,2.45696E-05,0.003125,0.018805554,150,49
D:1| T0: 0.10| T1: 515.00| I0: 300.00| I1: 100.00| WTP: 0,1,0.096153846,515,0,0,0,300,100,-3881079369,1391367689,6514.048505,3555376943,355537694.3,22,49476,2189,1082,1082,0,1082,49476,0,1082,22.89991863,0.676159479,0.676159479,69516.93897,135.4141579,1.547599675,99346.13751,0.69675912,0.001374042,1.7834E-05,0,0.021869189,175,40
D:1| T0: 0.10| T1: 515.00| I0: 300.00| I1: 100.00| WTP: 0,1,0.096153846,515,0,0,0,300,100,-8476090797,574142276,8693.189981,8041431298,804143129.8,36,68339,2956,1444,1444,0,1444,68339,0,1444,20.64261931,0.603773585,0.603773585,57868.10821,174.13596,1.403440622,99113.57103,0.582085181,0.001759612,1.61701E-05,0,0.021130573,257,91
D:1| T0: 0.10| T1: 515.00| I0: 300.00| I1: 100.00| WTP: 0,1,0.096153846,515,0,0,0,300,100,-7752193006,898736779,6825.787718,7410903620,741090362,34,51808,2211,1134,1134,0,1134,51808,0,1134,11.13959085,0.271159246,0.271159246,71586.02246,153.6478139,0.720818291,99374.94023,0.717971518,0.001557226,9.20473E-06,0,0.021888511,354,84
D:1| T0: 0.10| T1: 515.00| I0: 300.00| I1: 100.00| WTP: 0,1,0.096153846,515,0,0,0,300,100,-13822302974,346473503,8397.446943,13402430627,1340243063,38,77444,3755,1394,1394,0,1394,77444,0,1394,20.16782912,0.41761116,0.41761116,53369.95902,191.0845684,1.024411508,99164.20052,0.522210211,0.001987993,1.26297E-05,0,0.018000568,318,152
D:1| T0: 0.10| T1: 515.00| I0: 300.00| I1: 100.00| WTP: 0,1,0.096153846,515,0,0,0,300,100,-12189334929,445552282,9252.921564,11726688851,1172668885,42,72662,3146,1537,1537,0,1537,72662,0,1537,17.56768753,0.484243231,0.484243231,56928.07102,184.0803373,1.155348424,99087.2166,0.563187641,0.001901349,1.40746E-05,0,0.021152735,314,133
D:1| T0: 0.10| T1: 515.00| I0: 300.00| I1: 100.00| WTP: 0,1,0.096153846,515,0,0,0,300,100,-1725468550,911758476,10079.82174,1221477463,122147746.3,4,83116,3764,771,1674,903,771,83116,903,1674,92.03300971,1.330097087,3.066019417,31596.79223,452.1961165,4.578640777,98647.88544,0.281813526,0.00480222,5.04463E-05,0.539426523,0.020141253,70,13
D:1| T0: 0.10| T1: 515.00| I0: 300.00| I1: 100.00| WTP: 0,1,0.096153846,515,0,0,0,300,100,-5206772940,1464197940,9634.805815,4725032650,472503265,14,79699,3582,1414,1600,186,1414,79699,186,1600,33.37784299,0.890682318,1.022010271,31809.30888,341.9251651,2.052824652,98637.19589,0.322016602,0.003446983,2.22773E-05,0.11625,0.020075534,195,53
D:1| T0: 0.10| T1: 515.00| I0: 300.00| I1: 100.00| WTP: 0,1,0.096153846,515,0,0,0,300,100,-6715313079,500405854,8607.982179,6284913970,628491397,34,64514,2793,1430,1430,0,1430,64514,0,1430,19.17177243,0.59463895,0.59463895,59397.04814,143.4294311,1.377461707,99102.23523,0.595812931,0.001455936,1.58536E-05,0,0.022166075,260,71
D:1| T0: 0.10| T1: 515.00| I0: 300.00| I1: 100.00| WTP: 0,1,0.096153846,515,0,0,0,300,100,-6729081047,772037341,10478.38105,6205161995,620516199.5,32,76713,3207,1736,1741,5,1736,76713,5,1741,30.63286164,1.13836478,1.141509434,50029.76022,197.9646226,2.514937107,98893.34984,0.504830685,0.001997688,2.75534E-05,0.002871913,0.02269498,182,70
D:1| T0: 0.10| T1: 515.00| I0: 300.00| I1: 100.00| WTP: 0,1,0.096153846,515,0,0,0,300,100,-4608593330,1543158763,5466.038431,4335291409,433529140.9,28,43713,1974,908,908,0,908,43713,0,908,12.12029289,0.307531381,0.307531381,71927.56851,111.250523,0.785041841,99419.56015,0.721332517,0.001126456,9.59638E-06,0,0.020772328,272,49
D:1| T0: 0.10| T1: 515.00| I0: 300.00| I1: 100.00| WTP: 0,1,0.096153846,515,0,0,0,300,100,-3718763033,1604932531,11501.31507,3143697280,314369728,16,82874,3423,1399,1911,512,1399,82874,512,1911,53.40948814,1.533083645,2.163545568,36522.63046,304.0224719,3.895131086,98561.16479,0.35693904,0.003129992,4.2549E-05,0.268062827,0.023047035,113,35
D:1| T0: 0.10| T1: 515.00| I0: 300.00| I1: 100.00| WTP: 0,1,0.096153846,515,0,0,0,300,100,-8225210597,539051477,10468.47836,7701786679,770178667.9,22,79672,3523,1691,1739,48,1691,79672,48,1739,27.19255051,0.886363636,0.912878788,40375.29798,286.7474747,1.971590909,98707.17803,0.396393872,0.002950896,2.22667E-05,0.02760207,0.021827265,222,87
D:1| T0: 0.10| T1: 515.00| I0: 300.00| I1: 100.00| WTP: 0,1,0.096153846,515,0,0,0,300,100,-3462215838,1743124675,6845.259715,3119952852,311995285.2,24,53560,2357,1137,1137,0,1137,53560,0,1137,21.88455882,0.638970588,0.638970588,68799.03235,133.3676471,1.468382353,99350.27279,0.690747672,0.00134761,1.68657E-05,0,0.021228529,194,35
D:1| T0: 0.10| T1: 515.00| I0: 300.00| I1: 100.00| WTP: 0,1,0.096153846,515,0,0,0,300,100,-12312386315,1965983789,8402.915465,11892240542,1189224054,32,63105,2746,1396,1396,0,1396,63105,0,1396,15.14037433,0.414438503,0.414438503,61597.69385,163.2709447,1.039215686,99167.69875,0.619301513,0.001650145,1.25575E-05,0,0.022122211,320,135
D:1| T0: 0.10| T1: 515.00| I0: 300.00| I1: 100.00| WTP: 0,1,0.096153846,515,0,0,0,300,100,-10269837342,516774280,7903.875733,9874643555,987464355.5,50,62861,2703,1313,1313,0,1313,62861,0,1313,11.94390507,0.296655879,0.296655879,60939.19058,145.2038835,0.769147789,99175.65444,0.613403645,0.001464989,9.50848E-06,0,0.020887355,396,112
D:1| T0: 0.10| T1: 515.00| I0: 300.00| I1: 100.00| WTP: 0,1,0.096153846,515,0,0,0,300,100,-1306194288,86603142,10493.61535,781513521,78151352.1,2,83064,3579,515,1743,1228,515,83064,1228,1743,229.9306931,2.455445545,8.504950495,37292.29208,1066.920792,11.04950495,98757.9604,0.340566859,0.011316743,0.000118645,0.704936854,0.020971781,28,8
D:1| T0: 0.10| T1: 515.00| I0: 300.00| I1: 100.00| WTP: 0,1,0.096153846,515,0,0,0,300,100,-8760504921,1431870609,7578.580603,8381575891,838157589.1,48,58804,2512,1259,1259,0,1259,58804,0,1259,10.85655315,0.259373925,0.259373925,65482.04713,139.2573099,0.693498452,99281.26385,0.658859929,0.001403188,8.71375E-06,0,0.021410472,416,95
D:1| T0: 0.10| T1: 515.00| I0: 300.00| I1: 100.00| WTP: 0,1,0.096153846,515,0,0,0,300,100,-6016017624,1592383984,8490.483558,5591493447,559149344.7,18,68670,3079,1410,1410,0,1410,68670,0,1410,32.22060016,0.932684509,0.932684509,55294.53366,162.5182482,2.077858881,99091.86942,0.556054184,0.001641948,2.30707E-05,0,0.020533283,176,63
D:1| T0: 0.10| T1: 515.00| I0: 300.00| I1: 100.00| WTP: 0,1,0.096153846,515,0,0,0,300,100,-8872605186,1440183867,7893.818266,8477914273,847791427.3,34,64120,2935,1311,1311,0,1311,64120,0,1311,16.15190434,0.414968999,0.414968999,55407.78964,137.2984942,0.995128432,99088.85828,0.558440199,0.001383968,1.16835E-05,0,0.020446039,323,96
D:1| T0: 0.10| T1: 515.00| I0: 300.00| I1: 100.00| WTP: 0,1,0.096153846,515,0,0,0,300,100,-8928018755,1696510588,9016.656628,8477185923,847718592.3,40,68639,2873,1498,1498,0,1498,68639,0,1498,18.98559232,0.59284952,0.59284952,59535.57898,172.7497332,1.392742796,99122.33138,0.599410437,0.001743115,1.61079E-05,0,0.021824963,268,96
D:1| T0: 0.10| T1: 515.00| I0: 300.00| I1: 100.00| WTP: 0,1,0.096153846,515,0,0,0,300,100,-12713478083,895039877,10811.05709,12172925228,1217292523,36,78378,3435,1796,1796,0,1796,78378,0,1796,20.19188192,0.638376384,0.638376384,46072.84271,189.5221402,1.473708487,98771.97694,0.461923901,0.001926477,1.68194E-05,0,0.022915178,308,138
D:1| T0: 0.10| T1: 515.00| I0: 300.00| I1: 100.00| WTP: 0,1,0.096153846,515,0,0,0,300,100,-13816548237,129565953,8696.975632,13381699455,1338169946,48,63966,2746,1445,1445,0,1445,63966,0,1445,12.06513134,0.342929111,0.342929111,60174.96294,161.3688377,0.861820799,99108.64592,0.605998215,0.001628454,1.04789E-05,0,0.022590479,396,152
D:1| T0: 0.10| T1: 515.00| I0: 300.00| I1: 100.00| WTP: 0,1,0.096153846,515,0,0,0,300,100,-6236372761,1902565669,7767.609352,5847992293,584799229.3,34,65527,2944,1290,1290,0,1290,65527,0,1290,23.83641161,0.64116095,0.64116095,61931.08443,165.8271768,1.486147757,99251.36478,0.621934212,0.001676193,1.71742E-05,0,0.019687443,216,66
D:1| T0: 0.10| T1: 515.00| I0: 300.00| I1: 100.00| WTP: 0,1,0.096153846,515,0,0,0,300,100,-10766875661,1984179288,7451.380947,10394306614,1039430661,54,58138,2462,1238,1238,0,1238,58138,0,1238,10.42661035,0.25343189,0.25343189,66348.95776,154.8884196,0.691657867,99306.82717,0.6648099,0.001572187,8.83485E-06,0,0.021294162,403,118
D:1| T0: 0.10| T1: 515.00| I0: 300.00| I1: 100.00| WTP: 0,1,0.096153846,515,0,0,0,300,100,-11153438695,677377223,9518.090739,10677534158,1067753416,24,73534,3216,1581,1581,0,1581,73534,0,1581,18.04179498,0.520457545,0.520457545,44274.21117,261.7641883,1.223933128,98801.31236,0.447471983,0.002639898,1.40157E-05,0,0.021500551,324,121
D:1| T0: 0.10| T1: 515.00| I0: 300.00| I1: 100.00| WTP: 0,1,0.096153846,515,0,0,0,300,100,-14906542388,973583301,9193.784537,14446853161,1444685316,32,73546,3321,1527,1527,0,1527,73546,0,1527,15.47523277,0.383985102,0.383985102,49089.74972,222.5761639,0.954562384,98948.13482,0.494994584,0.002246304,1.14661E-05,0,0.020762516,384,164
D:1| T0: 0.10| T1: 515.00| I0: 300.00| I1: 100.00| WTP: 0,1,0.096153846,515,0,0,0,300,100,-8340729816,781062938,7685.062534,7956476689,795647668.9,38,67498,3119,1276,1276,0,1276,67498,0,1276,16.98833693,0.387041037,0.387041037,53679.95464,133.9896328,0.923542117,99140.54989,0.540630648,0.001350093,1.10897E-05,0,0.018904264,331,90
D:1| T0: 0.10| T1: 515.00| I0: 300.00| I1: 100.00| WTP: 0,1,0.096153846,515,0,0,0,300,100,-18952848791,338783425,9470.177926,18479339895,1847933989,42,74213,3352,1573,1573,0,1573,74213,0,1573,13.40185422,0.324488491,0.324488491,56490.61349,194.1943734,0.823529412,99091.28804,0.567932172,0.001964091,1.01601E-05,0,0.021195747,446,210
D:1| T0: 0.10| T1: 515.00| I0: 300.00| I1: 125.00| WTP: 0,1,0.096153846,515,0,0,0,300,125,-6212104821,1178568022,7541.124537,5835048594,583504859.4,36,57692,2361,1253,1253,0,1253,57692,0,1253,14.86147412,0.450078411,0.450078411,66257.49085,155.6414009,1.102456874,99273.10193,0.666690769,0.001568033,1.31755E-05,0,0.021718783,273,66
D:1| T0: 0.10| T1: 515.00| I0: 300.00| I1: 125.00| WTP: 0,1,0.096153846,515,0,0,0,300,125,-6602047146,2029998696,9567.573739,6123668459,612366845.9,26,77647,3455,1581,1589,8,1581,77647,8,1589,39.09454545,1.240909091,1.248181818,45316.33091,238.2618182,2.67,98900.03,0.452371252,0.002423695,2.92884E-05,0.005034613,0.0204652,156,69
D:1| T0: 0.10| T1: 515.00| I0: 300.00| I1: 125.00| WTP: 0,1,0.096153846,515,0,0,0,300,125,-4495089620,776062361,11225.53606,3933812817,393381281.7,10,80491,3433,1605,1865,260,1605,80491,260,1865,38.07530648,1.220665499,1.441330998,36409.18389,435.3677758,2.84938704,98547.27233,0.354244034,0.004490806,3.13333E-05,0.139410188,0.02317058,159,44
D:1| T0: 0.10| T1: 515.00| I0: 300.00| I1: 125.00| WTP: 0,1,0.096153846,515,0,0,0,300,125,-8413689701,1813046880,7668.46183,8030266609,803026660.9,44,57858,2527,1274,1274,0,1274,57858,0,1274,13.63308403,0.354157501,0.354157501,65864.65728,162.1663,0.920369556,99258.56005,0.662868391,0.001633873,1.12768E-05,0,0.022019427,325,91
D:1| T0: 0.10| T1: 515.00| I0: 300.00| I1: 125.00| WTP: 0,1,0.096153846,515,0,0,0,300,125,-5261176443,2032407216,7527.724781,4884790203,488479020.3,32,64430,2929,1250,1250,0,1250,64430,0,1250,25.94146685,0.677009873,0.677009873,61271.01269,158.432299,1.556417489,99266.26728,0.612901681,0.001610204,1.78927E-05,0,0.0194009,201,55
D:1| T0: 0.10| T1: 515.00| I0: 300.00| I1: 125.00| WTP: 0,1,0.096153846,515,0,0,0,300,125,-5733905180,1507873352,6890.041775,5389403091,538940309.1,36,49541,2023,1145,1145,0,1145,49541,0,1145,9.975369458,0.283251232,0.283251232,72498.45484,146.5069787,0.761083744,99366.92241,0.726977261,0.001486385,9.52123E-06,0,0.02311217,345,61
D:1| T0: 0.10| T1: 515.00| I0: 300.00| I1: 125.00| WTP: 0,1,0.096153846,515,0,0,0,300,125,-3434598153,1855899401,6357.71884,3116712211,311671221.1,20,51135,2290,1056,1056,0,1056,51135,0,1056,22.84232026,0.639705882,0.639705882,70737.35458,155.4828431,1.510620915,99408.10458,0.710828449,0.001565557,1.73464E-05,0,0.020651621,175,35
D:1| T0: 0.10| T1: 515.00| I0: 300.00| I1: 125.00| WTP: 0,1,0.096153846,515,0,0,0,300,125,-7104784932,1819459251,9235.075457,6643031159,664303115.9,28,71957,3110,1534,1534,0,1534,71957,0,1534,28.66374909,0.905908096,0.905908096,53763.88111,188.3865791,2.023340627,99043.40627,0.541863446,0.001899098,2.25343E-05,0,0.02131888,196,75
D:1| T0: 0.10| T1: 515.00| I0: 300.00| I1: 125.00| WTP: 0,1,0.096153846,515,0,0,0,300,125,-3059120154,909791748,7482.95751,2684972279,268497227.9,24,55426,2491,1243,1243,0,1243,55426,0,1243,24.71170463,0.783189317,0.783189317,66787.64101,140.197172,1.761979576,99282.80754,0.671957752,0.001411802,1.96352E-05,0,0.022427917,182,30
D:1| T0: 0.10| T1: 515.00| I0: 300.00| I1: 125.00| WTP: 0,1,0.096153846,515,0,0,0,300,125,-6212291264,1339092841,9029.070584,5760837734,576083773.4,24,66134,2802,1500,1500,0,1500,66134,0,1500,29.16029292,1.007323027,1.007323027,58895.59317,194.8413344,2.220504475,99084.57771,0.593585418,0.001963894,2.45744E-05,0,0.022681223,176,65
D:1| T0: 0.10| T1: 515.00| I0: 300.00| I1: 125.00| WTP: 0,1,0.096153846,515,0,0,0,300,125,-6217909147,1365866345,10583.61589,5688728353,568872835.3,26,82817,3584,1742,1758,16,1742,82817,16,1758,40.40180995,1.370135747,1.386425339,46563.88688,234.8298643,2.943891403,98867.99819,0.444583311,0.002481595,3.34385E-05,0.009101251,0.021227782,151,64
D:1| T0: 0.10| T1: 515.00| I0: 300.00| I1: 125.00| WTP: 0,1,0.096153846,515,0,0,0,300,125,-10153115584,825453433,8850.543733,9710588398,971058839.8,32,70902,3158,1470,1470,0,1470,70902,0,1470,21.66447368,0.596491228,0.596491228,54802.69518,198.2006579,1.402960526,99083.22807,0.552153013,0.001997685,1.62289E-05,0,0.020732843,261,110
D:1| T0: 0.10| T1: 515.00| I0: 300.00| I1: 125.00| WTP: 0,1,0.096153846,515,0,0,0,300,125,-6540976416,939711378,10060.61256,6037945788,603794578.8,24,80838,3589,1617,1671,54,1617,80838,54,1671,38.00689655,1.177586207,1.225862069,40483.59569,274.137931,2.635344828,98789.07586,0.409032285,0.002764278,2.8561E-05,0.032315978,0.020670972,166,68
D:1| T0: 0.10| T1: 515.00| I0: 300.00| I1: 125.00| WTP: 0,1,0.096153846,515,0,0,0,300,125,-12493505373,638950699,8345.664432,12076222151,1207622215,44,70661,3167,1386,1386,0,1386,70661,0,1386,17.43882979,0.405585106,0.405585106,58788.28901,198.454344,1.023492908,99199.20922,0.591771721,0.001999962,1.23675E-05,0,0.01961478,323,137
D:1| T0: 0.10| T1: 515.00| I0: 300.00| I1: 125.00| WTP: 0,1,0.096153846,515,0,0,0,300,125,-5246867338,938699148,7310.399343,4881347371,488134737.1,34,63006,2829,1214,1214,0,1214,63006,0,1214,26.00224719,0.701123596,0.701123596,63211.66742,160.0808989,1.605992509,99293.48464,0.629440014,0.001640053,1.86048E-05,0,0.019268312,188,55
D:1| T0: 0.10| T1: 515.00| I0: 300.00| I1: 125.00| WTP: 0,1,0.096153846,515,0,0,0,300,125,-8821943182,121790188,7085.588962,8467663734,846766373.4,44,56840,2558,1177,1177,0,1177,56840,0,1177,10.99248927,0.245350501,0.245350501,64834.82582,147.2274678,0.668812589,99292.15665,0.652274036,0.001482749,8.46599E-06,0,0.020707613,399,96
D:1| T0: 0.10| T1: 515.00| I0: 300.00| I1: 125.00| WTP: 0,1,0.096153846,515,0,0,0,300,125,-6099743574,1331335240,10059.64798,5596761174,559676117.4,16,78778,3388,1560,1671,111,1560,78778,111,1671,31.51152416,0.973234201,1.053531599,37287.67881,388.0126394,2.212639405,98689.62379,0.370978877,0.003949674,2.44443E-05,0.066427289,0.021211775,191,63
D:1| T0: 0.10| T1: 515.00| I0: 300.00| I1: 125.00| WTP: 0,1,0.096153846,515,0,0,0,300,125,-1600416408,470935411,11189.15966,1040958425,104095842.5,2,81563,3470,796,1859,1063,796,81563,1063,1859,96.23026316,1.603070175,3.903508772,32477.86623,463.2214912,5.649122807,98505.36184,0.296268851,0.00488949,6.14923E-05,0.571812803,0.022792197,63,11
D:1| T0: 0.10| T1: 515.00| I0: 300.00| I1: 125.00| WTP: 0,1,0.096153846,515,0,0,0,300,125,-9460532763,823434397,9125.140858,9004275720,900427572,38,67357,2875,1516,1516,0,1516,67357,0,1516,18.01636905,0.551587302,0.551587302,57888.20437,170.3888889,1.302579365,99063.33383,0.583354297,0.001718345,1.51471E-05,0,0.022506941,288,102
D:1| T0: 0.10| T1: 515.00| I0: 300.00| I1: 125.00| WTP: 0,1,0.096153846,515,0,0,0,300,125,-2774168934,493045351,7079.993772,2420169245,242016924.5,22,56782,2485,1176,1176,0,1176,56782,0,1176,27.91084559,0.894301471,0.894301471,64577.73254,131.9246324,1.960477941,99286.65809,0.649066075,0.001330536,2.17653E-05,0,0.020710789,156,27
D:1| T0: 0.10| T1: 515.00| I0: 300.00| I1: 125.00| WTP: 0,1,0.096153846,515,0,0,0,300,125,-9454560870,1700216563,7245.494225,9092286159,909228615.9,30,63621,2925,1203,1203,0,1203,63621,0,1203,21.56199305,0.495365006,0.495365006,62709.34473,199.8192352,1.184820394,99291.58922,0.630869989,0.002011772,1.40159E-05,0,0.018909148,247,103
D:1| T0: 0.10| T1: 515.00| I0: 300.00| I1: 125.00| WTP: 0,1,0.096153846,515,0,0,0,300,125,-4164976482,1744119059,6763.033523,3826824806,382682480.6,24,62358,2764,1123,1123,0,1123,62358,0,1123,31.10234742,0.847887324,0.847887324,60803.94836,162.0910798,1.895774648,99294.19343,0.611771544,0.001631245,2.11881E-05,0,0.01799288,153,43
D:1| T0: 0.10| T1: 515.00| I0: 300.00| I1: 125.00| WTP: 0,1,0.096153846,515,0,0,0,300,125,-10075846690,2036906360,7566.953377,9697499021,969749902.1,44,59205,2625,1257,1257,0,1257,59205,0,1257,12.86307385,0.30738523,0.30738523,64928.0008,164.7576846,0.815568862,99267.05269,0.650812967,0.001671731,1.01684E-05,0,0.021231315,355,110
D:1| T0: 0.10| T1: 515.00| I0: 300.00| I1: 125.00| WTP: 0,1,0.096153846,515,0,0,0,300,125,-10295677198,809704121,8260.905614,9882631917,988263191.7,34,68409,3087,1372,1372,0,1372,68409,0,1372,19.77672956,0.519392034,0.519392034,60531.89413,184.6252621,1.241614256,99201.53564,0.608889214,0.001862749,1.44885E-05,0,0.020055841,272,112
D:1| T0: 0.10| T1: 515.00| I0: 300.00| I1: 125.00| WTP: 0,1,0.096153846,515,0,0,0,300,125,-15823012264,1219866412,9874.411504,15329291689,1532929169,42,80249,3580,1640,1640,0,1640,80249,0,1640,17.03764259,0.453231939,0.453231939,43269.88137,250.8403042,1.069201521,98835.87681,0.436945528,0.002531172,1.25699E-05,0,0.020436646,376,174
D:1| T0: 0.10| T1: 515.00| I0: 300.00| I1: 125.00| WTP: 0,1,0.096153846,515,0,0,0,300,125,-4695022353,843498920,7042.01642,4342921531,434292153.1,34,53601,2234,1170,1170,0,1170,53601,0,1170,15.23953099,0.456728085,0.456728085,67997.75544,143.8486879,1.10720268,99305.1636,0.684122915,0.001448639,1.31348E-05,0,0.021828765,256,49
D:1| T0: 0.10| T1: 515.00| I0: 300.00| I1: 125.00| WTP: 0,1,0.096153846,515,0,0,0,300,125,-12946056105,107351963,10446.63291,12423724459,1242372446,56,71422,2968,1736,1736,0,1736,71422,0,1736,13.87372401,0.4536862,0.4536862,58050.09792,187.3833648,1.111909263,99010.34669,0.584998954,0.001892449,1.32417E-05,0,0.024306236,378,141
D:1| T0: 0.10| T1: 515.00| I0: 300.00| I1: 125.00| WTP: 0,1,0.096153846,515,0,0,0,300,125,-13124991857,773789021,8747.349994,12687624358,1268762436,52,71478,2984,1453,1453,0,1453,71478,0,1453,14.63913547,0.370127364,0.370127364,57793.16017,187.4469317,0.919722115,99149.30838,0.581584179,0.001891403,1.13022E-05,0,0.020327933,370,144
D:1| T0: 0.10| T1: 515.00| I0: 300.00| I1: 125.00| WTP: 0,1,0.096153846,515,0,0,0,300,125,-9439351476,850936611,8799.224239,8999390265,899939026.5,40,66021,2775,1462,1462,0,1462,66021,0,1462,16.68915542,0.531734133,0.531734133,57873.16142,174.5792104,1.269365317,99079.12744,0.580220983,0.001772587,1.48166E-05,0,0.022129322,284,102
D:1| T0: 0.10| T1: 515.00| I0: 300.00| I1: 125.00| WTP: 0,1,0.096153846,515,0,0,0,300,125,-7595384169,1701318364,8615.04155,7164632091,716463209.1,36,68622,2959,1431,1431,0,1431,68622,0,1431,22.68773006,0.676687117,0.676687117,56802.28282,177.3325153,1.547239264,99096.64785,0.569152472,0.001800967,1.78049E-05,0,0.020853371,232,81
D:1| T0: 0.10| T1: 515.00| I0: 300.00| I1: 125.00| WTP: 0,1,0.096153846,515,0,0,0,300,125,-9318187102,778708269,6615.197282,8987427238,898742723.8,40,52869,2284,1099,1099,0,1099,52869,0,1099,11.15429043,0.273514851,0.273514851,70567.97442,167.3176568,0.725247525,99402.38573,0.708973501,0.001686125,9.12528E-06,0,0.020787229,346,102
D:1| T0: 0.10| T1: 515.00| I0: 300.00| I1: 125.00| WTP: 0,1,0.096153846,515,0,0,0,300,125,-4592595705,1391938506,8371.439853,4174023712,417402371.2,32,58269,2454,1391,1391,0,1391,58269,0,1391,22.58906135,0.810051737,0.810051737,63843.52106,153.0672579,1.837398374,99147.1833,0.643176775,0.001542684,2.06903E-05,0,0.023872042,194,47
D:1| T0: 0.10| T1: 515.00| I0: 300.00| I1: 125.00| WTP: 0,1,0.096153846,515,0,0,0,300,125,-4886384034,43418681,5783.997867,4597184141,459718414.1,30,45500,1893,961,961,0,961,45500,0,961,14.20075997,0.3989867,0.3989867,75704.28626,161.8752375,1.019632679,99496.10386,0.760446303,0.001628055,1.22232E-05,0,0.021120879,226,52
D:1| T0: 0.10| T1: 515.00| I0: 300.00| I1: 125.00| WTP: 0,1,0.096153846,515,0,0,0,300,125,-4023252793,817384966,10682.92749,3489106419,348910641.9,24,78803,3197,1496,1775,279,1496,78803,279,1775,40.82716049,1.349794239,1.62962963,38527.93416,221.8364198,3.159465021,98636.5751,0.388042148,0.002244785,3.40393E-05,0.157183099,0.022524809,139,39
D:1| T0: 0.10| T1: 515.00| I0: 300.00| I1: 125.00| WTP: 0,1,0.096153846,515,0,0,0,300,125,-5745412823,762053968,9987.568825,5246034382,524603438.2,28,78559,3435,1634,1659,25,1634,78559,25,1659,36.8558952,1.212227074,1.233187773,46018.25153,213.8331878,2.664628821,98878.21921,0.463517727,0.002160388,2.9027E-05,0.015069319,0.021117886,164,59
D:1| T0: 0.10| T1: 515.00| I0: 300.00| I1: 125.00| WTP: 0,1,0.096153846,515,0,0,0,300,125,-11081473282,1692506311,8230.307491,10669957908,1066995791,48,66926,3029,1367,1367,0,1367,66926,0,1367,15.23320972,0.374948496,0.374948496,60218.88669,183.1920066,0.940255459,99206.37742,0.603672646,0.00185723,1.14083E-05,0,0.020425545,344,121
D:1| T0: 0.10| T1: 515.00| I0: 300.00| I1: 125.00| WTP: 0,1,0.096153846,515,0,0,0,300,125,-4053990533,1037620300,6507.313749,3728624846,372862484.6,24,50983,2150,1081,1081,0,1081,50983,0,1081,16.48381185,0.473427001,0.473427001,69559.38852,130.0458155,1.135613928,99363.24557,0.68956444,0.001351822,1.37058E-05,0,0.021203146,227,42
D:1| T0: 0.10| T1: 515.00| I0: 300.00| I1: 125.00| WTP: 0,1,0.096153846,515,0,0,0,300,125,-5345714575,301400999,7656.738341,4962877658,496287765.8,34,56832,2468,1272,1272,0,1272,56832,0,1272,19.72733078,0.616219668,0.616219668,64940.99425,150.5977011,1.41954023,99231.29438,0.653740244,0.001516933,1.63387E-05,0,0.022382151,224,56
D:1| T0: 0.10| T1: 515.00| I0: 300.00| I1: 125.00| WTP: 0,1,0.096153846,515,0,0,0,300,125,-8999204571,1868336855,10197.77709,8489315716,848931571.6,28,78289,3459,1694,1694,0,1694,78289,0,1694,28.75440977,0.928765265,0.928765265,50262.93623,206.7767978,2.07734057,98927.29851,0.506981252,0.002086735,2.31657E-05,0,0.021638054,211,96
D:1| T0: 0.10| T1: 515.00| I0: 300.00| I1: 125.00| WTP: 0,1,0.096153846,515,0,0,0,300,125,-8911791536,1868498144,10245.11492,8399535790,839953579,30,76687,3327,1702,1702,0,1702,76687,0,1702,24.71394231,0.811899038,0.811899038,48449.14483,191.3449519,1.831730769,98870.79567,0.488945957,0.001931058,2.062E-05,0,0.022194114,238,95
D:1| T0: 0.10| T1: 515.00| I0: 300.00| I1: 125.00| WTP: 0,1,0.096153846,515,0,0,0,300,125,-7243678675,2101566889,7120.985049,6887629423,688762942.3,34,54284,2408,1183,1183,0,1183,54284,0,1183,13.58746492,0.377455566,0.377455566,65324.058,142.9728718,0.933582788,99237.34331,0.657630866,0.001440318,1.1127E-05,0,0.021792793,306,78
D:1| T0: 0.10| T1: 515.00| I0: 300.00| I1: 125.00| WTP: 0,1,0.096153846,515,0,0,0,300,125,-2532377021,1665097450,10576.16473,2003568784,200356878.4,8,81026,3478,1055,1757,702,1055,81026,702,1757,70.09165303,1.551554828,2.67594108,36507.72013,454.7643208,4.40589198,98653.5892,0.330708167,0.004859593,4.91966E-05,0.399544678,0.021684398,83,22
D:1| T0: 0.10| T1: 515.00| I0: 300.00| I1: 125.00| WTP: 0,1,0.096153846,515,0,0,0,300,125,-3451854283,1716179948,9539.620857,2974873240,297487324,10,82951,3840,1309,1584,275,1309,82951,275,1584,54.4124424,1.339861751,1.641705069,30874.29608,327.812212,3.158986175,98705.92281,0.312276141,0.003301834,3.35633E-05,0.173611111,0.019095611,124,33
D:1| T0: 0.10| T1: 515.00| I0: 300.00| I1: 125.00| WTP: 0,1,0.096153846,515,0,0,0,300,125,-3917683310,1560278715,7376.722969,3548847161,354884716.1,24,50304,1969,1226,1226,0,1226,50304,0,1226,15.99193006,0.638870208,0.638870208,66771.12441,115.0880968,1.455279085,99203.87559,0.668169523,0.001174458,1.67945E-05,0,0.024373273,209,40
D:1| T0: 0.10| T1: 515.00| I0: 300.00| I1: 125.00| WTP: 0,1,0.096153846,515,0,0,0,300,125,-11828440161,991019385,10731.4746,11291866431,1129186643,40,78126,3386,1782,1783,1,1782,78126,1,1783,20.99384615,0.704615385,0.705128205,45923.38103,236.4994872,1.632307692,98797.67538,0.46386715,0.002386915,1.84371E-05,0.000560852,0.022822108,279,128
D:1| T0: 0.10| T1: 515.00| I0: 300.00| I1: 125.00| WTP: 0,1,0.096153846,515,0,0,0,300,125,-6754900377,118052103,9264.864212,6291657167,629165716.7,18,73050,3129,1501,1539,38,1501,73050,38,1539,30.49095201,0.983477577,1.011801731,46152.12038,290.1620771,2.20220299,98871.88592,0.457453862,0.002970901,2.447E-05,0.024691358,0.02106805,179,71
D:1| T0: 0.10| T1: 515.00| I0: 300.00| I1: 125.00| WTP: 0,1,0.096153846,515,0,0,0,300,125,-4873419857,1209758844,10195.92555,4363623580,436362358,16,73627,3043,1664,1694,30,1664,73627,30,1694,42.92178771,1.642458101,1.673743017,49018.55866,240.5217877,3.535195531,98839.10838,0.479887089,0.002497767,3.89279E-05,0.017709563,0.023007864,125,49
D:1| T0: 0.10| T1: 515.00| I0: 300.00| I1: 125.00| WTP: 0,1,0.096153846,515,0,0,0,300,125,-7007334131,70671723,7602.212784,6627223492,662722349.2,42,56624,2450,1263,1263,0,1263,56624,0,1263,11.89778469,0.313641663,0.313641663,63814.09988,136.4018655,0.804508356,99196.89234,0.642029079,0.001376845,9.89126E-06,0,0.02230503,367,75
D:1| T0: 0.10| T1: 515.00| I0: 300.00| I1: 125.00| WTP: 0,1,0.096153846,515,0,0,0,300,125,-5893114422,1722612191,6376.755041,5574276670,557427667,28,52832,2424,1059,1059,0,1059,52832,0,1059,17.02254791,0.398534386,0.398534386,70528.86979,164.0574972,1.002254791,99426.53551,0.708435586,0.001652354,1.20094E-05,0,0.02004467,253,63
D:1| T0: 0.10| T1: 515.00| I0: 300.00| I1: 125.00| WTP: 0,1,0.096153846,515,0,0,0,300,125,-3939370309,1968291596,5931.362378,3642802190,364280219,22,48684,2320,985,985,0,985,48684,0,985,19.89929577,0.499295775,0.499295775,69907.75704,136.8316901,1.207746479,99402.09648,0.700454168,0.001387197,1.40407E-05,0,0.02023252,202,41
D:1| T0: 0.10| T1: 515.00| I0: 300.00| I1: 125.00| WTP: 0,1,0.096153846,515,0,0,0,300,125,-3896918030,1877569084,11490.47461,3322394299,332239429.9,14,82830,3484,1483,1909,426,1483,82830,426,1909,58.75984252,1.744094488,2.288713911,36568.79659,347.1981627,4.251968504,98577.15354,0.361801005,0.003548678,4.5505E-05,0.223153483,0.023047205,108,37
D:1| T0: 0.10| T1: 515.00| I0: 300.00| I1: 125.00| WTP: 0,1,0.096153846,515,0,0,0,300,125,-2708500110,1726322189,10564.71523,2180264348,218026434.8,6,81226,3498,1293,1755,462,1293,81226,462,1755,72.36333333,1.976666667,2.721666667,35685.93,459.9183333,4.888333333,98643.77333,0.354518775,0.004679418,5.16978E-05,0.263247863,0.021606382,85,24
D:1| T0: 0.10| T1: 515.00| I0: 300.00| I1: 125.00| WTP: 0,1,0.096153846,515,0,0,0,300,125,-6700985311,307848836,9878.478504,6207061386,620706138.6,24,75886,3250,1638,1641,3,1638,75886,3,1641,34.26105442,1.192176871,1.194727891,45581.90731,226.335034,2.578231293,98858.04167,0.460229177,0.002281879,2.80892E-05,0.001828154,0.021624542,168,70
D:1| T0: 0.10| T1: 515.00| I0: 300.00| I1: 125.00| WTP: 0,1,0.096153846,515,0,0,0,300,125,-1653749366,1154000220,10427.68746,1132364994,113236499.4,4,83824,3795,873,1732,859,873,83824,859,1732,94.7602459,1.62295082,3.370901639,27934.66189,447.3565574,5.153688525,98552.71107,0.283078491,0.004502355,5.37718E-05,0.496244945,0.020651149,70,12
D:1| T0: 0.10| T1: 515.00| I0: 300.00| I1: 125.00| WTP: 0,1,0.096153846,515,0,0,0,300,125,-5385702820,2028661055,6772.720781,5047066780,504706678,34,53526,2340,1125,1125,0,1125,53526,0,1125,17.70018171,0.470623864,0.470623864,70662.67959,169.3337371,1.149606299,99394.68928,0.710348641,0.001704336,1.36969E-05,0,0.021017823,236,57
D:1| T0: 0.10| T1: 515.00| I0: 300.00| I1: 125.00| WTP: 0,1,0.096153846,515,0,0,0,300,125,-12559681158,1629114640,9590.150557,12080173630,1208017363,42,75704,3274,1593,1593,0,1593,75704,0,1593,19.06836028,0.514549654,0.514549654,55496.32517,216.5053118,1.262355658,99087.67667,0.559009811,0.002183671,1.48273E-05,0,0.021042481,310,137
D:1| T0: 0.10| T1: 515.00| I0: 300.00| I1: 125.00| WTP: 0,1,0.096153846,515,0,0,0,300,125,-4229875711,1439048174,11130.22252,3673364585,367336458.5,14,82860,3665,1479,1849,370,1479,82860,370,1849,49.84734513,1.44800885,1.845132743,34363.81748,389.5619469,3.501106195,98552.74226,0.345832799,0.003943127,3.72529E-05,0.200108167,0.022314748,129,41
D:1| T0: 0.10| T1: 515.00| I0: 300.00| I1: 125.00| WTP: 0,1,0.096153846,515,0,0,0,300,125,-1335401807,865227006,11176.59618,776571997.5,77657199.75,2,83612,3494,647,1857,1210,647,83612,1210,1857,115.4037433,1.529411765,4.743315508,33558.27807,600.7433155,6.529411765,98567.06684,0.285799847,0.006532813,7.28688E-05,0.651588584,0.022210262,50,8
D:1| T0: 0.10| T1: 515.00| I0: 300.00| I1: 125.00| WTP: 0,1,0.096153846,515,0,0,0,300,125,-7757391702,890479738,9909.438193,7261919793,726191979.3,20,77580,3390,1624,1646,22,1624,77580,22,1646,29.60251924,0.933519944,0.946815955,40926.0147,388.6354094,2.093072078,98759.41638,0.413673871,0.0039178,2.30568E-05,0.013365735,0.021216808,205,82
D:1| T0: 0.10| T1: 515.00| I0: 300.00| I1: 125.00| WTP: 0,1,0.096153846,515,0,0,0,300,125,-4285864564,1017049163,7459.141229,3912907502,391290750.2,30,60170,2621,1239,1239,0,1239,60170,0,1239,22.11732229,0.652864044,0.652864044,62630.34714,147.5120773,1.507936508,99222.79917,0.630516565,0.001486092,1.71961E-05,0,0.020591657,207,44
D:1| T0: 0.10| T1: 515.00| I0: 300.00| I1: 125.00| WTP: 0,1,0.096153846,515,0,0,0,300,125,-5796480951,1707305064,6226.126,5485174651,548517465.1,30,52208,2373,1034,1034,0,1034,52208,0,1034,15.03222506,0.343222506,0.343222506,67527.97903,140.8040921,0.873657289,99368.02558,0.677373937,0.001424269,1.06821E-05,0,0.019806153,278,62
D:1| T0: 0.10| T1: 515.00| I0: 300.00| I1: 125.00| WTP: 0,1,0.096153846,515,0,0,0,300,125,-1345482937,400145663,11303.97131,780284371.7,78028437.17,2,83824,3616,714,1878,1164,714,83824,1164,1878,132.8621701,1.935483871,5.328445748,29338.54252,658.4252199,7.416422287,98471.60411,0.297454985,0.006624804,7.65575E-05,0.619808307,0.022404085,49,8
D:1| T0: 0.10| T1: 515.00| I0: 300.00| I1: 125.00| WTP: 0,1,0.096153846,515,0,0,0,300,125,-5346886521,1662654181,7615.697059,4966101668,496610166.8,38,62321,2669,1265,1265,0,1265,62321,0,1265,20.99171975,0.585987261,0.585987261,63899.83567,162.1089172,1.396178344,99294.3949,0.642760747,0.001632453,1.62069E-05,0,0.020298134,225,56
D:1| T0: 0.10| T1: 515.00| I0: 300.00| I1: 125.00| WTP: 0,1,0.096153846,515,0,0,0,300,125,-4892458451,182136456,10343.72815,4375272043,437527204.3,22,83305,3750,1522,1718,196,1522,83305,196,1718,50.02409639,1.445783133,1.65279299,39989.42607,315.7097481,3.318729463,98793.47974,0.400780683,0.003200185,3.59635E-05,0.114086147,0.020623259,130,49
D:1| T0: 0.10| T1: 515.00| I0: 300.00| I1: 125.00| WTP: 0,1,0.096153846,515,0,0,0,300,125,-6844620105,979575387,6195.397272,6534850241,653485024.1,32,48727,2240,1029,1029,0,1029,48727,0,1029,12.37186813,0.284835165,0.284835165,69759.50418,144.4457143,0.734065934,99363.45407,0.701565,0.001453833,9.08891E-06,0,0.021117656,325,74
D:1| T0: 0.10| T1: 515.00| I0: 300.00| I1: 125.00| WTP: 0,1,0.096153846,515,0,0,0,300,125,-5153887431,2142525414,10420.13756,4632880553,463288055.3,16,78153,3417,1648,1731,83,1648,78153,83,1731,40.77895753,1.396718147,1.472007722,40712.11873,295.5376448,3.07046332,98691.67085,0.404148144,0.003018593,3.3288E-05,0.047949162,0.022148862,147,52
D:1| T0: 0.10| T1: 515.00| I0: 300.00| I1: 125.00| WTP: 0,1,0.096153846,515,0,0,0,300,125,-5534032710,1464057597,9325.986786,5067733371,506773337.1,16,74500,3217,1538,1549,11,1538,74500,11,1549,35.37075718,1.130548303,1.136640557,46833.60574,244.0600522,2.483028721,98919.24717,0.472190066,0.002461843,2.70766E-05,0.007101356,0.020791946,164,57
D:1| T0: 0.10| T1: 515.00| I0: 300.00| I1: 125.00| WTP: 0,1,0.096153846,515,0,0,0,300,125,-4169678341,364562610,10053.2616,3667015261,366701526.1,12,75668,3324,1567,1670,103,1567,75668,103,1670,50.17375456,1.708383961,1.82746051,44347.54192,309.9513973,3.729040097,98798.76671,0.444697446,0.003142522,3.986E-05,0.061676647,0.022071262,117,41
D:1| T0: 0.10| T1: 515.00| I0: 300.00| I1: 125.00| WTP: 0,1,0.096153846,515,0,0,0,300,125,-4867876725,40350784,10046.36787,4365558331,436555833.1,14,75287,3241,1577,1669,92,1577,75287,92,1669,39.76352705,1.394789579,1.482965932,42141.6493,289.1723447,3.067134269,98733.37976,0.426061756,0.002915166,3.27679E-05,0.055122828,0.022168502,143,49
D:1| T0: 0.10| T1: 515.00| I0: 300.00| I1: 125.00| WTP: 0,1,0.096153846,515,0,0,0,300,125,-5686781143,804064356,8775.052099,5248028538,524802853.8,28,77473,3577,1447,1457,10,1447,77473,10,1457,39.61462094,1.090252708,1.101083032,51080.75542,201.8564982,2.407039711,99089.29603,0.50871379,0.002057947,2.6691E-05,0.006863418,0.018806552,157,59
D:1| T0: 0.10| T1: 515.00| I0: 300.00| I1: 125.00| WTP: 0,1,0.096153846,515,0,0,0,300,125,-4798771921,2125493986,8824.577607,4357543041,435754304.1,34,66248,2802,1466,1466,0,1466,66248,0,1466,29.51585977,1.005843072,1.005843072,60308.55676,174.3405676,2.230383973,99137.36311,0.607087566,0.001758777,2.46547E-05,0,0.02212897,171,49
D:1| T0: 0.10| T1: 515.00| I0: 300.00| I1: 125.00| WTP: 0,1,0.096153846,515,0,0,0,300,125,-4680761403,23154253,8105.707928,4275476006,427547600.6,16,69399,3209,1342,1346,4,1342,69399,4,1346,42.47001091,1.231188659,1.235550709,53891.14286,202.0501636,2.706652126,99122.71865,0.538440863,0.002054367,2.97711E-05,0.002973978,0.019381521,130,48
D:1| T0: 0.10| T1: 515.00| I0: 300.00| I1: 125.00| WTP: 0,1,0.096153846,515,0,0,0,300,125,-3749086029,1391367689,7325.707323,3382800663,338280066.3,24,53391,2331,1217,1217,0,1217,53391,0,1217,23.66907631,0.774297189,0.774297189,67994.98635,144.5686747,1.746184739,99273.33655,0.681724936,0.0014677,1.9813E-05,0,0.022794104,177,38
D:1| T0: 0.10| T1: 515.00| I0: 300.00| I1: 125.00| WTP: 0,1,0.096153846,515,0,0,0,300,125,-7782166403,574142276,8831.443994,7340594203,734059420.3,36,68347,2964,1467,1467,0,1467,68347,0,1467,23.8138942,0.708731676,0.708731676,59733.89356,198.7539834,1.643722116,99136.38432,0.600646586,0.002008732,1.88741E-05,0,0.021464314,224,83
D:1| T0: 0.10| T1: 515.00| I0: 300.00| I1: 125.00| WTP: 0,1,0.096153846,515,0,0,0,300,125,-7217527238,898736779,6698.883831,6882583047,688258304.7,38,49168,2149,1113,1113,0,1113,49168,0,1113,10.02669718,0.254767353,0.254767353,69655.82418,138.1273837,0.682684973,99329.63654,0.69885315,0.001399233,8.58633E-06,0,0.022636674,373,78
D:1| T0: 0.10| T1: 515.00| I0: 300.00| I1: 125.00| WTP: 0,1,0.096153846,515,0,0,0,300,125,-11965886595,346473503,8120.595323,11559856829,1155985683,40,77007,3653,1348,1348,0,1348,77007,0,1348,22.14425908,0.465161923,0.465161923,52597.77821,214.624632,1.131010795,99185.31992,0.512077746,0.002240819,1.37992E-05,0,0.017505584,281,131
D:1| T0: 0.10| T1: 515.00| I0: 300.00| I1: 125.00| WTP: 0,1,0.096153846,515,0,0,0,300,125,-11599986930,445552282,9768.893073,11111542277,1111154228,46,73397,3132,1623,1623,0,1623,73397,0,1623,18.03621825,0.555503293,0.555503293,56801.22342,197.4021637,1.320790216,99041.88758,0.561472645,0.002042524,1.57791E-05,0,0.02211262,296,126
D:1| T0: 0.10| T1: 515.00| I0: 300.00| I1: 125.00| WTP: 0,1,0.096153846,515,0,0,0,300,125,-1642291793,911758476,10146.27111,1134978237,113497823.7,4,83127,3793,782,1685,903,782,83127,903,1685,90.01498127,1.31835206,2.992509363,30586.8839,435.7284644,4.47752809,98625.06554,0.272524803,0.004618782,4.9E-05,0.535905045,0.020270189,73,12
D:1| T0: 0.10| T1: 515.00| I0: 300.00| I1: 125.00| WTP: 0,1,0.096153846,515,0,0,0,300,125,-4674303015,1464197940,9484.960533,4200054989,420005498.9,14,80070,3631,1389,1575,186,1389,80070,186,1575,42.0437557,1.084776664,1.247948952,34000.28897,425.183227,2.516864175,98702.39471,0.343943856,0.004284752,2.72115E-05,0.118095238,0.019670288,157,47
D:1| T0: 0.10| T1: 515.00| I0: 300.00| I1: 125.00| WTP: 0,1,0.096153846,515,0,0,0,300,125,-6265100365,500405854,8397.331578,5845233787,584523378.7,36,61734,2782,1395,1395,0,1395,61734,0,1395,19.75433526,0.624277457,0.624277457,59493.90231,144.0075145,1.421965318,99095.14798,0.596698034,0.001462003,1.63443E-05,0,0.022596948,246,66
D:1| T0: 0.10| T1: 515.00| I0: 300.00| I1: 125.00| WTP: 0,1,0.096153846,515,0,0,0,300,125,-6440922491,772037341,9950.279605,5943408511,594340851.1,34,76932,3257,1648,1653,5,1648,76932,5,1653,33.04805302,1.142502071,1.145816073,50004.16819,208.8889809,2.507870754,98933.90389,0.504421725,0.002107241,2.75539E-05,0.003024803,0.021486508,173,67
D:1| T0: 0.10| T1: 515.00| I0: 300.00| I1: 125.00| WTP: 0,1,0.096153846,515,0,0,0,300,125,-3994344194,1543158763,5371.291229,3725779632,372577963.2,26,45253,2058,892,892,0,892,45253,0,892,14.32089136,0.327019499,0.327019499,71055.40724,121.4506964,0.821169916,99424.96936,0.712328745,0.001229997,1.00447E-05,0,0.019711836,255,42
D:1| T0: 0.10| T1: 515.00| I0: 300.00| I1: 125.00| WTP: 0,1,0.096153846,515,0,0,0,300,125,-3731387999,1604932531,11700.40316,3146367841,314636784.1,18,83713,3486,1432,1944,512,1432,83713,512,1944,58.85391766,1.701195219,2.37184595,37220.89243,327.1022576,4.26560425,98571.39575,0.363223033,0.003371915,4.62283E-05,0.263374486,0.0232222,106,35
D:1| T0: 0.10| T1: 515.00| I0: 300.00| I1: 125.00| WTP: 0,1,0.096153846,515,0,0,0,300,125,-7621766802,539051477,10637.18173,7089907715,708990771.5,22,80354,3531,1719,1767,48,1719,80354,48,1767,27.03310852,0.868179031,0.893930104,38451.99264,281.7204169,1.951563458,98661.06806,0.377017966,0.002897848,2.1969E-05,0.027164686,0.021990741,229,80
D:1| T0: 0.10| T1: 515.00| I0: 300.00| I1: 125.00| WTP: 0,1,0.096153846,515,0,0,0,300,125,-3186610670,1743124675,6616.611188,2855780111,285578011.1,26,52506,2335,1099,1099,0,1099,52506,0,1099,20.81084939,0.573875803,0.573875803,66953.63241,126.9250535,1.366167024,99320.84797,0.672380647,0.001282384,1.58205E-05,0,0.020931739,200,32
D:1| T0: 0.10| T1: 515.00| I0: 300.00| I1: 125.00| WTP: 0,1,0.096153846,515,0,0,0,300,125,-10673688996,1965983789,8848.81276,10231248358,1023124836,32,67179,2906,1470,1470,0,1470,67179,0,1470,17.77810362,0.514662757,0.514662757,60023.26686,190.3558162,1.230205279,99127.93695,0.603398325,0.001924958,1.45114E-05,0,0.021881838,292,116
D:1| T0: 0.10| T1: 515.00| I0: 300.00| I1: 125.00| WTP: 0,1,0.096153846,515,0,0,0,300,125,-9746526590,516774280,7940.16275,9349518453,934951845.3,50,63142,2801,1319,1319,0,1319,63142,0,1319,13.21139489,0.332023576,0.332023576,61648.8778,159.372888,0.853045187,99189.36542,0.62042875,0.001607839,1.04384E-05,0,0.020889424,363,106
D:1| T0: 0.10| T1: 515.00| I0: 300.00| I1: 125.00| WTP: 0,1,0.096153846,515,0,0,0,300,125,-1218850705,86603142,10493.7124,694165085.1,69416508.51,2,83367,3597,515,1743,1228,515,83367,1228,1743,223.1100478,2.373205742,8.220095694,36463.64115,1034.569378,10.67942584,98740.36842,0.333074595,0.010954924,0.000114472,0.704532415,0.020907553,29,7
D:1| T0: 0.10| T1: 515.00| I0: 300.00| I1: 125.00| WTP: 0,1,0.096153846,515,0,0,0,300,125,-8367815173,1431870609,6826.428048,8026493771,802649377.1,54,55734,2426,1134,1134,0,1134,55734,0,1134,10.52652616,0.247093023,0.247093023,64651.03961,139.1304506,0.666061047,99272.71802,0.650584387,0.001401429,8.28525E-06,0,0.020346647,394,91
D:1| T0: 0.10| T1: 515.00| I0: 300.00| I1: 125.00| WTP: 0,1,0.096153846,515,0,0,0,300,125,-6081996963,1592383984,8134.882386,5675252844,567525284.4,22,67456,3020,1351,1351,0,1351,67456,0,1351,33.40482574,1,1,57859.23682,175.1751564,2.204647006,99165.61752,0.581500122,0.001769402,2.43541E-05,0,0.020028167,160,64
D:1| T0: 0.10| T1: 515.00| I0: 300.00| I1: 125.00| WTP: 0,1,0.096153846,515,0,0,0,300,125,-8154495161,1440183867,7587.027012,7775143810,777514381,36,64010,2890,1260,1260,0,1260,64010,0,1260,20.93294118,0.532352941,0.532352941,59747.53529,182.1658824,1.288823529,99210.22824,0.601509086,0.001834699,1.49087E-05,0,0.019684424,243,88
D:1| T0: 0.10| T1: 515.00| I0: 300.00| I1: 125.00| WTP: 0,1,0.096153846,515,0,0,0,300,125,-8486829062,1696510588,8932.979617,8040180081,804018008.1,44,68769,2935,1484,1484,0,1484,68769,0,1484,19.03558346,0.574568289,0.574568289,58187.37886,170.3903715,1.346415489,99096.23182,0.585962063,0.001719363,1.56473E-05,0,0.021579491,273,91
D:1| T0: 0.10| T1: 515.00| I0: 300.00| I1: 125.00| WTP: 0,1,0.096153846,515,0,0,0,300,125,-10858999876,895039877,10570.24581,10330487586,1033048759,34,80088,3445,1756,1756,0,1756,80088,0,1756,22.88745981,0.729903537,0.729903537,46023.54394,224.7240086,1.673097535,98819.40407,0.460604368,0.002285533,1.9121E-05,0,0.021926429,265,117
D:1| T0: 0.10| T1: 515.00| I0: 300.00| I1: 125.00| WTP: 0,1,0.096153846,515,0,0,0,300,125,-12649677262,129565953,9785.873202,12160383602,1216038360,48,70328,2992,1626,1626,0,1626,70328,0,1626,13.98551829,0.419969512,0.419969512,57395.2763,189.1920732,1.041539634,99034.55526,0.578126254,0.001910493,1.24997E-05,0,0.023120237,374,138
D:1| T0: 0.10| T1: 515.00| I0: 300.00| I1: 125.00| WTP: 0,1,0.096153846,515,0,0,0,300,125,-5878532213,1902565669,7629.35485,5497064470,549706447,34,64621,2968,1267,1267,0,1267,64621,0,1267,24.65547945,0.644520548,0.644520548,61601.91644,169.019863,1.52260274,99265.66712,0.618482986,0.001707923,1.75147E-05,0,0.019607236,208,62
D:1| T0: 0.10| T1: 515.00| I0: 300.00| I1: 125.00| WTP: 0,1,0.096153846,515,0,0,0,300,125,-10071530238,1984179288,7500.567314,9696501872,969650187.2,56,58217,2528,1246,1246,0,1246,58217,0,1246,11.39532374,0.26942446,0.26942446,65444.66691,158.6183453,0.710431655,99268.10468,0.655823646,0.001610662,9.0889E-06,0,0.021402683,394,110
D:1| T0: 0.10| T1: 515.00| I0: 300.00| I1: 125.00| WTP: 0,1,0.096153846,515,0,0,0,300,125,-10282821845,677377223,9644.084043,9800617643,980061764.3,26,74241,3245,1602,1602,0,1602,74241,0,1602,18.43265306,0.553741497,0.553741497,43873.37324,271.0267574,1.277097506,98790.61088,0.443417504,0.002733323,1.46412E-05,0,0.021578373,314,111
D:1| T0: 0.10| T1: 515.00| I0: 300.00| I1: 125.00| WTP: 0,1,0.096153846,515,0,0,0,300,125,-14285905970,973583301,9037.882455,13834011847,1383401185,36,73915,3331,1501,1501,0,1501,73915,0,1501,16.48352941,0.399607843,0.399607843,48581.80235,235.2866667,0.992156863,98963.09804,0.48974146,0.002374131,1.18662E-05,0,0.02030711,364,157
D:1| T0: 0.10| T1: 515.00| I0: 300.00| I1: 125.00| WTP: 0,1,0.096153846,515,0,0,0,300,125,-8263569168,781062938,7901.185082,7868509914,786850991.4,42,67630,3178,1312,1312,0,1312,67630,0,1312,20.29025534,0.503387181,0.503387181,56841.3606,161.1073476,1.181865555,99165.87858,0.5723128,0.00162347,1.37569E-05,0,0.019399675,275,89
D:1| T0: 0.10| T1: 515.00| I0: 300.00| I1: 125.00| WTP: 0,1,0.096153846,515,0,0,0,300,125,-18401910986,338783425,8995.260754,17952147948,1795214795,48,73950,3322,1494,1494,0,1494,73950,0,1494,13.0283197,0.282567653,0.282567653,55278.63247,190.7964128,0.758967904,99102.49497,0.555614024,0.001929158,9.49388E-06,0,0.02020284,453,204
D:1| T0: 0.10| T1: 515.00| I0: 350.00| I1: 75.00| WTP: 0,1,0.096153846,515,0,0,0,350,75,-7021367589,1178568022,7878.585525,6627438313,662743831.3,30,59526,2500,1309,1309,0,1309,59526,0,1309,13.89116576,0.410291439,0.410291439,65504.62796,139.7367942,1.00136612,99247.71129,0.659262475,0.001408573,1.19947E-05,0,0.02199076,313,75
D:1| T0: 0.10| T1: 515.00| I0: 350.00| I1: 75.00| WTP: 0,1,0.096153846,515,0,0,0,350,75,-6613153678,2029998696,9718.854395,6127210959,612721095.9,18,80845,3575,1606,1614,8,1606,80845,8,1614,40.0931677,1.212954747,1.220053239,44953.07098,242.2759539,2.642413487,98914.41083,0.448704887,0.002464681,2.90356E-05,0.004956629,0.019964623,160,69
D:1| T0: 0.10| T1: 515.00| I0: 350.00| I1: 75.00| WTP: 0,1,0.096153846,515,0,0,0,350,75,-5012211895,776062361,11110.44502,4456689644,445668964.4,8,77920,3313,1586,1846,260,1586,77920,260,1846,30.92427617,1.023756496,1.210838901,35812.25464,356.2991834,2.394951745,98507.94655,0.350582317,0.003662775,2.61855E-05,0.14084507,0.023691269,188,50
D:1| T0: 0.10| T1: 515.00| I0: 350.00| I1: 75.00| WTP: 0,1,0.096153846,515,0,0,0,350,75,-8934888676,1813046880,7554.732454,8557152054,855715205.4,32,56269,2517,1255,1255,0,1255,56269,0,1255,12.17091049,0.323688272,0.323688272,64249.92284,138.2959105,0.802083333,99194.46721,0.647017532,0.001393958,9.74102E-06,0,0.022303577,371,97
D:1| T0: 0.10| T1: 515.00| I0: 350.00| I1: 75.00| WTP: 0,1,0.096153846,515,0,0,0,350,75,-5710939317,2032407216,7750.054108,5323436612,532343661.2,26,64790,2959,1287,1287,0,1287,64790,0,1287,24.60186418,0.656458056,0.656458056,61265.44341,151.5173103,1.503994674,99253.15779,0.61311049,0.001539366,1.7387E-05,0,0.019865403,213,60
D:1| T0: 0.10| T1: 515.00| I0: 350.00| I1: 75.00| WTP: 0,1,0.096153846,515,0,0,0,350,75,-6280837365,1507873352,7257.266733,5917974029,591797402.9,28,49219,2133,1206,1206,0,1206,49219,0,1206,10.56124539,0.309299467,0.309299467,73583.67718,145.7738632,0.807865629,99362.73372,0.737997955,0.001479238,1.00109E-05,0,0.024502733,346,67
D:1| T0: 0.10| T1: 515.00| I0: 350.00| I1: 75.00| WTP: 0,1,0.096153846,515,0,0,0,350,75,-3787137358,1855899401,6370.183533,3468628181,346862818.1,16,52559,2271,1058,1058,0,1058,52559,0,1058,20.92290909,0.578909091,0.578909091,69578.46473,141.8130909,1.344,99388.83782,0.69928512,0.001428202,1.54708E-05,0,0.020129759,197,39
D:1| T0: 0.10| T1: 515.00| I0: 350.00| I1: 75.00| WTP: 0,1,0.096153846,515,0,0,0,350,75,-7172650518,1819459251,8874.159848,6728942525,672894252.5,20,71685,3067,1474,1474,0,1474,71685,0,1474,28.97507553,0.895015106,0.895015106,55453.71979,193.8791541,2.009063444,99104.20544,0.558641137,0.001954127,2.24141E-05,0,0.020562182,190,76
D:1| T0: 0.10| T1: 515.00| I0: 350.00| I1: 75.00| WTP: 0,1,0.096153846,515,0,0,0,350,75,-3344996423,909791748,6327.530794,3028619884,302861988.4,20,50712,2245,1051,1051,0,1051,50712,0,1051,16.26127709,0.44288225,0.44288225,65429.96954,96.57527827,1.07029877,99284.03749,0.65852689,0.000972959,1.23717E-05,0,0.020724878,244,34
D:1| T0: 0.10| T1: 515.00| I0: 350.00| I1: 75.00| WTP: 0,1,0.096153846,515,0,0,0,350,75,-6737288314,1339092841,9076.012875,6283487670,628348767,18,65043,2723,1508,1508,0,1508,65043,0,1508,22.9640678,0.819661017,0.819661017,57123.50034,158.7362712,1.844067797,99024.90576,0.576076002,0.001600687,2.05887E-05,0,0.023185375,211,71
D:1| T0: 0.10| T1: 515.00| I0: 350.00| I1: 75.00| WTP: 0,1,0.096153846,515,0,0,0,350,75,-6646587643,1365866345,10432.79492,6124947897,612494789.7,20,80435,3465,1715,1733,18,1715,80435,18,1733,31.86090776,1.072474378,1.085651537,43330.71742,184.4062958,2.346998536,98786.42753,0.416025787,0.001931753,2.641E-05,0.010386613,0.021545347,188,69
D:1| T0: 0.10| T1: 515.00| I0: 350.00| I1: 75.00| WTP: 0,1,0.096153846,515,0,0,0,350,75,-10419438576,825453433,8851.638233,9976856664,997685666.4,22,72355,3225,1470,1470,0,1470,72355,0,1470,22.21527778,0.581730769,0.581730769,55209.58814,198.0747863,1.362713675,99101.75641,0.556166532,0.001996683,1.5813E-05,0,0.020316495,268,113
D:1| T0: 0.10| T1: 515.00| I0: 350.00| I1: 75.00| WTP: 0,1,0.096153846,515,0,0,0,350,75,-7409035576,939711378,9904.273221,6913821915,691382191.5,22,80155,3542,1591,1645,54,1591,80155,54,1645,31.47697842,0.971942446,1.012230216,39397.21151,225.952518,2.168345324,98763.5554,0.398160693,0.002279038,2.34583E-05,0.032826748,0.020523761,199,78
D:1| T0: 0.10| T1: 515.00| I0: 350.00| I1: 75.00| WTP: 0,1,0.096153846,515,0,0,0,350,75,-12768005634,638950699,8579.826061,12339014331,1233901433,32,70451,3179,1425,1425,0,1425,70451,0,1425,15.38546169,0.371316306,0.371316306,56388.10373,176.189391,0.925736739,99145.94578,0.567845618,0.001775981,1.12744E-05,0,0.020226824,364,140
D:1| T0: 0.10| T1: 515.00| I0: 350.00| I1: 75.00| WTP: 0,1,0.096153846,515,0,0,0,350,75,-5454140103,938699148,7876.161198,5060332043,506033204.3,24,65527,2981,1308,1308,0,1308,65527,0,1308,27.20237213,0.779095626,0.779095626,63601.21127,164.056338,1.739065975,99265.48629,0.633610031,0.00168136,1.98433E-05,0,0.019961542,190,57
D:1| T0: 0.10| T1: 515.00| I0: 350.00| I1: 75.00| WTP: 0,1,0.096153846,515,0,0,0,350,75,-9850713975,121790188,6617.302568,9519848846,951984884.6,34,55509,2511,1099,1099,0,1099,55509,0,1099,11.47126013,0.234708917,0.234708917,68261.73913,147.4587325,0.641857038,99396.2126,0.686165074,0.00148436,8.14049E-06,0,0.019798591,387,108
D:1| T0: 0.10| T1: 515.00| I0: 350.00| I1: 75.00| WTP: 0,1,0.096153846,515,0,0,0,350,75,-6266877045,1331335240,9915.228435,5771115623,577111562.3,12,77507,3337,1536,1647,111,1536,77507,111,1647,33.31394422,1.044621514,1.130677291,39043.251,408.7139442,2.344223108,98725.45578,0.388378758,0.004162446,2.58215E-05,0.067395264,0.021249968,178,65
D:1| T0: 0.10| T1: 515.00| I0: 350.00| I1: 75.00| WTP: 0,1,0.096153846,515,0,0,0,350,75,-1692567502,470935411,11267.42086,1129196459,112919645.9,2,81933,3478,809,1872,1063,809,81933,1063,1872,93.52219873,1.553911205,3.77167019,32056.34672,448.94926,5.477801268,98496.28118,0.293070121,0.004731398,5.97695E-05,0.56784188,0.022848773,65,12
D:1| T0: 0.10| T1: 515.00| I0: 350.00| I1: 75.00| WTP: 0,1,0.096153846,515,0,0,0,350,75,-9471377505,823434397,9311.822256,9005786392,900578639.2,30,69326,2945,1547,1547,0,1547,69326,0,1547,18.72970247,0.582955119,0.582955119,58328.06657,177.8693898,1.367120524,99075.82148,0.587766347,0.00179416,1.57164E-05,0,0.02231486,284,102
D:1| T0: 0.10| T1: 515.00| I0: 350.00| I1: 75.00| WTP: 0,1,0.096153846,515,0,0,0,350,75,-2922615160,493045351,6527.698779,2596230221,259623022.1,16,57318,2545,1084,1084,0,1084,57318,0,1084,28.43000915,0.801463861,0.801463861,65300.39707,133.1555352,1.776761208,99363.37511,0.655901568,0.001342304,1.99614E-05,0,0.018912035,156,29
D:1| T0: 0.10| T1: 515.00| I0: 350.00| I1: 75.00| WTP: 0,1,0.096153846,515,0,0,0,350,75,-10089788440,1700216563,7689.702959,9705303292,970530329.2,22,65680,3009,1277,1277,0,1277,65680,0,1277,19.19926778,0.472803347,0.472803347,61540.08682,184.9947699,1.135983264,99264.31015,0.619236527,0.001863204,1.34365E-05,0,0.019442753,274,110
D:1| T0: 0.10| T1: 515.00| I0: 350.00| I1: 75.00| WTP: 0,1,0.096153846,515,0,0,0,350,75,-4629414321,1744119059,7291.470988,4264840771,426484077.1,20,59161,2622,1211,1211,0,1211,59161,0,1211,28.76795096,0.847635727,0.847635727,61813.831,143.0008757,1.910683012,99241.98161,0.622224311,0.001439754,2.13187E-05,0,0.020469566,164,48
D:1| T0: 0.10| T1: 515.00| I0: 350.00| I1: 75.00| WTP: 0,1,0.096153846,515,0,0,0,350,75,-11022741494,2036906360,7260.070826,10659737952,1065973795,32,56747,2500,1206,1206,0,1206,56747,0,1206,9.927295918,0.237882653,0.237882653,62694.32334,125.8290816,0.623086735,99216.02423,0.629056555,0.00127527,7.78016E-06,0,0.021252225,445,121
D:1| T0: 0.10| T1: 515.00| I0: 350.00| I1: 75.00| WTP: 0,1,0.096153846,515,0,0,0,350,75,-10737657042,809704121,8333.030954,10321005495,1032100549,26,67059,2985,1384,1384,0,1384,67059,0,1384,18.83175709,0.496266799,0.496266799,60631.42459,171.4494774,1.18964659,99190.74813,0.609950188,0.001729996,1.38809E-05,0,0.020638542,286,117
D:1| T0: 0.10| T1: 515.00| I0: 350.00| I1: 75.00| WTP: 0,1,0.096153846,515,0,0,0,350,75,-13902232179,1219866412,10036.4044,13400411959,1340041196,30,77894,3540,1664,1667,3,1664,77894,3,1667,17.40345369,0.486263736,0.48744113,41199.50942,250.283752,1.149136578,98752.97057,0.416547776,0.002525493,1.31777E-05,0.00179964,0.021400878,364,152
D:1| T0: 0.10| T1: 515.00| I0: 350.00| I1: 75.00| WTP: 0,1,0.096153846,515,0,0,0,350,75,-4885220226,843498920,7241.826082,4523128922,452312892.2,26,55674,2428,1203,1203,0,1203,55674,0,1203,17.52176436,0.506674405,0.506674405,69411.47243,154.6395821,1.201392919,99347.12014,0.698009885,0.001557359,1.40403E-05,0,0.021607932,247,51
D:1| T0: 0.10| T1: 515.00| I0: 350.00| I1: 75.00| WTP: 0,1,0.096153846,515,0,0,0,350,75,-14685558621,107351963,10205.91296,14175262973,1417526297,46,72297,2979,1696,1696,0,1696,72297,0,1696,13.16966581,0.427102461,0.427102461,59944.58575,185.931693,1.048475946,99060.60742,0.603922445,0.001877903,1.25635E-05,0,0.023459113,389,161
D:1| T0: 0.10| T1: 515.00| I0: 350.00| I1: 75.00| WTP: 0,1,0.096153846,515,0,0,0,350,75,-14500419784,773789021,8277.75404,14086532082,1408653208,42,66516,2882,1375,1375,0,1375,66516,0,1375,12.45911296,0.305613306,0.305613306,58382.37076,156.8059598,0.777546778,99144.09563,0.587680901,0.001581995,9.59808E-06,0,0.020671718,412,160
D:1| T0: 0.10| T1: 515.00| I0: 350.00| I1: 75.00| WTP: 0,1,0.096153846,515,0,0,0,350,75,-10709492607,850936611,9551.694755,10231907869,1023190787,32,69883,2917,1587,1587,0,1587,69883,0,1587,18.78240741,0.595164609,0.595164609,60891.31584,190.6512346,1.420781893,99113.60597,0.610594046,0.001937312,1.65686E-05,0,0.022709386,276,116
D:1| T0: 0.10| T1: 515.00| I0: 350.00| I1: 75.00| WTP: 0,1,0.096153846,515,0,0,0,350,75,-8141048655,1701318364,9017.290408,7690184135,769018413.5,28,68456,2997,1498,1498,0,1498,68456,0,1498,21.45662368,0.677022274,0.677022274,57708.88277,169.5820633,1.551582649,99073.24912,0.57862896,0.001722449,1.78089E-05,0,0.021882669,242,87
D:1| T0: 0.10| T1: 515.00| I0: 350.00| I1: 75.00| WTP: 0,1,0.096153846,515,0,0,0,350,75,-9387564569,778708269,6266.599283,9074234605,907423460.5,28,50032,2188,1041,1041,0,1041,50032,0,1041,8.99393531,0.203504043,0.203504043,67935.24326,128.9508086,0.551886792,99334.85613,0.683054611,0.001299615,7.05627E-06,0,0.020806684,424,103
D:1| T0: 0.10| T1: 515.00| I0: 350.00| I1: 75.00| WTP: 0,1,0.096153846,515,0,0,0,350,75,-4967292904,1391938506,8834.173129,4525584248,452558424.8,26,61124,2584,1468,1468,0,1468,61124,0,1468,22.27069834,0.840172786,0.840172786,65035.2887,156.4960403,1.886969042,99181.31893,0.654874223,0.001577728,2.12784E-05,0,0.024017146,199,51
D:1| T0: 0.10| T1: 515.00| I0: 350.00| I1: 75.00| WTP: 0,1,0.096153846,515,0,0,0,350,75,-5090376593,43418681,6212.758121,4779738687,477973868.7,22,49344,2173,1032,1032,0,1032,49344,0,1032,14.2688,0.365866667,0.365866667,72129.7568,148.4629333,0.9104,99422.0848,0.724998314,0.0014941,1.10591E-05,0,0.020914821,268,54
D:1| T0: 0.10| T1: 515.00| I0: 350.00| I1: 75.00| WTP: 0,1,0.096153846,515,0,0,0,350,75,-4043357877,817384966,10990.76664,3493819545,349381954.5,16,80582,3418,1541,1826,285,1541,80582,285,1826,52.68571429,1.710559006,2.055900621,42543.99379,272.5416149,3.962732919,98704.18509,0.428187587,0.002759476,4.23364E-05,0.156164384,0.022648862,115,39
D:1| T0: 0.10| T1: 515.00| I0: 350.00| I1: 75.00| WTP: 0,1,0.096153846,515,0,0,0,350,75,-6178790425,762053968,9808.732188,5688353815,568835381.5,24,81211,3561,1604,1629,25,1604,81211,25,1629,40.06440072,1.219141324,1.240608229,48300.15742,226.9159213,2.682468694,98975.27549,0.486100186,0.002292284,2.91826E-05,0.015346839,0.020058859,160,64
D:1| T0: 0.10| T1: 515.00| I0: 350.00| I1: 75.00| WTP: 0,1,0.096153846,515,0,0,0,350,75,-12273471558,1692506311,7574.913094,11894725904,1189472590,38,64711,2927,1258,1258,0,1258,64711,0,1258,13.26471677,0.294335431,0.294335431,60179.83377,159.9911144,0.758978156,99232.84969,0.603434838,0.001620844,9.42287E-06,0,0.019440281,383,135
D:1| T0: 0.10| T1: 515.00| I0: 350.00| I1: 75.00| WTP: 0,1,0.096153846,515,0,0,0,350,75,-4329597046,1037620300,6795.0431,3989844891,398984489.1,16,51379,2163,1129,1129,0,1129,51379,0,1129,17.6650619,0.589408528,0.589408528,73300.25928,148.2475928,1.367262724,99430.64237,0.726806408,0.001546968,1.61853E-05,0,0.021973958,201,45
D:1| T0: 0.10| T1: 515.00| I0: 350.00| I1: 75.00| WTP: 0,1,0.096153846,515,0,0,0,350,75,-5714626790,301400999,7922.622,5318495690,531849569,26,59505,2671,1316,1316,0,1316,59505,0,1316,20.39975918,0.605057194,0.605057194,63335.66045,149.1697772,1.385912101,99207.5876,0.637666107,0.00150291,1.59412E-05,0,0.022115789,238,60
D:1| T0: 0.10| T1: 515.00| I0: 350.00| I1: 75.00| WTP: 0,1,0.096153846,515,0,0,0,350,75,-8981387769,1868336855,9831.640622,8489805738,848980573.8,20,74759,3358,1633,1633,0,1633,74759,0,1633,28.18696511,0.883475971,0.883475971,49613.474,191.4068466,1.970375247,98915.9447,0.500524659,0.001931003,2.16636E-05,0,0.021843524,217,96
D:1| T0: 0.10| T1: 515.00| I0: 350.00| I1: 75.00| WTP: 0,1,0.096153846,515,0,0,0,350,75,-8897613383,1868498144,9992.383223,8397994221,839799422.1,20,75722,3294,1660,1660,0,1660,75722,0,1660,27.89597781,0.921636616,0.921636616,52826.27254,217.3398058,2.07073509,98971.24272,0.532781377,0.002192633,2.32001E-05,0,0.021922295,206,95
D:1| T0: 0.10| T1: 515.00| I0: 350.00| I1: 75.00| WTP: 0,1,0.096153846,515,0,0,0,350,75,-7409260069,2101566889,6822.377528,7068141192,706814119.2,24,58029,2580,1133,1133,0,1133,58029,0,1133,16.02319842,0.361796644,0.361796644,67182.77789,162.1505429,0.936821323,99359.6002,0.675575024,0.001632599,1.12427E-05,0,0.01952472,290,80
D:1| T0: 0.10| T1: 515.00| I0: 350.00| I1: 75.00| WTP: 0,1,0.096153846,515,0,0,0,350,75,-2618728710,1665097450,10558.02093,2090827664,209082766.4,6,81611,3453,1052,1754,702,1052,81611,702,1754,64.34743202,1.425981873,2.463746224,35644.87764,422.5725076,4.052870091,98637.24924,0.324717169,0.004495524,4.51041E-05,0.400456361,0.021480474,90,23
D:1| T0: 0.10| T1: 515.00| I0: 350.00| I1: 75.00| WTP: 0,1,0.096153846,515,0,0,0,350,75,-3612977056,1716179948,9275.053275,3149224392,314922439.2,8,82180,3813,1265,1540,275,1265,82180,275,1540,54.88028169,1.311032864,1.618544601,31572.67019,331.5352113,3.111502347,98740.60446,0.319270163,0.003339027,3.31449E-05,0.178687459,0.018727412,122,35
D:1| T0: 0.10| T1: 515.00| I0: 350.00| I1: 75.00| WTP: 0,1,0.096153846,515,0,0,0,350,75,-4325464567,1560278715,8405.582122,3905185461,390518546.1,20,53820,2200,1397,1397,0,1397,53820,0,1397,20.06870799,0.839432412,0.839432412,68885.69529,136.9551904,1.88648245,99189.46677,0.689244907,0.001400621,2.12993E-05,0,0.025956893,188,44
D:1| T0: 0.10| T1: 515.00| I0: 350.00| I1: 75.00| WTP: 0,1,0.096153846,515,0,0,0,350,75,-12010201642,991019385,10816.29198,11469387042,1146938704,28,80648,3422,1796,1797,1,1796,80648,1,1797,19.96506138,0.656751653,0.657223796,44096.54769,224.8186969,1.510387158,98770.5373,0.445496002,0.002269867,1.71099E-05,0.000556483,0.022282016,303,130
D:1| T0: 0.10| T1: 515.00| I0: 350.00| I1: 75.00| WTP: 0,1,0.096153846,515,0,0,0,350,75,-6951809272,118052103,9655.918378,6469013353,646901335.3,14,73834,3176,1566,1604,38,1566,73834,38,1604,26.84444444,0.886868687,0.911111111,44002.8532,250.213468,1.97037037,98803.40404,0.436976288,0.002557076,2.17989E-05,0.023690773,0.021724703,210,73
D:1| T0: 0.10| T1: 515.00| I0: 350.00| I1: 75.00| WTP: 0,1,0.096153846,515,0,0,0,350,75,-5161745779,1209758844,10676.81526,4627905016,462790501.6,12,76431,3126,1744,1774,30,1744,76431,30,1774,40.14197531,1.594650206,1.62345679,47912.10597,230.6028807,3.402263374,98808.61728,0.469740836,0.002390155,3.7482E-05,0.016910936,0.023210477,136,52
D:1| T0: 0.10| T1: 515.00| I0: 350.00| I1: 75.00| WTP: 0,1,0.096153846,515,0,0,0,350,75,-7502147891,70671723,7060.429626,7149126410,714912641,32,53966,2256,1173,1173,0,1173,53966,0,1173,11.17442778,0.296369376,0.296369376,66484.13062,131.281768,0.757695343,99263.03394,0.668651413,0.001324835,9.32373E-06,0,0.021735908,362,81
D:1| T0: 0.10| T1: 515.00| I0: 350.00| I1: 75.00| WTP: 0,1,0.096153846,515,0,0,0,350,75,-6725173791,1722612191,5612.051233,6444571229,644457122.9,22,46170,2154,932,932,0,932,46170,0,932,12.28881701,0.291127542,0.291127542,69535.48752,117.8766174,0.714879852,99396.65018,0.698838875,0.001187047,8.65795E-06,0,0.020186705,308,73
D:1| T0: 0.10| T1: 515.00| I0: 350.00| I1: 75.00| WTP: 0,1,0.096153846,515,0,0,0,350,75,-4308602879,1968291596,6286.012319,3994302264,399430226.4,16,52120,2314,1044,1044,0,1044,52120,0,1044,21.13421829,0.572271386,0.572271386,71396.81563,153.0730088,1.345132743,99444.40782,0.71508533,0.001552443,1.55939E-05,0,0.020030698,193,45
D:1| T0: 0.10| T1: 515.00| I0: 350.00| I1: 75.00| WTP: 0,1,0.096153846,515,0,0,0,350,75,-3987932837,1877569084,11586.10887,3408627394,340862739.4,10,83794,3472,1499,1925,426,1499,83794,426,1925,58.4953271,1.813084112,2.367156208,36967.58478,357.7957276,4.360480641,98597.65287,0.365670446,0.003657918,4.67453E-05,0.221298701,0.022973005,106,38
D:1| T0: 0.10| T1: 515.00| I0: 350.00| I1: 75.00| WTP: 0,1,0.096153846,515,0,0,0,350,75,-3021440438,1726322189,9884.884924,2527196192,252719619.2,6,76650,3339,1180,1642,462,1180,76650,462,1642,64.10990712,1.685758514,2.377708978,36585.30341,403.1718266,4.193498452,98670.0356,0.364247843,0.004097761,4.44012E-05,0.28136419,0.021422048,92,28
D:1| T0: 0.10| T1: 515.00| I0: 350.00| I1: 75.00| WTP: 0,1,0.096153846,515,0,0,0,350,75,-6956505445,307848836,9728.307507,6470090070,647009007,18,77055,3290,1613,1616,3,1613,77055,3,1616,28.02283737,0.920415225,0.922491349,42584.27958,186.8346021,2.042214533,98819.05744,0.430166437,0.001884236,2.25123E-05,0.001856436,0.020972033,207,73
D:1| T0: 0.10| T1: 515.00| I0: 350.00| I1: 75.00| WTP: 0,1,0.096153846,515,0,0,0,350,75,-1740860955,1154000220,10409.77525,1220372193,122037219.3,4,83903,3822,870,1729,859,870,83903,859,1729,103.0731707,1.729490022,3.620842572,29189.43681,484.7738359,5.55210643,98584.15743,0.295700585,0.00487807,5.80384E-05,0.496818971,0.020607375,65,13
D:1| T0: 0.10| T1: 515.00| I0: 350.00| I1: 75.00| WTP: 0,1,0.096153846,515,0,0,0,350,75,-5895928467,2028661055,6519.461837,5569955375,556995537.5,26,51711,2295,1083,1083,0,1083,51711,0,1083,14.05368098,0.365030675,0.365030675,70123.55726,138.7622699,0.925869121,99384.84254,0.70504875,0.001396789,1.11282E-05,0,0.02094332,280,63
D:1| T0: 0.10| T1: 515.00| I0: 350.00| I1: 75.00| WTP: 0,1,0.096153846,515,0,0,0,350,75,-13779448242,1629114640,9499.139335,13304491275,1330449128,34,74227,3207,1578,1578,0,1578,74227,0,1578,14.72304833,0.405204461,0.405204461,52081.60781,171.6208178,0.995910781,98992.61599,0.525039954,0.001731601,1.18213E-05,0,0.021259111,385,151
D:1| T0: 0.10| T1: 515.00| I0: 350.00| I1: 75.00| WTP: 0,1,0.096153846,515,0,0,0,350,75,-4662413181,1439048174,11057.49059,4109538651,410953865.1,12,80931,3533,1467,1837,370,1467,80931,370,1837,42.09510086,1.249759846,1.594620557,33066.57349,331.1095101,3.004803074,98500.73967,0.333167146,0.003350335,3.21055E-05,0.201415351,0.022698348,149,46
D:1| T0: 0.10| T1: 515.00| I0: 350.00| I1: 75.00| WTP: 0,1,0.096153846,515,0,0,0,350,75,-1416272826,865227006,11044.42522,864051565,86405156.5,2,82841,3471,625,1835,1210,625,82841,1210,1835,84.50784314,1.096078431,3.452941176,30336.21373,435.7568627,4.682352941,98486.00784,0.266874595,0.00464258,5.14228E-05,0.659400545,0.022150867,69,9
D:1| T0: 0.10| T1: 515.00| I0: 350.00| I1: 75.00| WTP: 0,1,0.096153846,515,0,0,0,350,75,-8302135628,890479738,10311.39062,7786566097,778656609.7,16,79369,3390,1691,1713,22,1691,79369,22,1713,23.95599305,0.801389693,0.81239143,39107.03243,329.3908512,1.796757383,98705.48755,0.395502905,0.003322248,1.98693E-05,0.012842966,0.021582734,247,88
D:1| T0: 0.10| T1: 515.00| I0: 350.00| I1: 75.00| WTP: 0,1,0.096153846,515,0,0,0,350,75,-4471216853,1017049163,7604.21663,4091006022,409100602.2,24,61270,2760,1263,1263,0,1263,61270,0,1263,25.7898773,0.769171779,0.769171779,66010.48236,167.5099693,1.724693252,99298.1112,0.664100767,0.001687078,1.94792E-05,0,0.020613677,187,46
D:1| T0: 0.10| T1: 515.00| I0: 350.00| I1: 75.00| WTP: 0,1,0.096153846,515,0,0,0,350,75,-6162173293,1707305064,6573.71545,5833487520,583348752,22,53423,2309,1092,1092,0,1092,53423,0,1092,15.46384872,0.408231368,0.408231368,70581.15072,155.4060067,1.018353726,99411.34983,0.707775148,0.001572812,1.22749E-05,0,0.020440634,256,66
D:1| T0: 0.10| T1: 515.00| I0: 350.00| I1: 75.00| WTP: 0,1,0.096153846,515,0,0,0,350,75,-1345482937,400145663,11303.97131,780284371.7,78028437.17,2,83824,3616,714,1878,1164,714,83824,1164,1878,132.8621701,1.935483871,5.328445748,29338.54252,658.4252199,7.416422287,98471.60411,0.297454985,0.006624804,7.65575E-05,0.619808307,0.022404085,49,8
D:1| T0: 0.10| T1: 515.00| I0: 350.00| I1: 75.00| WTP: 0,1,0.096153846,515,0,0,0,350,75,-6137213975,1662654181,7651.664311,5754630760,575463076,34,60286,2633,1271,1271,0,1271,60286,0,1271,19.65944645,0.578219013,0.578219013,65216.30505,148.988568,1.328519856,99288.70878,0.65605128,0.00150075,1.53833E-05,0,0.021082838,238,65
D:1| T0: 0.10| T1: 515.00| I0: 350.00| I1: 75.00| WTP: 0,1,0.096153846,515,0,0,0,350,75,-5318694385,182136456,10162.58337,4810565217,481056521.7,18,83078,3631,1491,1688,197,1491,83078,197,1688,44.97850563,1.31013306,1.505629478,39781.11259,295.9744115,3.027635619,98801.80246,0.398918323,0.00299938,3.29603E-05,0.116706161,0.0203185,139,54
D:1| T0: 0.10| T1: 515.00| I0: 350.00| I1: 75.00| WTP: 0,1,0.096153846,515,0,0,0,350,75,-7687962139,979575387,5605.592137,7407682532,740768253.2,26,48820,2150,931,931,0,931,48820,0,931,8.729,0.172,0.172,67271.38467,110.036,0.480666667,99382.92967,0.676442972,0.001107496,6.23359E-06,0,0.019070053,429,84
D:1| T0: 0.10| T1: 515.00| I0: 350.00| I1: 75.00| WTP: 0,1,0.096153846,515,0,0,0,350,75,-5763519638,2142525414,10336.13363,5246712957,524671295.7,12,78718,3411,1634,1717,83,1634,78718,83,1717,33.8685259,1.126693227,1.188844622,38735.21116,245.9609562,2.497211155,98660.03825,0.385457832,0.002507541,2.71939E-05,0.048340128,0.021812592,178,59
D:1| T0: 0.10| T1: 515.00| I0: 350.00| I1: 75.00| WTP: 0,1,0.096153846,515,0,0,0,350,75,-6318735846,1464057597,9247.806449,5856345524,585634552.4,12,72930,3243,1525,1536,11,1525,72930,11,1536,33.10938776,1.032653061,1.038367347,48015.93061,223.0522449,2.295510204,98935.17796,0.484179853,0.002249884,2.51812E-05,0.007166124,0.021047868,175,66
D:1| T0: 0.10| T1: 515.00| I0: 350.00| I1: 75.00| WTP: 0,1,0.096153846,515,0,0,0,350,75,-4502167611,364562610,9740.137972,4015160712,401516071.2,10,74260,3244,1515,1618,103,1515,74260,103,1618,44.14475138,1.472928177,1.58121547,44449.25856,275.4541436,3.243093923,98818.73923,0.446065966,0.002791002,3.50588E-05,0.063658838,0.021788605,129,45
D:1| T0: 0.10| T1: 515.00| I0: 350.00| I1: 75.00| WTP: 0,1,0.096153846,515,0,0,0,350,75,-4967139542,40350784,10256.91815,4454293635,445429363.5,10,77275,3269,1612,1704,92,1612,77275,92,1704,37.8656015,1.332706767,1.415413534,41593.19549,279.3280075,2.915413534,98721.98684,0.420557089,0.002817046,3.14057E-05,0.05399061,0.022051116,152,50
D:1| T0: 0.10| T1: 515.00| I0: 350.00| I1: 75.00| WTP: 0,1,0.096153846,515,0,0,0,350,75,-6286781260,804064356,8469.333795,5863314570,586331457,24,77754,3613,1406,1406,0,1406,77754,0,1406,40.2625,1.04375,1.04375,53919.33661,200.575,2.315178571,99188.17054,0.537204506,0.002044029,2.55585E-05,0,0.018082671,159,66
D:1| T0: 0.10| T1: 515.00| I0: 350.00| I1: 75.00| WTP: 0,1,0.096153846,515,0,0,0,350,75,-4918276740,2125493986,9413.922434,4447580619,444758061.9,26,67840,2902,1564,1564,0,1564,67840,0,1564,29.54281099,1.054119548,1.054119548,60428.70113,172.8731826,2.315831987,99084.38045,0.608602694,0.001745,2.54656E-05,0,0.023054245,177,50
D:1| T0: 0.10| T1: 515.00| I0: 350.00| I1: 75.00| WTP: 0,1,0.096153846,515,0,0,0,350,75,-5172603056,23154253,7468.407699,4799182671,479918267.1,14,66307,3011,1236,1240,4,1236,66307,4,1240,35.2849162,0.95716946,0.960893855,52960.90037,164.689013,2.127560521,99123.446,0.529760243,0.001672166,2.33717E-05,0.003225806,0.018700891,153,54
D:1| T0: 0.10| T1: 515.00| I0: 350.00| I1: 75.00| WTP: 0,1,0.096153846,515,0,0,0,350,75,-3884629234,1391367689,6609.740801,3554142194,355414219.4,18,50223,2177,1098,1098,0,1098,50223,0,1098,21.4822974,0.674272227,0.674272227,68053.31235,133.1424076,1.533438238,99306.5295,0.68224085,0.001350883,1.74968E-05,0,0.021862493,181,40
D:1| T0: 0.10| T1: 515.00| I0: 350.00| I1: 75.00| WTP: 0,1,0.096153846,515,0,0,0,350,75,-8204962302,574142276,8584.209937,7775751805,777575180.5,28,67662,2855,1426,1426,0,1426,67662,0,1426,20.76212741,0.634132086,0.634132086,59001.61017,181.6931619,1.4628872,99150.45529,0.59329735,0.001835673,1.68178E-05,0,0.021075657,244,88
D:1| T0: 0.10| T1: 515.00| I0: 350.00| I1: 75.00| WTP: 0,1,0.096153846,515,0,0,0,350,75,-7808420599,898736779,6242.516838,7496294757,749629475.7,28,47195,2144,1037,1037,0,1037,47195,0,1037,10.43143418,0.240078585,0.240078585,71992.67033,136.091945,0.648722986,99377.61257,0.722199215,0.001378835,8.24033E-06,0,0.021972667,362,85
D:1| T0: 0.10| T1: 515.00| I0: 350.00| I1: 75.00| WTP: 0,1,0.096153846,515,0,0,0,350,75,-13296083566,346473503,8415.077012,12875329715,1287532972,32,77043,3677,1397,1397,0,1397,77043,0,1397,20.17501108,0.424457244,0.424457244,52860.66593,194.0465219,1.050952592,99160.62561,0.516695892,0.002019492,1.28713E-05,0,0.018132731,313,146
D:1| T0: 0.10| T1: 515.00| I0: 350.00| I1: 75.00| WTP: 0,1,0.096153846,515,0,0,0,350,75,-12289932200,445552282,9528.906365,11813486881,1181348688,36,72437,3116,1583,1583,0,1583,72437,0,1583,16.94516971,0.493472585,0.493472585,56334.57267,180.0073977,1.186248912,99048.34204,0.557493792,0.001858774,1.42087E-05,0,0.021853774,320,134
D:1| T0: 0.10| T1: 515.00| I0: 350.00| I1: 75.00| WTP: 0,1,0.096153846,515,0,0,0,350,75,-1808458216,911758476,10025.15239,1307200596,130720059.6,4,81411,3665,762,1665,903,762,81411,903,1665,69.7224736,1.028657617,2.377073906,29144.78431,344.066365,3.549019608,98580.06033,0.265050457,0.00361095,3.84382E-05,0.542342342,0.020451782,91,14
D:1| T0: 0.10| T1: 515.00| I0: 350.00| I1: 75.00| WTP: 0,1,0.096153846,515,0,0,0,350,75,-5136848622,1464197940,9965.493218,4638573961,463857396.1,12,81640,3665,1469,1655,186,1469,81640,186,1655,40.54529464,1.105540897,1.262972735,33671.22779,418.8188215,2.553210202,98671.4336,0.340682371,0.004221734,2.7684E-05,0.112386707,0.020271926,163,52
D:1| T0: 0.10| T1: 515.00| I0: 350.00| I1: 75.00| WTP: 0,1,0.096153846,515,0,0,0,350,75,-7035842671,500405854,8096.073332,6631039004,663103900.4,28,59207,2585,1345,1345,0,1345,59207,0,1345,18.9235706,0.605600933,0.605600933,62352.92707,139.7707118,1.385647608,99160.493,0.625381091,0.001418575,1.59025E-05,0,0.022716908,244,75
D:1| T0: 0.10| T1: 515.00| I0: 350.00| I1: 75.00| WTP: 0,1,0.096153846,515,0,0,0,350,75,-7426554847,772037341,10317.64444,6910672625,691067262.5,28,76482,3318,1713,1714,1,1713,76482,1,1714,30.2013034,1.033309196,1.034033309,51083.28385,181.6937002,2.276611151,98908.81752,0.515329477,0.001833975,2.50117E-05,0.000583431,0.022410502,198,78
D:1| T0: 0.10| T1: 515.00| I0: 350.00| I1: 75.00| WTP: 0,1,0.096153846,515,0,0,0,350,75,-4340374626,1543158763,5346.1598,4073066636,407306663.6,20,44749,1986,888,888,0,888,44749,0,888,13.27002801,0.316526611,0.316526611,72551.96415,121.2610644,0.822969188,99456.53333,0.727268616,0.001227983,1.00559E-05,0,0.019844019,254,46
D:1| T0: 0.10| T1: 515.00| I0: 350.00| I1: 75.00| WTP: 0,1,0.096153846,515,0,0,0,350,75,-3728848732,1604932531,11675.93625,3145051920,314505192,12,84561,3504,1428,1940,512,1428,84561,512,1940,59.33151432,1.740791269,2.429740791,37832.00955,340.4802183,4.366984993,98589.17462,0.369127365,0.003512139,4.74022E-05,0.264053636,0.022930192,103,35
D:1| T0: 0.10| T1: 515.00| I0: 350.00| I1: 75.00| WTP: 0,1,0.096153846,515,0,0,0,350,75,-7875665993,539051477,10486.58668,7351336659,735133665.9,16,78816,3444,1694,1742,48,1694,78816,48,1742,28.15535248,0.93537859,0.962793734,40490.22715,293.9758486,2.058746736,98698.92102,0.397175681,0.003027083,2.30782E-05,0.027554535,0.022102111,215,83
D:1| T0: 0.10| T1: 515.00| I0: 350.00| I1: 75.00| WTP: 0,1,0.096153846,515,0,0,0,350,75,-3583331347,1743124675,5882.392471,3289211724,328921172.4,22,47750,2137,977,977,0,977,47750,0,977,19.6358898,0.551005212,0.551005212,70056.38943,120.1176471,1.280714818,99399.69844,0.703197389,0.001212981,1.46644E-05,0,0.020460733,192,37
D:1| T0: 0.10| T1: 515.00| I0: 350.00| I1: 75.00| WTP: 0,1,0.096153846,515,0,0,0,350,75,-12144236302,1965983789,8511.63619,11718654492,1171865449,26,63493,2736,1414,1414,0,1414,63493,0,1414,15.77145438,0.448509485,0.448509485,61624.83559,166.0194219,1.088075881,99148.52304,0.619658399,0.001678283,1.28933E-05,0,0.022270172,316,133
D:1| T0: 0.10| T1: 515.00| I0: 350.00| I1: 75.00| WTP: 0,1,0.096153846,515,0,0,0,350,75,-9938969834,516774280,8235.253422,9527207163,952720716.3,38,64930,2778,1368,1368,0,1368,64930,0,1368,13.75904088,0.353773585,0.353773585,62942.51612,163.9272799,0.89504717,99220.28184,0.633295079,0.001653884,1.08331E-05,0,0.021068843,363,108
D:1| T0: 0.10| T1: 515.00| I0: 350.00| I1: 75.00| WTP: 0,1,0.096153846,515,0,0,0,350,75,-1306194288,86603142,10493.61535,781513521,78151352.1,2,83064,3579,515,1743,1228,515,83064,1228,1743,229.9306931,2.455445545,8.504950495,37292.29208,1066.920792,11.04950495,98757.9604,0.340566859,0.011316743,0.000118645,0.704936854,0.020971781,28,8
D:1| T0: 0.10| T1: 515.00| I0: 350.00| I1: 75.00| WTP: 0,1,0.096153846,515,0,0,0,350,75,-8458494087,1431870609,6880.632396,8114462467,811446246.7,40,55244,2427,1143,1143,0,1143,55244,0,1143,11.41918993,0.290208415,0.290208415,66707.99843,150.1576878,0.734172238,99309.89383,0.671106558,0.001512165,9.03748E-06,0,0.02069003,364,92
D:1| T0: 0.10| T1: 515.00| I0: 350.00| I1: 75.00| WTP: 0,1,0.096153846,515,0,0,0,350,75,-5386220332,1592383984,8231.221798,4974659242,497465924.2,16,66581,2931,1363,1367,4,1363,66581,4,1367,33.90197842,1.042266187,1.047661871,53504.76349,175.3696043,2.257194245,99062.29496,0.538204021,0.001771275,2.47636E-05,0.002926116,0.020531383,159,56
D:1| T0: 0.10| T1: 515.00| I0: 350.00| I1: 75.00| WTP: 0,1,0.096153846,515,0,0,0,350,75,-8708096762,1440183867,8068.662593,8304663633,830466363.3,26,67669,3041,1340,1340,0,1340,67669,0,1340,21.80811594,0.568695652,0.568695652,61188.41159,189.2689855,1.346666667,99231.6887,0.615834945,0.001907022,1.56319E-05,0,0.019802273,247,94
D:1| T0: 0.10| T1: 515.00| I0: 350.00| I1: 75.00| WTP: 0,1,0.096153846,515,0,0,0,350,75,-9100061240,1696510588,8944.687485,8652826866,865282686.6,34,67191,2911,1486,1486,0,1486,67191,0,1486,15.68476357,0.47854641,0.47854641,55815.99562,137.9238179,1.126094571,99023.15849,0.562488646,0.001392079,1.31097E-05,0,0.022116057,327,98
D:1| T0: 0.10| T1: 515.00| I0: 350.00| I1: 75.00| WTP: 0,1,0.096153846,515,0,0,0,350,75,-11987627158,895039877,10348.15594,11470219361,1147021936,28,77658,3353,1719,1719,0,1719,77658,0,1719,19.79143646,0.616022099,0.616022099,45074.02256,187.46593,1.409300184,98787.11234,0.451741653,0.001904892,1.60621E-05,0,0.022135517,309,130
D:1| T0: 0.10| T1: 515.00| I0: 350.00| I1: 75.00| WTP: 0,1,0.096153846,515,0,0,0,350,75,-14054526834,129565953,9898.936644,13559580001,1355958000,36,67700,2851,1645,1645,0,1645,67700,0,1645,12.71444282,0.409090909,0.409090909,60563.90872,175.53739,1.008064516,99065.71738,0.610053164,0.001772735,1.21647E-05,0,0.024298375,389,154
D:1| T0: 0.10| T1: 515.00| I0: 350.00| I1: 75.00| WTP: 0,1,0.096153846,515,0,0,0,350,75,-6581908001,1902565669,7712.784459,6196268778,619626877.8,30,65091,2902,1281,1281,0,1281,65091,0,1281,20.33860574,0.560632689,0.560632689,60517.314,145.1212654,1.300527241,99247.85062,0.607845407,0.001466267,1.5141E-05,0,0.01968014,244,70
D:1| T0: 0.10| T1: 515.00| I0: 350.00| I1: 75.00| WTP: 0,1,0.096153846,515,0,0,0,350,75,-10227617507,1984179288,7163.519118,9869441551,986944155.1,42,56906,2476,1190,1190,0,1190,56906,0,1190,10.3801511,0.257211538,0.257211538,65811.80014,147.220467,0.660027473,99290.8465,0.659574395,0.001494069,8.28172E-06,0,0.020912414,413,112
D:1| T0: 0.10| T1: 515.00| I0: 350.00| I1: 75.00| WTP: 0,1,0.096153846,515,0,0,0,350,75,-11180539392,677377223,10011.33973,10679972405,1067997241,18,75343,3388,1663,1663,0,1663,75343,0,1663,18.99460916,0.566486972,0.566486972,44675.52066,273.9285714,1.312219227,98791.82659,0.451525078,0.00276314,1.506E-05,0,0.022072389,317,121
D:1| T0: 0.10| T1: 515.00| I0: 350.00| I1: 75.00| WTP: 0,1,0.096153846,515,0,0,0,350,75,-15790566040,973583301,9320.295869,15324551246,1532455125,26,75998,3403,1548,1548,0,1548,75998,0,1548,16.60920897,0.417158599,0.417158599,50988.57536,242.9598583,1.024399843,99010.9878,0.513866918,0.002452195,1.22841E-05,0,0.020368957,363,174
D:1| T0: 0.10| T1: 515.00| I0: 350.00| I1: 75.00| WTP: 0,1,0.096153846,515,0,0,0,350,75,-8351212394,781062938,7865.731434,7957925822,795792582.2,30,68896,3186,1306,1306,0,1306,68896,0,1306,21.38847385,0.508537887,0.508537887,58130.70651,169.4765208,1.200640342,99218.67609,0.585051759,0.001707345,1.40222E-05,0,0.018956383,268,90
D:1| T0: 0.10| T1: 515.00| I0: 350.00| I1: 75.00| WTP: 0,1,0.096153846,515,0,0,0,350,75,-20066962010,338783425,8977.497499,19618087135,1961808713,38,71095,3269,1491,1491,0,1491,71095,0,1491,13.11006289,0.297484277,0.297484277,57396.73994,182.8437107,0.761949686,99103.11541,0.577090999,0.001849029,9.46869E-06,0,0.020971939,454,223
D:1| T0: 0.10| T1: 515.00| I0: 350.00| I1: 100.00| WTP: 0,1,0.096153846,515,0,0,0,350,100,-5972230361,1178568022,7879.468937,5578256914,557825691.4,30,59444,2546,1309,1309,0,1309,59444,0,1309,17.31607335,0.49622438,0.49622438,65944.42988,165.3759439,1.198489752,99259.80906,0.663601765,0.00166625,1.42062E-05,0,0.022021096,264,63
D:1| T0: 0.10| T1: 515.00| I0: 350.00| I1: 100.00| WTP: 0,1,0.096153846,515,0,0,0,350,100,-6630174990,2029998696,10055.24248,6127412866,612741286.6,20,81568,3539,1662,1670,8,1662,81568,8,1670,43.50914341,1.358999038,1.366698749,47038.3128,265.5004812,2.987487969,98940.93936,0.469391114,0.00270288,3.26218E-05,0.004790419,0.020473715,147,69
D:1| T0: 0.10| T1: 515.00| I0: 350.00| I1: 100.00| WTP: 0,1,0.096153846,515,0,0,0,350,100,-4567701824,776062361,11002.07058,4017598295,401759829.5,8,78386,3273,1568,1828,260,1568,78386,260,1828,35.62370242,1.179065744,1.397058824,36970.46107,418.9143599,2.767301038,98548.94637,0.360284274,0.004319263,3.02798E-05,0.142231947,0.023320788,161,45
D:1| T0: 0.10| T1: 515.00| I0: 350.00| I1: 100.00| WTP: 0,1,0.096153846,515,0,0,0,350,100,-8073518991,1813046880,7837.317346,7681653124,768165312.4,34,59668,2554,1302,1302,0,1302,59668,0,1302,14.91352859,0.40492794,0.40492794,67146.08461,175.1250581,1.015341702,99279.77452,0.675602588,0.001764694,1.21797E-05,0,0.021820741,308,87
D:1| T0: 0.10| T1: 515.00| I0: 350.00| I1: 100.00| WTP: 0,1,0.096153846,515,0,0,0,350,100,-5017822669,2032407216,7935.85295,4621030021,462103002.1,26,65918,2992,1316,1318,2,1316,65918,2,1318,26.96931138,0.782934132,0.784431138,60570.74701,172.130988,1.77245509,99228.8256,0.605741171,0.001750758,2.00262E-05,0.001517451,0.019994539,189,52
D:1| T0: 0.10| T1: 515.00| I0: 350.00| I1: 100.00| WTP: 0,1,0.096153846,515,0,0,0,350,100,-5721215655,1507873352,6655.558713,5388437720,538843772,28,48258,1919,1106,1106,0,1106,48258,0,1106,10.75169914,0.315813321,0.315813321,74868.90938,157.4503851,0.812868147,99423.87676,0.750459927,0.001598122,1.01566E-05,0,0.022918955,312,61
D:1| T0: 0.10| T1: 515.00| I0: 350.00| I1: 100.00| WTP: 0,1,0.096153846,515,0,0,0,350,100,-3610576977,1855899401,6381.584895,3291497732,329149773.2,18,52048,2273,1060,1060,0,1060,52048,0,1060,20.16289262,0.583637692,0.583637692,68328.54054,142.6501096,1.355734112,99359.56318,0.686918744,0.001436671,1.55681E-05,0,0.020365816,196,37
D:1| T0: 0.10| T1: 515.00| I0: 350.00| I1: 100.00| WTP: 0,1,0.096153846,515,0,0,0,350,100,-7371893386,1819459251,9413.674764,6901209648,690120964.8,22,70867,2968,1564,1564,0,1564,70867,0,1564,25.95135908,0.902002861,0.902002861,54186.67597,182.8061516,2.01788269,99022.41059,0.546224349,0.001843147,2.2535E-05,0,0.022070133,200,78
D:1| T0: 0.10| T1: 515.00| I0: 350.00| I1: 100.00| WTP: 0,1,0.096153846,515,0,0,0,350,100,-2981204758,909791748,6086.99819,2676854848,267685484.8,20,48932,2197,1011,1011,0,1011,48932,0,1011,27.18044355,0.804435484,0.804435484,72364.55444,159.858871,1.834677419,99438.44052,0.727234026,0.001607784,2.04657E-05,0,0.020663015,142,30
D:1| T0: 0.10| T1: 515.00| I0: 350.00| I1: 100.00| WTP: 0,1,0.096153846,515,0,0,0,350,100,-6019164954,1339092841,8763.342486,5580997830,558099783,20,63174,2655,1456,1456,0,1456,63174,0,1456,23.31690141,0.849295775,0.849295775,55718.6507,159.9309859,1.874647887,98989.19296,0.562107203,0.001612308,2.06427E-05,0,0.023048916,203,63
D:1| T0: 0.10| T1: 515.00| I0: 350.00| I1: 100.00| WTP: 0,1,0.096153846,515,0,0,0,350,100,-6394227793,1365866345,10601.65169,5864145209,586414520.9,22,82471,3577,1745,1761,16,1745,82471,16,1761,39.30026339,1.312554873,1.326602283,46785.85514,226.7208077,2.866549605,98859.10711,0.447740679,0.002392805,3.24515E-05,0.009085747,0.021353737,156,66
D:1| T0: 0.10| T1: 515.00| I0: 350.00| I1: 100.00| WTP: 0,1,0.096153846,515,0,0,0,350,100,-10324102706,825453433,8683.701876,9889917613,988991761.3,26,71414,3297,1442,1442,0,1442,71414,0,1442,22.85442694,0.577946768,0.577946768,55105.38729,197.7925041,1.3557849,99091.44867,0.555205711,0.00199382,1.57706E-05,0,0.020192119,263,112
D:1| T0: 0.10| T1: 515.00| I0: 350.00| I1: 100.00| WTP: 0,1,0.096153846,515,0,0,0,350,100,-6653709791,939711378,10500.07307,6128706137,612870613.7,22,81393,3605,1690,1744,54,1690,81393,54,1744,38.9566695,1.225998301,1.27357689,40451.03738,272.0220901,2.718776551,98757.5446,0.408759941,0.002743713,2.94097E-05,0.030963303,0.021426904,169,69
D:1| T0: 0.10| T1: 515.00| I0: 350.00| I1: 100.00| WTP: 0,1,0.096153846,515,0,0,0,350,100,-11881644478,638950699,8423.039896,11460492483,1146049248,34,67852,3089,1399,1399,0,1399,67852,0,1399,15.08310139,0.373757455,0.373757455,55383.71213,170.7928429,0.934393638,99091.58171,0.558021613,0.001721629,1.11992E-05,0,0.020618405,360,130
D:1| T0: 0.10| T1: 515.00| I0: 350.00| I1: 100.00| WTP: 0,1,0.096153846,515,0,0,0,350,100,-4922472771,938699148,7762.03597,4534370972,453437097.2,24,64102,2968,1289,1289,0,1289,64102,0,1289,28.58878505,0.80529595,0.80529595,62959.63551,167.8489097,1.80529595,99258.81464,0.626772266,0.001721341,2.05602E-05,0,0.020108577,181,51
D:1| T0: 0.10| T1: 515.00| I0: 350.00| I1: 100.00| WTP: 0,1,0.096153846,515,0,0,0,350,100,-8288592984,121790188,6888.247487,7944180610,794418061,34,57773,2573,1144,1144,0,1144,57773,0,1144,13.13197556,0.285539715,0.285539715,66669.25092,169.4456212,0.746232179,99355.31772,0.670327869,0.001705846,9.36955E-06,0,0.019784328,350,90
D:1| T0: 0.10| T1: 515.00| I0: 350.00| I1: 100.00| WTP: 0,1,0.096153846,515,0,0,0,350,100,-5922971959,1331335240,9988.295754,5423557171,542355717.1,12,79564,3469,1548,1659,111,1548,79564,111,1659,36.57166806,1.117351215,1.207879296,38985.97904,440.7803856,2.498742666,98738.46773,0.387349229,0.004491972,2.73837E-05,0.066907776,0.020851139,169,61
D:1| T0: 0.10| T1: 515.00| I0: 350.00| I1: 100.00| WTP: 0,1,0.096153846,515,0,0,0,350,100,-1600416408,470935411,11189.15966,1040958425,104095842.5,2,81563,3470,796,1859,1063,796,81563,1063,1859,96.23026316,1.603070175,3.903508772,32477.86623,463.2214912,5.649122807,98505.36184,0.296268851,0.00488949,6.14923E-05,0.571812803,0.022792197,63,11
D:1| T0: 0.10| T1: 515.00| I0: 350.00| I1: 100.00| WTP: 0,1,0.096153846,515,0,0,0,350,100,-9067901873,823434397,8378.941026,8648954822,864895482.2,32,62652,2737,1392,1392,0,1392,62652,0,1392,20.65169231,0.649846154,0.649846154,61920.20369,198.0129231,1.515076923,99166.848,0.623594723,0.001995163,1.72417E-05,0,0.022217966,233,98
D:1| T0: 0.10| T1: 515.00| I0: 350.00| I1: 100.00| WTP: 0,1,0.096153846,515,0,0,0,350,100,-3010467457,493045351,6586.841483,2681125383,268112538.3,18,54122,2417,1094,1094,0,1094,54122,0,1094,24.42275748,0.716777409,0.716777409,64945.21761,113.486711,1.613787375,99307.69934,0.652811724,0.001144382,1.82877E-05,0,0.020213965,172,30
D:1| T0: 0.10| T1: 515.00| I0: 350.00| I1: 100.00| WTP: 0,1,0.096153846,515,0,0,0,350,100,-9560129643,1700216563,7629.422553,9178658516,917865851.6,24,64392,2944,1267,1267,0,1267,64392,0,1267,19.77153762,0.494547437,0.494547437,61329.28517,190.08506,1.177208288,99253.47983,0.617130927,0.001914141,1.38973E-05,0,0.019676357,262,104
D:1| T0: 0.10| T1: 515.00| I0: 350.00| I1: 100.00| WTP: 0,1,0.096153846,515,0,0,0,350,100,-4033700023,1744119059,7515.851968,3657907424,365790742.4,20,64922,2957,1246,1248,2,1246,64922,2,1248,37.23809524,1.045592705,1.047619048,61344.40223,181.8642351,2.312056738,99264.36069,0.617243899,0.001830709,2.54012E-05,0.001602564,0.019223068,141,41
D:1| T0: 0.10| T1: 515.00| I0: 350.00| I1: 100.00| WTP: 0,1,0.096153846,515,0,0,0,350,100,-9662267133,2036906360,8041.751906,9260179538,926017953.8,34,61192,2617,1336,1336,0,1336,61192,0,1336,13.52535328,0.365752286,0.365752286,64647.08728,177.0665004,0.92394015,99242.7074,0.647958971,0.001797624,1.12598E-05,0,0.021832919,341,105
D:1| T0: 0.10| T1: 515.00| I0: 350.00| I1: 100.00| WTP: 0,1,0.096153846,515,0,0,0,350,100,-9401376413,809704121,7959.723862,9003390220,900339022,26,67254,3009,1322,1322,0,1322,67254,0,1322,20.52640545,0.537762635,0.537762635,60704.35434,196.4003407,1.299261783,99222.84611,0.61053074,0.001980946,1.51227E-05,0,0.019641954,251,102
D:1| T0: 0.10| T1: 515.00| I0: 350.00| I1: 100.00| WTP: 0,1,0.096153846,515,0,0,0,350,100,-12431764141,1219866412,10403.18143,11911605069,1191160507,30,80761,3611,1725,1728,3,1725,80761,3,1728,20.09623993,0.592658908,0.594001791,41585.85765,294.7542525,1.363921218,98736.74575,0.420462257,0.002974971,1.55843E-05,0.001736111,0.021396466,320,135
D:1| T0: 0.10| T1: 515.00| I0: 350.00| I1: 100.00| WTP: 0,1,0.096153846,515,0,0,0,350,100,-4614137803,843498920,7138.718431,4257201881,425720188.1,28,53409,2340,1186,1186,0,1186,53409,0,1186,14.66460587,0.422462648,0.422462648,66107.82741,131.9196291,1.042246265,99260.11231,0.665363707,0.001328816,1.2287E-05,0,0.022205995,278,48
D:1| T0: 0.10| T1: 515.00| I0: 350.00| I1: 100.00| WTP: 0,1,0.096153846,515,0,0,0,350,100,-12314136016,107351963,10151.20812,11806575611,1180657561,44,70446,2845,1687,1687,0,1687,70446,0,1687,12.9609463,0.44573789,0.44573789,56892.25986,183.6744273,1.072474653,98980.79572,0.573515636,0.001854843,1.27778E-05,0,0.023947421,381,134
D:1| T0: 0.10| T1: 515.00| I0: 350.00| I1: 100.00| WTP: 0,1,0.096153846,515,0,0,0,350,100,-12678072168,773789021,8626.371506,12246753593,1224675359,42,68308,2979,1433,1433,0,1433,68308,0,1433,14.82924837,0.388071895,0.388071895,58932.03962,189.0539216,0.974264706,99157.78227,0.593041716,0.00190719,1.17969E-05,0,0.020978816,350,139
D:1| T0: 0.10| T1: 515.00| I0: 350.00| I1: 100.00| WTP: 0,1,0.096153846,515,0,0,0,350,100,-9041782706,850936611,9497.784791,8566893467,856689346.7,30,69049,2948,1578,1578,0,1578,69049,0,1578,19.65576408,0.63538874,0.63538874,58165.47828,196.2123324,1.49383378,99047.71957,0.583113851,0.001994049,1.71766E-05,0,0.022839184,265,97
D:1| T0: 0.10| T1: 515.00| I0: 350.00| I1: 100.00| WTP: 0,1,0.096153846,515,0,0,0,350,100,-7606772401,1701318364,8860.996343,7163722584,716372258.4,30,67956,2910,1472,1472,0,1472,67956,0,1472,21.07549361,0.671312427,0.671312427,55686.259,166.1631823,1.521486643,99044.73113,0.558248356,0.001687144,1.73338E-05,0,0.021661394,245,81
D:1| T0: 0.10| T1: 515.00| I0: 350.00| I1: 100.00| WTP: 0,1,0.096153846,515,0,0,0,350,100,-8985096667,778708269,6922.153311,8638989001,863898900.1,32,53567,2322,1150,1150,0,1150,53567,0,1150,10.7961202,0.25028528,0.25028528,69018.57931,156.4465576,0.689235451,99353.47242,0.69372176,0.001576967,8.80587E-06,0,0.021468441,376,98
D:1| T0: 0.10| T1: 515.00| I0: 350.00| I1: 100.00| WTP: 0,1,0.096153846,515,0,0,0,350,100,-4596862019,1391938506,8455.540369,4174085000,417408500,28,59140,2500,1405,1405,0,1405,59140,0,1405,21.63571935,0.793054571,0.793054571,61633.89794,150.0148831,1.794472006,99097.95819,0.621132212,0.001512167,2.00415E-05,0,0.023757588,202,47
D:1| T0: 0.10| T1: 515.00| I0: 350.00| I1: 100.00| WTP: 0,1,0.096153846,515,0,0,0,350,100,-4531238553,43418681,5693.908068,4246543150,424654315,22,42500,1861,946,946,0,946,42500,0,946,10.48598131,0.289252336,0.289252336,70532.43785,111.7018692,0.734579439,99357.81262,0.70949966,0.001124073,8.87894E-06,0,0.022259347,306,48
D:1| T0: 0.10| T1: 515.00| I0: 350.00| I1: 100.00| WTP: 0,1,0.096153846,515,0,0,0,350,100,-4125911258,817384966,10924.12324,3579705096,357970509.6,20,79583,3265,1536,1815,279,1536,79583,279,1815,44.31336898,1.439572193,1.730481283,40051.98075,231.7572193,3.380748663,98649.8492,0.403383121,0.002345706,3.62622E-05,0.153719008,0.022806378,134,40
D:1| T0: 0.10| T1: 515.00| I0: 350.00| I1: 100.00| WTP: 0,1,0.096153846,515,0,0,0,350,100,-5729222213,762053968,9657.36995,5246353716,524635371.6,24,78248,3355,1579,1604,25,1579,78248,25,1604,33.01085271,1.030232558,1.048837209,43742.16124,188.7643411,2.279844961,98875.35969,0.440564987,0.001906435,2.48943E-05,0.015586035,0.020498926,184,59
D:1| T0: 0.10| T1: 515.00| I0: 350.00| I1: 100.00| WTP: 0,1,0.096153846,515,0,0,0,350,100,-11077936766,1692506311,8122.817606,10671795885,1067179589,40,66801,3053,1349,1349,0,1349,66801,0,1349,16.08684654,0.378583474,0.378583474,61264.26307,186.3440135,0.946458685,99224.97133,0.61409015,0.00188958,1.15196E-05,0,0.020194611,336,121
D:1| T0: 0.10| T1: 515.00| I0: 350.00| I1: 100.00| WTP: 0,1,0.096153846,515,0,0,0,350,100,-4023920931,1037620300,5971.746671,3725333597,372533359.7,20,46707,2036,992,992,0,992,46707,0,992,13.9727475,0.394883204,0.394883204,69441.64127,108.3631813,0.94160178,99365.43548,0.689357087,0.001122913,1.14131E-05,0,0.021239241,250,42
D:1| T0: 0.10| T1: 515.00| I0: 350.00| I1: 100.00| WTP: 0,1,0.096153846,515,0,0,0,350,100,-5105278627,301400999,8030.341197,4703761567,470376156.7,26,62346,2711,1334,1334,0,1334,62346,0,1334,23.41034727,0.738483345,0.738483345,65078.68462,182.8540043,1.674698795,99267.74415,0.654842468,0.001841806,1.9022E-05,0,0.021396722,202,53
D:1| T0: 0.10| T1: 515.00| I0: 350.00| I1: 100.00| WTP: 0,1,0.096153846,515,0,0,0,350,100,-8758846850,1868336855,10606.89635,8228502032,822850203.2,20,78944,3502,1762,1762,0,1762,78944,0,1762,29.48677966,0.989830508,0.989830508,49499.33492,208.1525424,2.176949153,98895.07797,0.499329004,0.00210095,2.40876E-05,0,0.022320467,211,93
D:1| T0: 0.10| T1: 515.00| I0: 350.00| I1: 100.00| WTP: 0,1,0.096153846,515,0,0,0,350,100,-8819678559,1868498144,10160.98993,8311629063,831162906.3,22,74454,3262,1688,1688,0,1688,74454,0,1688,26.647365,0.889394925,0.889394925,50223.00846,201.6096291,1.98308393,98888.00065,0.506804315,0.002034199,2.21374E-05,0,0.022671717,220,94
D:1| T0: 0.10| T1: 515.00| I0: 350.00| I1: 100.00| WTP: 0,1,0.096153846,515,0,0,0,350,100,-6702663662,2101566889,6820.669424,6361630191,636163019.1,26,54410,2392,1133,1133,0,1133,54410,0,1133,15.29254202,0.399159664,0.399159664,66988.40021,161.2405462,0.99789916,99300.26628,0.674035884,0.001623518,1.19627E-05,0,0.020823378,272,72
D:1| T0: 0.10| T1: 515.00| I0: 350.00| I1: 100.00| WTP: 0,1,0.096153846,515,0,0,0,350,100,-2441153493,1665097450,10510.01335,1915652826,191565282.6,6,81277,3469,1044,1746,702,1044,81277,702,1746,65.57910906,1.437788018,2.493087558,35316.1659,428.0291859,4.107526882,98635.74808,0.320548589,0.00455752,4.56442E-05,0.402061856,0.021482092,88,21
D:1| T0: 0.10| T1: 515.00| I0: 350.00| I1: 100.00| WTP: 0,1,0.096153846,515,0,0,0,350,100,-3369647105,1716179948,9641.84881,2887554664,288755466.4,8,82820,3807,1326,1601,275,1326,82820,275,1601,65.71428571,1.654646325,2.018030513,33429.71567,395.0152566,3.848821082,98752.08044,0.337942,0.003977309,4.08753E-05,0.171767645,0.019331079,103,32
D:1| T0: 0.10| T1: 515.00| I0: 350.00| I1: 100.00| WTP: 0,1,0.096153846,515,0,0,0,350,100,-3855605820,1560278715,7786.775956,3466267023,346626702.3,20,54224,2155,1294,1294,0,1294,54224,0,1294,20.40229008,0.781679389,0.781679389,67881.72977,141.0832061,1.764885496,99240.56107,0.678614886,0.001442188,2.01613E-05,0,0.02384553,184,39
D:1| T0: 0.10| T1: 515.00| I0: 350.00| I1: 100.00| WTP: 0,1,0.096153846,515,0,0,0,350,100,-11386773236,991019385,10647.67504,10854389484,1085438948,30,78991,3426,1768,1769,1,1768,78991,1,1769,21.96178344,0.739384289,0.739915074,45778.78503,247.8428875,1.668789809,98801.60244,0.4623905,0.002501513,1.89314E-05,0.000565291,0.022394956,270,123
D:1| T0: 0.10| T1: 515.00| I0: 350.00| I1: 100.00| WTP: 0,1,0.096153846,515,0,0,0,350,100,-6714060087,118052103,10107.1776,6208701207,620870120.7,14,77348,3330,1641,1679,38,1641,77348,38,1679,31.5293669,1.042715484,1.070175439,45221.48665,297.7307399,2.33180778,98833.02212,0.448242377,0.003048728,2.5915E-05,0.022632519,0.02170709,185,70
D:1| T0: 0.10| T1: 515.00| I0: 350.00| I1: 100.00| WTP: 0,1,0.096153846,515,0,0,0,350,100,-4706693726,1209758844,10334.60205,4189963624,418996362.4,12,75268,3081,1687,1717,30,1687,75268,30,1717,44.73863636,1.701136364,1.732954545,48503.07273,249.9579545,3.636363636,98830.74091,0.474242593,0.002597231,4.01581E-05,0.017472335,0.022811819,122,47
D:1| T0: 0.10| T1: 515.00| I0: 350.00| I1: 100.00| WTP: 0,1,0.096153846,515,0,0,0,350,100,-6301531939,70671723,7535.777347,5924743071,592474307.1,30,57097,2403,1252,1252,0,1252,57097,0,1252,13.70105942,0.38876094,0.38876094,66261.22662,161.6490097,0.97005988,99270.99539,0.666161059,0.001631348,1.16226E-05,0,0.021927597,310,67
D:1| T0: 0.10| T1: 515.00| I0: 350.00| I1: 100.00| WTP: 0,1,0.096153846,515,0,0,0,350,100,-6058755512,1722612191,6214.105308,5748050247,574805024.7,22,52229,2355,1032,1032,0,1032,52229,0,1032,15.80808625,0.367654987,0.367654987,69468.22426,156.0663073,0.930997305,99414.10566,0.697885612,0.00157181,1.11904E-05,0,0.019759894,264,65
D:1| T0: 0.10| T1: 515.00| I0: 350.00| I1: 100.00| WTP: 0,1,0.096153846,515,0,0,0,350,100,-4043899134,1968291596,6238.191368,3731989566,373198956.6,16,52003,2332,1036,1036,0,1036,52003,0,1036,22.37134052,0.604776579,0.604776579,71034.19414,160.7781202,1.399845917,99435.73806,0.711365143,0.001630931,1.61706E-05,0,0.019922311,184,42
D:1| T0: 0.10| T1: 515.00| I0: 350.00| I1: 100.00| WTP: 0,1,0.096153846,515,0,0,0,350,100,-3989368320,1877569084,11610.19241,3408858699,340885869.9,12,82866,3471,1503,1929,426,1503,82866,426,1929,55.19322459,1.686323714,2.207026349,35511.27478,332.9309912,4.100376412,98540.18695,0.351432138,0.003401394,4.40013E-05,0.220954357,0.023267321,113,38
D:1| T0: 0.10| T1: 515.00| I0: 350.00| I1: 100.00| WTP: 0,1,0.096153846,515,0,0,0,350,100,-2617690104,1726322189,10510.51748,2092164230,209216423,4,80847,3467,1284,1746,462,1284,80847,462,1746,75.34554974,2.05061082,2.830715532,36775.30192,478.0401396,5.09947644,98675.57243,0.365249609,0.004865378,5.38327E-05,0.264604811,0.021596349,81,23
D:1| T0: 0.10| T1: 515.00| I0: 350.00| I1: 100.00| WTP: 0,1,0.096153846,515,0,0,0,350,100,-6007160702,307848836,10022.6789,5506026757,550602675.7,16,78471,3314,1662,1665,3,1662,78471,3,1665,36.60545455,1.314545455,1.317272727,44609.50909,249.9018182,2.814545455,98845.78273,0.450420117,0.002519666,3.04714E-05,0.001801802,0.02121803,158,62
D:1| T0: 0.10| T1: 515.00| I0: 350.00| I1: 100.00| WTP: 0,1,0.096153846,515,0,0,0,350,100,-1740860955,1154000220,10409.77525,1220372193,122037219.3,4,83903,3822,870,1729,859,870,83903,859,1729,103.0731707,1.729490022,3.620842572,29189.43681,484.7738359,5.55210643,98584.15743,0.295700585,0.00487807,5.80384E-05,0.496818971,0.020607375,65,13
D:1| T0: 0.10| T1: 515.00| I0: 350.00| I1: 100.00| WTP: 0,1,0.096153846,515,0,0,0,350,100,-5307678099,2028661055,6953.084957,4960023852,496002385.2,28,54383,2394,1155,1155,0,1155,54383,0,1155,15.28275505,0.417400311,0.417400311,67063.43656,148.2610047,1.010875194,99309.50129,0.674638303,0.001492858,1.20259E-05,0,0.021238255,276,56
D:1| T0: 0.10| T1: 515.00| I0: 350.00| I1: 100.00| WTP: 0,1,0.096153846,515,0,0,0,350,100,-12643197567,1629114640,9517.931689,12167300982,1216730098,36,75534,3318,1581,1581,0,1581,75534,0,1581,18.60191083,0.517743403,0.517743403,55187.56961,213.2383985,1.241128298,99096.61328,0.555867687,0.002150378,1.44939E-05,0,0.020930971,314,138
D:1| T0: 0.10| T1: 515.00| I0: 350.00| I1: 100.00| WTP: 0,1,0.096153846,515,0,0,0,350,100,-4058493819,1439048174,11226.04349,3497191645,349719164.5,10,82978,3638,1495,1865,370,1495,82978,370,1865,54.40146879,1.640146879,2.079559364,35278.46389,431.2839657,3.921664627,98570.97552,0.354799915,0.004366216,4.16296E-05,0.198391421,0.022475837,117,39
D:1| T0: 0.10| T1: 515.00| I0: 350.00| I1: 100.00| WTP: 0,1,0.096153846,515,0,0,0,350,100,-1335401807,865227006,11176.59618,776571997.5,77657199.75,2,83612,3494,647,1857,1210,647,83612,1210,1857,115.4037433,1.529411765,4.743315508,33558.27807,600.7433155,6.529411765,98567.06684,0.285799847,0.006532813,7.28688E-05,0.651588584,0.022210262,50,8
D:1| T0: 0.10| T1: 515.00| I0: 350.00| I1: 100.00| WTP: 0,1,0.096153846,515,0,0,0,350,100,-7781273504,890479738,10378.02193,7262372408,726237240.8,16,79040,3475,1702,1724,22,1702,79040,22,1724,25.76399027,0.858272506,0.869829684,38533.76825,343.7354015,1.908759124,98687.95134,0.389719058,0.003466637,2.10079E-05,0.012761021,0.021812017,235,82
D:1| T0: 0.10| T1: 515.00| I0: 350.00| I1: 100.00| WTP: 0,1,0.096153846,515,0,0,0,350,100,-4106044857,1017049163,7410.415224,3735524096,373552409.6,24,57674,2550,1231,1231,0,1231,57674,0,1231,21.47662247,0.655268667,0.655268667,62565.69993,142.7096999,1.512909979,99209.56106,0.630014806,0.001437413,1.72749E-05,0,0.021345217,205,42
D:1| T0: 0.10| T1: 515.00| I0: 350.00| I1: 100.00| WTP: 0,1,0.096153846,515,0,0,0,350,100,-5635658053,1707305064,6549.886768,5308163714,530816371.4,24,51713,2310,1088,1088,0,1088,51713,0,1088,15.0106553,0.389984017,0.389984017,68449.78903,144.2589238,0.973894513,99347.94299,0.686736832,0.001459788,1.17125E-05,0,0.021039197,267,60
D:1| T0: 0.10| T1: 515.00| I0: 350.00| I1: 100.00| WTP: 0,1,0.096153846,515,0,0,0,350,100,-1345482937,400145663,11303.97131,780284371.7,78028437.17,2,83824,3616,714,1878,1164,714,83824,1164,1878,132.8621701,1.935483871,5.328445748,29338.54252,658.4252199,7.416422287,98471.60411,0.297454985,0.006624804,7.65575E-05,0.619808307,0.022404085,49,8
D:1| T0: 0.10| T1: 515.00| I0: 350.00| I1: 100.00| WTP: 0,1,0.096153846,515,0,0,0,350,100,-5214357209,1662654181,8338.595062,4797427456,479742745.6,30,63865,2922,1385,1385,0,1385,63865,0,1385,25.33748271,0.751728907,0.751728907,65281.48064,179.9993084,1.708160443,99284.20055,0.656637422,0.001813202,1.92765E-05,0,0.02168637,207,54
D:1| T0: 0.10| T1: 515.00| I0: 350.00| I1: 100.00| WTP: 0,1,0.096153846,515,0,0,0,350,100,-5132705645,182136456,9940.518839,4635679703,463567970.3,20,82041,3628,1455,1651,196,1455,82041,196,1651,42.21067684,1.196377502,1.376549094,38335.51859,270.128694,2.762631077,98770.37941,0.384536804,0.002736368,2.99789E-05,0.11871593,0.020124084,150,52
D:1| T0: 0.10| T1: 515.00| I0: 350.00| I1: 100.00| WTP: 0,1,0.096153846,515,0,0,0,350,100,-6335497719,979575387,6537.615648,6008616937,600861693.7,24,51107,2316,1086,1086,0,1086,51107,0,1086,13.0527307,0.339453861,0.339453861,70135.52589,160.7080979,0.857344633,99363.05979,0.705290418,0.001617828,1.02769E-05,0,0.021249535,304,68
D:1| T0: 0.10| T1: 515.00| I0: 350.00| I1: 100.00| WTP: 0,1,0.096153846,515,0,0,0,350,100,-5176484293,2142525414,10835.14435,4634727076,463472707.6,12,79447,3472,1717,1800,83,1717,79447,83,1800,38.54504906,1.355040143,1.424620874,39297.5397,277.249777,2.955396967,98639.18287,0.390400687,0.002829991,3.20033E-05,0.046111111,0.022656614,159,52
D:1| T0: 0.10| T1: 515.00| I0: 350.00| I1: 100.00| WTP: 0,1,0.096153846,515,0,0,0,350,100,-5689166926,1464057597,8953.128112,5241510521,524151052.1,12,71844,3177,1476,1487,11,1476,71844,11,1487,32.53306122,1.009795918,1.015510204,46689.69796,219.0906122,2.220408163,98919.86531,0.470835004,0.002209474,2.4369E-05,0.007397445,0.020698487,175,59
D:1| T0: 0.10| T1: 515.00| I0: 350.00| I1: 100.00| WTP: 0,1,0.096153846,515,0,0,0,350,100,-4331692742,364562610,9806.68504,3841358490,384135849,12,74165,3265,1526,1629,103,1526,74165,103,1629,41.89651639,1.363729508,1.464139344,42746.33914,255.704918,3.029713115,98762.54816,0.429209033,0.002590409,3.2728E-05,0.063228975,0.021964835,139,43
D:1| T0: 0.10| T1: 515.00| I0: 350.00| I1: 100.00| WTP: 0,1,0.096153846,515,0,0,0,350,100,-4956342074,40350784,10087.97233,4451943457,445194345.7,12,75391,3179,1584,1676,92,1584,75391,92,1676,33.20630861,1.168797954,1.243819267,40267.052,246.6649616,2.593350384,98687.21228,0.407331783,0.002487553,2.80047E-05,0.054892601,0.022231065,168,50
D:1| T0: 0.10| T1: 515.00| I0: 350.00| I1: 100.00| WTP: 0,1,0.096153846,515,0,0,0,350,100,-6083363170,804064356,7952.105351,5685757902,568575790.2,26,74597,3460,1320,1320,0,1320,74597,0,1320,35.77705452,0.873067535,0.873067535,51059.95769,175.1082181,1.946297803,99142.36697,0.5088875,0.001782452,2.18366E-05,0,0.017695082,174,64
D:1| T0: 0.10| T1: 515.00| I0: 350.00| I1: 100.00| WTP: 0,1,0.096153846,515,0,0,0,350,100,-4979257435,2125493986,8962.140147,4531150428,453115042.8,30,65781,2796,1489,1489,0,1489,65781,0,1489,26.94492526,0.960660897,0.960660897,59324.22502,163.6561762,2.139260425,99079.73958,0.597536,0.001651492,2.3606E-05,0,0.022635715,182,51
D:1| T0: 0.10| T1: 515.00| I0: 350.00| I1: 100.00| WTP: 0,1,0.096153846,515,0,0,0,350,100,-4500278044,23154253,8009.52067,4099802011,409980201.1,12,71098,3178,1326,1330,4,1326,71098,4,1330,45.27134503,1.330994152,1.335672515,54806.94854,221.6608187,2.894736842,99161.35906,0.547194704,0.002254852,3.15674E-05,0.003007519,0.0187071,121,46
D:1| T0: 0.10| T1: 515.00| I0: 350.00| I1: 100.00| WTP: 0,1,0.096153846,515,0,0,0,350,100,-3555389433,1391367689,6941.610778,3208308894,320830889.4,18,52429,2330,1152,1153,1,1152,52429,1,1153,23.88114105,0.715530903,0.716323296,66478.75277,140.2424723,1.634706815,99259.99525,0.666520946,0.001423319,1.85023E-05,0.000867303,0.021991646,179,36
D:1| T0: 0.10| T1: 515.00| I0: 350.00| I1: 100.00| WTP: 0,1,0.096153846,515,0,0,0,350,100,-8030164078,574142276,8560.727855,7602127685,760212768.5,32,67941,2913,1422,1422,0,1422,67941,0,1422,20.93135011,0.614416476,0.614416476,57520.21796,178.48627,1.421624714,99114.20137,0.578508562,0.001803297,1.64147E-05,0,0.020929924,250,86
D:1| T0: 0.10| T1: 515.00| I0: 350.00| I1: 100.00| WTP: 0,1,0.096153846,515,0,0,0,350,100,-7178843609,898736779,5953.759586,6881155630,688115563,30,46425,2065,989,989,0,989,46425,0,989,11.56092058,0.270306859,0.270306859,72688.2139,155.2635379,0.714350181,99412.34838,0.728737155,0.001573633,9.03145E-06,0,0.021303177,315,78
D:1| T0: 0.10| T1: 515.00| I0: 350.00| I1: 100.00| WTP: 0,1,0.096153846,515,0,0,0,350,100,-12420858100,346473503,8474.626528,11997126774,1199712677,32,76382,3613,1407,1407,0,1407,76382,0,1407,22.56997455,0.517557252,0.517557252,54814.62799,220.7984733,1.225445293,99188.64733,0.534547201,0.00230873,1.49627E-05,0,0.01842057,271,136
D:1| T0: 0.10| T1: 515.00| I0: 350.00| I1: 100.00| WTP: 0,1,0.096153846,515,0,0,0,350,100,-11209820102,445552282,8988.026114,10760418796,1076041880,36,70643,3074,1493,1493,0,1493,70643,0,1493,16.26828231,0.468112245,0.468112245,54031.98682,170.920068,1.099489796,99031.26828,0.534075015,0.001763309,1.30803E-05,0,0.021134437,328,122
D:1| T0: 0.10| T1: 515.00| I0: 350.00| I1: 100.00| WTP: 0,1,0.096153846,515,0,0,0,350,100,-1808458216,911758476,10025.15239,1307200596,130720059.6,4,81411,3665,762,1665,903,762,81411,903,1665,69.7224736,1.028657617,2.377073906,29144.78431,344.066365,3.549019608,98580.06033,0.265050457,0.00361095,3.84382E-05,0.542342342,0.020451782,91,14
D:1| T0: 0.10| T1: 515.00| I0: 350.00| I1: 100.00| WTP: 0,1,0.096153846,515,0,0,0,350,100,-4861124639,1464197940,9719.132601,4375168009,437516800.9,12,81100,3637,1428,1614,186,1428,81100,186,1614,39.21025641,1.05982906,1.212820513,32755.45641,404.6188034,2.42991453,98662.98291,0.331451202,0.004078713,2.6192E-05,0.115241636,0.019901356,168,49
D:1| T0: 0.10| T1: 515.00| I0: 350.00| I1: 100.00| WTP: 0,1,0.096153846,515,0,0,0,350,100,-6280122330,500405854,8750.812706,5842581694,584258169.4,30,62190,2640,1454,1454,0,1454,62190,0,1454,19.48767288,0.682501503,0.682501503,60267.4991,151.7997595,1.542994588,99082.76308,0.604475898,0.001541806,1.77317E-05,0,0.023379965,236,66
D:1| T0: 0.10| T1: 515.00| I0: 350.00| I1: 100.00| WTP: 0,1,0.096153846,515,0,0,0,350,100,-6285458495,772037341,10376.25875,5766645558,576664555.8,28,76017,3143,1718,1724,6,1718,76017,6,1724,31.50081301,1.207317073,1.211382114,48598.77317,203.0162602,2.611382114,98851.05447,0.490480953,0.00204833,2.82041E-05,0.003480278,0.022679138,176,65
D:1| T0: 0.10| T1: 515.00| I0: 350.00| I1: 100.00| WTP: 0,1,0.096153846,515,0,0,0,350,100,-3764035254,1543158763,6043.611028,3461854702,346185470.2,20,47894,2052,1004,1004,0,1004,47894,0,1004,15.62405542,0.437657431,0.437657431,72080.55668,145.6120907,1.078085642,99420.81423,0.722416196,0.001476055,1.27972E-05,0,0.02096296,226,39
D:1| T0: 0.10| T1: 515.00| I0: 350.00| I1: 100.00| WTP: 0,1,0.096153846,515,0,0,0,350,100,-3630632925,1604932531,11477.52011,3056756919,305675691.9,14,83593,3503,1395,1907,512,1395,83593,512,1907,56.6824147,1.6167979,2.279527559,36923.09186,322.6942257,4.099737533,98574.20079,0.3603351,0.003325729,4.46612E-05,0.268484531,0.022812915,107,34
D:1| T0: 0.10| T1: 515.00| I0: 350.00| I1: 100.00| WTP: 0,1,0.096153846,515,0,0,0,350,100,-7264848326,539051477,10499.26094,6739885279,673988527.9,16,80940,3553,1696,1744,48,1696,80940,48,1744,29.99527665,0.956815115,0.985155196,39729.71053,312.0499325,2.117408907,98712.59852,0.388801725,0.003215432,2.3901E-05,0.027522936,0.021546825,208,76
D:1| T0: 0.10| T1: 515.00| I0: 350.00| I1: 100.00| WTP: 0,1,0.096153846,515,0,0,0,350,100,-3095805498,1743124675,6591.994254,2766205785,276620578.5,20,52575,2283,1095,1095,0,1095,52575,0,1095,22.79721995,0.68683565,0.68683565,68944.9444,145.475879,1.587080948,99357.31153,0.692069037,0.00147007,1.80643E-05,0,0.020827389,174,31
D:1| T0: 0.10| T1: 515.00| I0: 350.00| I1: 100.00| WTP: 0,1,0.096153846,515,0,0,0,350,100,-11447903951,1965983789,8595.918195,11018108041,1101810804,26,64667,2832,1428,1428,0,1428,64667,0,1428,16.70853081,0.478199052,0.478199052,60856.88152,177.4146919,1.160663507,99146.16919,0.611796542,0.001793569,1.36653E-05,0,0.02208236,301,125
D:1| T0: 0.10| T1: 515.00| I0: 350.00| I1: 100.00| WTP: 0,1,0.096153846,515,0,0,0,350,100,-9048531081,516774280,7947.161774,8651172992,865117299.2,38,63925,2855,1320,1320,0,1320,63925,0,1320,15.94577497,0.406687754,0.406687754,63309.13737,185.6136466,0.996836873,99230.2413,0.636925791,0.001872225,1.20142E-05,0,0.020649198,315,98
D:1| T0: 0.10| T1: 515.00| I0: 350.00| I1: 100.00| WTP: 0,1,0.096153846,515,0,0,0,350,100,-1306194288,86603142,10493.61535,781513521,78151352.1,2,83064,3579,515,1743,1228,515,83064,1228,1743,229.9306931,2.455445545,8.504950495,37292.29208,1066.920792,11.04950495,98757.9604,0.340566859,0.011316743,0.000118645,0.704936854,0.020971781,28,8
D:1| T0: 0.10| T1: 515.00| I0: 350.00| I1: 100.00| WTP: 0,1,0.096153846,515,0,0,0,350,100,-7609733740,1431870609,7385.886895,7240439395,724043939.5,38,59032,2543,1227,1227,0,1227,59032,0,1227,12.61484245,0.325456053,0.325456053,65438.80473,168.2574627,0.837064677,99292.91998,0.658346668,0.001694676,1.02327E-05,0,0.020785337,345,82
D:1| T0: 0.10| T1: 515.00| I0: 350.00| I1: 100.00| WTP: 0,1,0.096153846,515,0,0,0,350,100,-4530599686,1592383984,8616.106879,4099794342,409979434.2,14,69397,3099,1427,1431,4,1427,69397,4,1431,37.74313725,1.201960784,1.207843137,52253.82059,198.722549,2.595098039,99035.06176,0.52549482,0.002007806,2.82767E-05,0.002795248,0.020620488,146,46
D:1| T0: 0.10| T1: 515.00| I0: 350.00| I1: 100.00| WTP: 0,1,0.096153846,515,0,0,0,350,100,-7834502750,1440183867,8087.344859,7430135507,743013550.7,26,67587,3090,1343,1343,0,1343,67587,0,1343,22.06026151,0.569073337,0.569073337,58151.21092,184.8993746,1.336554861,99165.7436,0.585597772,0.0018631,1.53645E-05,0,0.019870685,252,84
D:1| T0: 0.10| T1: 515.00| I0: 350.00| I1: 100.00| WTP: 0,1,0.096153846,515,0,0,0,350,100,-8069917947,1696510588,9312.148058,7604310544,760431054.4,34,70172,3014,1547,1547,0,1547,70172,0,1547,22.4261025,0.707985697,0.707985697,60129.11502,197.3587604,1.626340882,99137.06317,0.605314608,0.001991474,1.85824E-05,0,0.02204583,240,86
D:1| T0: 0.10| T1: 515.00| I0: 350.00| I1: 100.00| WTP: 0,1,0.096153846,515,0,0,0,350,100,-11042069159,895039877,10685.06075,10507816122,1050781612,28,78879,3487,1775,1775,0,1775,78879,0,1775,23.13456464,0.749340369,0.749340369,46578.9562,218.2511873,1.67651715,98793.93193,0.466416244,0.002220004,1.90319E-05,0,0.022503106,269,119
D:1| T0: 0.10| T1: 515.00| I0: 350.00| I1: 100.00| WTP: 0,1,0.096153846,515,0,0,0,350,100,-12825310178,129565953,9756.455002,12337487428,1233748743,38,70224,3069,1621,1621,0,1621,70224,0,1621,15.28947368,0.45465587,0.45465587,60036.09474,200.6959514,1.109311741,99101.07571,0.604424056,0.002026346,1.32382E-05,0,0.023069365,352,140
D:1| T0: 0.10| T1: 515.00| I0: 350.00| I1: 100.00| WTP: 0,1,0.096153846,515,0,0,0,350,100,-5723847865,1902565669,8067.362214,5320479755,532047975.5,30,64110,2881,1340,1340,0,1340,64110,0,1340,20.89326178,0.602265951,0.602265951,57861.23554,145.6905188,1.405485987,99138.77519,0.581519798,0.001472557,1.61271E-05,0,0.020902227,239,60
D:1| T0: 0.10| T1: 515.00| I0: 350.00| I1: 100.00| WTP: 0,1,0.096153846,515,0,0,0,350,100,-9664380892,1984179288,8136.929735,9257534405,925753440.5,44,61587,2528,1352,1352,0,1352,61587,0,1352,11.30583942,0.307664234,0.307664234,64745.24161,169.8,0.808029197,99233.90182,0.648849203,0.001725163,1.00125E-05,0,0.021952685,389,105
D:1| T0: 0.10| T1: 515.00| I0: 350.00| I1: 100.00| WTP: 0,1,0.096153846,515,0,0,0,350,100,-10297798994,677377223,9885.26918,9803535535,980353553.5,20,75984,3366,1642,1642,0,1642,75984,0,1642,21.88676319,0.654601861,0.654601861,45740.78594,317.4550155,1.502068252,98841.92347,0.462044275,0.003201412,1.7112E-05,0,0.021609813,276,111
D:1| T0: 0.10| T1: 515.00| I0: 350.00| I1: 100.00| WTP: 0,1,0.096153846,515,0,0,0,350,100,-14376426472,973583301,9115.665518,13920643197,1392064320,28,72241,3267,1514,1514,0,1514,72241,0,1514,15.16636063,0.392581711,0.392581711,48051.89313,215.8365773,0.959603379,98915.32354,0.484634718,0.002178279,1.1209E-05,0,0.020957628,389,158
D:1| T0: 0.10| T1: 515.00| I0: 350.00| I1: 100.00| WTP: 0,1,0.096153846,515,0,0,0,350,100,-7813762585,781062938,7649.276468,7431298762,743129876.2,30,67414,3144,1270,1270,0,1270,67414,0,1270,22.16443701,0.503344482,0.503344482,57766.86957,171.696767,1.217948718,99223.3456,0.581388725,0.001729188,1.42408E-05,0,0.018838817,257,84
D:1| T0: 0.10| T1: 515.00| I0: 350.00| I1: 100.00| WTP: 0,1,0.096153846,515,0,0,0,350,100,-18143771704,338783425,9109.130454,17688315181,1768831518,38,73996,3241,1513,1513,0,1513,73996,0,1513,13.82892057,0.324847251,0.324847251,57199.86999,205.769518,0.842498303,99119.82315,0.574884181,0.002081101,1.03746E-05,0,0.020447051,420,201
D:1| T0: 0.10| T1: 515.00| I0: 350.00| I1: 125.00| WTP: 0,1,0.096153846,515,0,0,0,350,125,-5801051621,1178568022,7928.094025,5404646920,540464692,32,58900,2613,1317,1317,0,1317,58900,0,1317,17.02420185,0.49330587,0.49330587,63625.56694,156.6143151,1.169412976,99195.69979,0.640597796,0.001578143,1.36462E-05,0,0.022360312,277,61
D:1| T0: 0.10| T1: 515.00| I0: 350.00| I1: 125.00| WTP: 0,1,0.096153846,515,0,0,0,350,125,-6258961316,2029998696,9694.071466,5774257743,577425774.3,22,79503,3502,1602,1610,8,1602,79503,8,1610,38.71656333,1.2170062,1.224092117,43653.59079,237.5420726,2.640389725,98877.80337,0.435579577,0.002416047,2.89111E-05,0.004968944,0.020251572,160,65
D:1| T0: 0.10| T1: 515.00| I0: 350.00| I1: 125.00| WTP: 0,1,0.096153846,515,0,0,0,350,125,-4548410699,776062361,10629.52875,4016934262,401693426.2,10,76251,3229,1506,1766,260,1506,76251,260,1766,33.41782502,1.089125102,1.295175797,36863.07114,384.1291905,2.524938675,98554.4955,0.360020042,0.003954987,2.75346E-05,0.147225368,0.023160352,171,45
D:1| T0: 0.10| T1: 515.00| I0: 350.00| I1: 125.00| WTP: 0,1,0.096153846,515,0,0,0,350,125,-7441584085,1813046880,7530.052922,7065081439,706508143.9,36,56990,2477,1251,1251,0,1251,56990,0,1251,13.11260286,0.365526202,0.365526202,63335.34907,156.3936769,0.901689043,99202.12386,0.637731459,0.001575644,1.08993E-05,0,0.02195122,330,80
D:1| T0: 0.10| T1: 515.00| I0: 350.00| I1: 125.00| WTP: 0,1,0.096153846,515,0,0,0,350,125,-4912265447,2032407216,7593.303141,4532600290,453260029,28,63839,2875,1259,1261,2,1259,63839,2,1261,27.24656489,0.767938931,0.769465649,60054.89237,170.0763359,1.718320611,99220.64733,0.600512802,0.001729728,1.95376E-05,0.001586043,0.019752816,186,51
D:1| T0: 0.10| T1: 515.00| I0: 350.00| I1: 125.00| WTP: 0,1,0.096153846,515,0,0,0,350,125,-5409648591,1507873352,7365.380359,5041379574,504137957.4,30,51319,2125,1224,1224,0,1224,51319,0,1224,11.46929628,0.364858808,0.364858808,72412.60242,166.6723442,0.908561183,99348.21649,0.725966369,0.001692399,1.1125E-05,0,0.023850815,316,57
D:1| T0: 0.10| T1: 515.00| I0: 350.00| I1: 125.00| WTP: 0,1,0.096153846,515,0,0,0,350,125,-3375435785,1855899401,6940.094336,3028431068,302843106.8,18,52606,2240,1153,1153,0,1153,52606,0,1153,23.77439024,0.780487805,0.780487805,70817.30314,170.6864111,1.791811847,99370.81969,0.711808851,0.001719057,2.02034E-05,0,0.021899059,164,34
D:1| T0: 0.10| T1: 515.00| I0: 350.00| I1: 125.00| WTP: 0,1,0.096153846,515,0,0,0,350,125,-6839608232,1819459251,9222.541561,6378481154,637848115.4,26,72047,3091,1532,1532,0,1532,72047,0,1532,29.90703125,0.975,0.975,54780.23516,201.4609375,2.16875,99066.62109,0.551965207,0.002030632,2.41034E-05,0,0.021264487,183,72
D:1| T0: 0.10| T1: 515.00| I0: 350.00| I1: 125.00| WTP: 0,1,0.096153846,515,0,0,0,350,125,-2746055993,909791748,6533.20815,2419395585,241939558.5,20,51497,2334,1085,1085,0,1085,51497,0,1085,24.10039841,0.675697211,0.675697211,66093.56255,132.8167331,1.555378486,99292.05259,0.665074488,0.001336912,1.73711E-05,0,0.021069188,180,27
D:1| T0: 0.10| T1: 515.00| I0: 350.00| I1: 125.00| WTP: 0,1,0.096153846,515,0,0,0,350,125,-5330855950,1339092841,8956.603348,4883025783,488302578.3,18,65333,2716,1488,1488,0,1488,65333,0,1488,32.19025735,1.147977941,1.147977941,58423.62316,215.9696691,2.523897059,99062.78217,0.588954878,0.00217625,2.75324E-05,0,0.022775975,156,55
D:1| T0: 0.10| T1: 515.00| I0: 350.00| I1: 125.00| WTP: 0,1,0.096153846,515,0,0,0,350,125,-6029948634,1365866345,10325.44264,5513676502,551367650.2,24,82535,3589,1699,1715,16,1699,82535,16,1715,40.5103697,1.320108206,1.336339044,45791.51939,233.3444545,2.867448151,98864.96934,0.436512156,0.002465274,3.24867E-05,0.009329446,0.020779315,152,62
D:1| T0: 0.10| T1: 515.00| I0: 350.00| I1: 125.00| WTP: 0,1,0.096153846,515,0,0,0,350,125,-9873824564,825453433,8520.321968,9447808466,944780846.6,28,68198,3123,1415,1415,0,1415,68198,0,1415,23.64800476,0.63549732,0.63549732,56693.62597,206.8910066,1.474091721,99122.52293,0.571074397,0.00208449,1.69652E-05,0,0.020748409,240,107
D:1| T0: 0.10| T1: 515.00| I0: 350.00| I1: 125.00| WTP: 0,1,0.096153846,515,0,0,0,350,125,-6382120521,939711378,10349.54836,5864643102,586464310.2,22,83256,3686,1665,1719,54,1665,83256,54,1719,41.77983349,1.319148936,1.370952821,41316.94172,303.0360777,2.92506938,98807.78723,0.417324277,0.003055949,3.15488E-05,0.031413613,0.020647161,155,66
D:1| T0: 0.10| T1: 515.00| I0: 350.00| I1: 125.00| WTP: 0,1,0.096153846,515,0,0,0,350,125,-10752758749,638950699,8639.206148,10320798441,1032079844,34,68800,3122,1435,1435,0,1435,68800,0,1435,16.4636284,0.448729185,0.448729185,54960.1411,191.7515337,1.07537248,99078.82603,0.553806757,0.001932676,1.26621E-05,0,0.020857558,326,117
D:1| T0: 0.10| T1: 515.00| I0: 350.00| I1: 125.00| WTP: 0,1,0.096153846,515,0,0,0,350,125,-4493755045,938699148,8025.099749,4092500058,409250005.8,24,65411,2873,1333,1333,0,1333,65411,0,1333,28.2907743,0.886326194,0.886326194,61843.20099,182.4390445,1.989291598,99227.47858,0.615124416,0.00187302,2.25157E-05,0,0.020378835,171,46
D:1| T0: 0.10| T1: 515.00| I0: 350.00| I1: 125.00| WTP: 0,1,0.096153846,515,0,0,0,350,125,-8370041079,121790188,6768.060779,8031638040,803163804,38,56637,2620,1124,1124,0,1124,56637,0,1124,11.90518519,0.253333333,0.253333333,64185.60037,151.9796296,0.669259259,99301.1163,0.645697317,0.001530187,8.36988E-06,0,0.019846385,385,91
D:1| T0: 0.10| T1: 515.00| I0: 350.00| I1: 125.00| WTP: 0,1,0.096153846,515,0,0,0,350,125,-5834166814,1331335240,10005.67675,5333882977,533388297.7,14,77704,3351,1551,1662,111,1551,77704,111,1662,35.80050719,1.142857143,1.234150465,38805.91462,434.3896872,2.540997464,98711.7481,0.385540062,0.004426649,2.76697E-05,0.066787004,0.02138886,168,60
D:1| T0: 0.10| T1: 515.00| I0: 350.00| I1: 125.00| WTP: 0,1,0.096153846,515,0,0,0,350,125,-1600416408,470935411,11189.15966,1040958425,104095842.5,2,81563,3470,796,1859,1063,796,81563,1063,1859,96.23026316,1.603070175,3.903508772,32477.86623,463.2214912,5.649122807,98505.36184,0.296268851,0.00488949,6.14923E-05,0.571812803,0.022792197,63,11
D:1| T0: 0.10| T1: 515.00| I0: 350.00| I1: 125.00| WTP: 0,1,0.096153846,515,0,0,0,350,125,-7636742754,823434397,9455.62581,7163961463,716396146.3,30,68023,2919,1571,1571,0,1571,68023,0,1571,22.28290283,0.758302583,0.758302583,57484.26322,214.2183272,1.73800738,99025.55228,0.579531308,0.002160338,1.94645E-05,0,0.02309513,233,81
D:1| T0: 0.10| T1: 515.00| I0: 350.00| I1: 125.00| WTP: 0,1,0.096153846,515,0,0,0,350,125,-2520678625,493045351,7213.054464,2160025902,216002590.2,18,57920,2562,1198,1198,0,1198,57920,0,1198,35.27312775,1.110132159,1.110132159,66073.6652,161.6420705,2.419603524,99321.51982,0.663760644,0.001630318,2.65756E-05,0,0.020683702,130,24
D:1| T0: 0.10| T1: 515.00| I0: 350.00| I1: 125.00| WTP: 0,1,0.096153846,515,0,0,0,350,125,-9108765720,1700216563,7347.478579,8741391791,874139179.1,28,63699,2985,1220,1220,0,1220,63699,0,1220,20.07166124,0.471226927,0.471226927,60371.9164,186.7904452,1.123235613,99247.36754,0.607550184,0.001880703,1.33205E-05,0,0.019152577,264,99
D:1| T0: 0.10| T1: 515.00| I0: 350.00| I1: 125.00| WTP: 0,1,0.096153846,515,0,0,0,350,125,-3843411382,1744119059,7286.482277,3479087268,347908726.8,20,62684,2803,1210,1210,0,1210,62684,0,1210,34.80441324,0.990972919,0.990972919,60976.58977,173.4252758,2.211634905,99265.41825,0.613590875,0.001745419,2.43958E-05,0,0.019287218,143,39
D:1| T0: 0.10| T1: 515.00| I0: 350.00| I1: 125.00| WTP: 0,1,0.096153846,515,0,0,0,350,125,-9230026701,2036906360,8114.610312,8824296185,882429618.5,36,61607,2697,1348,1348,0,1348,61607,0,1348,13.62078652,0.364365971,0.364365971,62964.80859,172.3599518,0.895666132,99211.3744,0.631093759,0.001749401,1.09669E-05,0,0.02188063,353,100
D:1| T0: 0.10| T1: 515.00| I0: 350.00| I1: 125.00| WTP: 0,1,0.096153846,515,0,0,0,350,125,-9774102933,809704121,8333.216515,9357442107,935744210.7,30,68929,3132,1384,1384,0,1384,68929,0,1384,21.27582356,0.567839196,0.567839196,60877.37186,198.5957566,1.341708543,99212.64489,0.612223529,0.00200361,1.55714E-05,0,0.020078632,255,106
D:1| T0: 0.10| T1: 515.00| I0: 350.00| I1: 125.00| WTP: 0,1,0.096153846,515,0,0,0,350,125,-11371059051,1219866412,10252.62547,10858427778,1085842778,30,79440,3527,1700,1703,3,1700,79440,3,1703,22.59076923,0.682564103,0.684102564,42515.55179,333.5651282,1.548717949,98762.81179,0.42975848,0.00336568,1.75921E-05,0.001761597,0.021437563,279,123
D:1| T0: 0.10| T1: 515.00| I0: 350.00| I1: 125.00| WTP: 0,1,0.096153846,515,0,0,0,350,125,-4466643664,843498920,7638.1543,4084735949,408473594.9,30,55316,2388,1269,1269,0,1269,55316,0,1269,18.1464891,0.559322034,0.559322034,67817.12167,161.5780872,1.320823245,99275.13923,0.682414026,0.001627328,1.54519E-05,0,0.022940921,236,46
D:1| T0: 0.10| T1: 515.00| I0: 350.00| I1: 125.00| WTP: 0,1,0.096153846,515,0,0,0,350,125,-12061220052,107351963,10302.17688,11546111209,1154611121,46,71194,2900,1712,1712,0,1712,71194,0,1712,14.58816376,0.493717065,0.493717065,57229.71869,202.2557762,1.192946899,98980.02027,0.576891518,0.002042522,1.39992E-05,0,0.02404697,353,131
D:1| T0: 0.10| T1: 515.00| I0: 350.00| I1: 125.00| WTP: 0,1,0.096153846,515,0,0,0,350,125,-12143661410,773789021,8422.74294,11722524263,1172252426,44,68926,3032,1399,1399,0,1399,68926,0,1399,13.33535498,0.334641456,0.334641456,54063.14984,167.6018552,0.826971102,99076.43418,0.544381741,0.001690926,1.00561E-05,0,0.02029713,401,133
D:1| T0: 0.10| T1: 515.00| I0: 350.00| I1: 125.00| WTP: 0,1,0.096153846,515,0,0,0,350,125,-8406004460,850936611,9153.82663,7948313128,794831312.8,32,67149,2783,1521,1521,0,1521,67149,0,1521,17.37222509,0.591120289,0.591120289,55765.74445,183.0552401,1.384099122,99007.13991,0.559100531,0.001859412,1.5932E-05,0,0.022651119,275,90
D:1| T0: 0.10| T1: 515.00| I0: 350.00| I1: 125.00| WTP: 0,1,0.096153846,515,0,0,0,350,125,-7206809289,1701318364,9541.045464,6729757015,672975701.5,30,71026,3079,1585,1585,0,1585,71026,0,1585,26.28979592,0.863265306,0.863265306,57091.91633,204.847619,1.944897959,99047.93878,0.571853721,0.002082952,2.19008E-05,0,0.022315772,209,76
D:1| T0: 0.10| T1: 515.00| I0: 350.00| I1: 125.00| WTP: 0,1,0.096153846,515,0,0,0,350,125,-8280070754,778708269,6850.046245,7937568441,793756844.1,32,52933,2334,1138,1138,0,1138,52933,0,1138,10.4227071,0.253698225,0.253698225,66610.93528,149.7544379,0.676405325,99306.81324,0.669743565,0.001509304,8.47159E-06,0,0.021499688,386,90
D:1| T0: 0.10| T1: 515.00| I0: 350.00| I1: 125.00| WTP: 0,1,0.096153846,515,0,0,0,350,125,-4431632432,1391938506,8630.15525,4000124670,400012467,26,60421,2565,1434,1434,0,1434,60421,0,1434,24.50588235,0.911372549,0.911372549,63388.41882,169.827451,2.039215686,99138.33569,0.638585208,0.001711727,2.26387E-05,0,0.02373347,183,45
D:1| T0: 0.10| T1: 515.00| I0: 350.00| I1: 125.00| WTP: 0,1,0.096153846,515,0,0,0,350,125,-4016785992,43418681,5851.246293,3724223677,372422367.7,22,45136,1972,972,972,0,972,45136,0,972,15.66390306,0.421556122,0.421556122,73242.23661,161.5663265,1.045280612,99437.9662,0.736120897,0.001624775,1.24505E-05,0,0.021534917,224,42
D:1| T0: 0.10| T1: 515.00| I0: 350.00| I1: 125.00| WTP: 0,1,0.096153846,515,0,0,0,350,125,-3718767123,817384966,11513.24581,3143104832,314310483.2,18,81797,3407,1634,1913,279,1634,81797,279,1913,56.4966443,1.986577181,2.351677852,42210.3745,299.2885906,4.524832215,98692.51946,0.424539586,0.003031148,4.82232E-05,0.145844224,0.023387166,106,35
D:1| T0: 0.10| T1: 515.00| I0: 350.00| I1: 125.00| WTP: 0,1,0.096153846,515,0,0,0,350,125,-5476870865,762053968,9855.775034,4984082113,498408211.3,24,78650,3448,1612,1637,25,1612,78650,25,1637,37.64442493,1.201931519,1.223002634,45234.18174,215.2080773,2.647936787,98873.24407,0.455569675,0.002174208,2.87869E-05,0.015281174,0.020801017,163,56
D:1| T0: 0.10| T1: 515.00| I0: 350.00| I1: 125.00| WTP: 0,1,0.096153846,515,0,0,0,350,125,-10643100114,1692506311,8242.086534,10230995787,1023099579,42,66583,3001,1369,1369,0,1369,66583,0,1369,14.46693069,0.360792079,0.360792079,58497.24436,174.3493069,0.913267327,99173.12673,0.586466382,0.001767292,1.09792E-05,0,0.020561113,358,116
D:1| T0: 0.10| T1: 515.00| I0: 350.00| I1: 125.00| WTP: 0,1,0.096153846,515,0,0,0,350,125,-3708003039,1037620300,6627.028106,3376651634,337665163.4,20,49423,2080,1101,1101,0,1101,49423,0,1101,18.78034682,0.606936416,0.606936416,71443.13006,149.6228324,1.401734104,99377.8815,0.707268783,0.00156409,1.66104E-05,0,0.022277077,191,38
D:1| T0: 0.10| T1: 515.00| I0: 350.00| I1: 125.00| WTP: 0,1,0.096153846,515,0,0,0,350,125,-5078642476,301400999,7554.951251,4700894913,470089491.3,28,58432,2554,1255,1255,0,1255,58432,0,1255,21.83160083,0.661122661,0.661122661,64166.27997,168.0644491,1.530838531,99237.64172,0.645937404,0.00169255,1.7492E-05,0,0.021477957,207,53
D:1| T0: 0.10| T1: 515.00| I0: 350.00| I1: 125.00| WTP: 0,1,0.096153846,515,0,0,0,350,125,-8461879265,1868336855,9987.326853,7962512922,796251292.2,22,76083,3389,1658,1659,1,1658,76083,1,1659,28.995842,0.952875953,0.952875953,49469.75121,204.8669439,2.097713098,98900.95495,0.499057699,0.002067163,2.3163E-05,0.000602773,0.021805134,207,90
D:1| T0: 0.10| T1: 515.00| I0: 350.00| I1: 125.00| WTP: 0,1,0.096153846,515,0,0,0,350,125,-7937080853,1868498144,10023.13088,7435924309,743592430.9,22,76594,3312,1665,1665,0,1665,76594,0,1665,31.72149962,1.042846213,1.042846213,52339.48891,242.8033665,2.313695486,98986,0.527708917,0.002448784,2.56724E-05,0,0.02172579,187,84
D:1| T0: 0.10| T1: 515.00| I0: 350.00| I1: 125.00| WTP: 0,1,0.096153846,515,0,0,0,350,125,-6450540814,2101566889,7013.25094,6099878267,609987826.7,28,55246,2428,1165,1165,0,1165,55246,0,1165,14.885,0.398,0.398,64705.4835,156.75,0.9975,99245.634,0.651358866,0.00157868,1.17124E-05,0,0.0210875,286,69
D:1| T0: 0.10| T1: 515.00| I0: 350.00| I1: 125.00| WTP: 0,1,0.096153846,515,0,0,0,350,125,-2355870782,1665097450,10552.14719,1828263422,182826342.2,6,81760,3475,1051,1753,702,1051,81760,702,1753,75.12105263,1.668421053,2.873684211,37201.14035,491.6719298,4.738596491,98681.5193,0.335093262,0.005276284,5.28078E-05,0.400684932,0.021428834,77,20
D:1| T0: 0.10| T1: 515.00| I0: 350.00| I1: 125.00| WTP: 0,1,0.096153846,515,0,0,0,350,125,-3278988498,1716179948,9569.95825,2800490586,280049058.6,8,83548,3871,1314,1589,275,1314,83548,275,1589,68.82708934,1.695965418,2.073487032,33557.38905,413.4466859,3.972622478,98769.30259,0.33916443,0.004162891,4.21124E-05,0.173064821,0.019019007,100,31
D:1| T0: 0.10| T1: 515.00| I0: 350.00| I1: 125.00| WTP: 0,1,0.096153846,515,0,0,0,350,125,-3510134367,1560278715,7918.434709,3114212632,311421263.2,20,52665,2064,1316,1316,0,1316,52665,0,1316,18.72912128,0.758169935,0.758169935,65911.84749,129.9883805,1.723311547,99156.36383,0.659303416,0.001328237,1.94953E-05,0,0.024988133,193,35
D:1| T0: 0.10| T1: 515.00| I0: 350.00| I1: 125.00| WTP: 0,1,0.096153846,515,0,0,0,350,125,-10665635107,991019385,10239.48173,10153661020,1015366102,32,78459,3355,1700,1701,1,1700,78459,1,1701,24.87507436,0.805472933,0.806067817,46859.80428,275.8661511,1.823319453,98849.82986,0.473120078,0.002783471,2.03934E-05,0.000587889,0.021680113,241,115
D:1| T0: 0.10| T1: 515.00| I0: 350.00| I1: 125.00| WTP: 0,1,0.096153846,515,0,0,0,350,125,-6534021178,118052103,9993.37624,6034352366,603435236.6,16,77963,3384,1622,1660,38,1622,77963,38,1660,33.01416208,1.062155783,1.090479937,44755.28324,310.38631,2.375295043,98839.64516,0.443118607,0.003179713,2.64343E-05,0.022891566,0.021292151,179,68
D:1| T0: 0.10| T1: 515.00| I0: 350.00| I1: 125.00| WTP: 0,1,0.096153846,515,0,0,0,350,125,-4526293328,1209758844,10244.31443,4014077606,401407760.6,12,74503,3145,1672,1702,30,1672,74503,30,1702,42.11231102,1.609071274,1.639308855,47010.26782,235.1598272,3.439524838,98800.45032,0.459653673,0.002439849,3.77692E-05,0.017626322,0.022845331,129,45
D:1| T0: 0.10| T1: 515.00| I0: 350.00| I1: 125.00| WTP: 0,1,0.096153846,515,0,0,0,350,125,-6128043529,70671723,7506.837575,5752701650,575270165,34,57465,2507,1247,1247,0,1247,57465,0,1247,16.32887288,0.444158518,0.444158518,67918.79928,182.5661348,1.079773546,99314.33968,0.682555697,0.001842395,1.29363E-05,0,0.021700165,277,65
D:1| T0: 0.10| T1: 515.00| I0: 350.00| I1: 125.00| WTP: 0,1,0.096153846,515,0,0,0,350,125,-5459638227,1722612191,6496.464398,5134815007,513481500.7,24,52878,2412,1079,1079,0,1079,52878,0,1079,14.45231072,0.354965585,0.354965585,66061.43461,142.7148476,0.8820059,99323.54277,0.664150226,0.001437918,1.06724E-05,0,0.020405848,290,58
D:1| T0: 0.10| T1: 515.00| I0: 350.00| I1: 125.00| WTP: 0,1,0.096153846,515,0,0,0,350,125,-3697064521,1968291596,6345.768203,3379776111,337977611.1,16,52538,2320,1054,1054,0,1054,52538,0,1054,21.42222222,0.622222222,0.622222222,69278.44904,161.8720307,1.424521073,99390.45517,0.693857186,0.001642345,1.63641E-05,0,0.020062433,185,38
D:1| T0: 0.10| T1: 515.00| I0: 350.00| I1: 125.00| WTP: 0,1,0.096153846,515,0,0,0,350,125,-3719005723,1877569084,11442.34102,3146888673,314688867.3,12,82547,3535,1475,1901,426,1475,82547,426,1901,54.53724054,1.601953602,2.108669109,34458.63614,322.2783883,3.918192918,98526.57021,0.340913903,0.003291326,4.21014E-05,0.224092583,0.023029584,116,35
D:1| T0: 0.10| T1: 515.00| I0: 350.00| I1: 125.00| WTP: 0,1,0.096153846,515,0,0,0,350,125,-2699960936,1726322189,10408.33323,2179544274,217954427.4,6,79740,3451,1267,1729,462,1267,79740,462,1729,61.76470588,1.662840746,2.304160689,33887.26399,388.7431851,4.120516499,98597.7604,0.33729638,0.00395037,4.36864E-05,0.267206478,0.021683514,99,24
D:1| T0: 0.10| T1: 515.00| I0: 350.00| I1: 125.00| WTP: 0,1,0.096153846,515,0,0,0,350,125,-5977914811,307848836,9493.287297,5503250446,550325044.6,18,75793,3155,1574,1577,3,1574,75793,3,1577,33.68549088,1.190269331,1.19287576,43805.3093,230.5013032,2.560382276,98841.88358,0.442362386,0.002323461,2.75695E-05,0.001902346,0.020806671,165,62
D:1| T0: 0.10| T1: 515.00| I0: 350.00| I1: 125.00| WTP: 0,1,0.096153846,515,0,0,0,350,125,-1653749366,1154000220,10427.68746,1132364994,113236499.4,4,83824,3795,873,1732,859,873,83824,859,1732,94.7602459,1.62295082,3.370901639,27934.66189,447.3565574,5.153688525,98552.71107,0.283078491,0.004502355,5.37718E-05,0.496244945,0.020651149,70,12
D:1| T0: 0.10| T1: 515.00| I0: 350.00| I1: 125.00| WTP: 0,1,0.096153846,515,0,0,0,350,125,-5208304061,2028661055,6772.074479,4869700337,486970033.7,30,52517,2253,1125,1125,0,1125,52517,0,1125,14.64041995,0.422047244,0.422047244,66874.48294,144.9149606,1.002624672,99296.15696,0.672849302,0.001459058,1.18716E-05,0,0.021421635,273,55
D:1| T0: 0.10| T1: 515.00| I0: 350.00| I1: 125.00| WTP: 0,1,0.096153846,515,0,0,0,350,125,-12264950132,1629114640,9024.499708,11813725147,1181372515,38,72638,3128,1499,1499,0,1499,72638,0,1499,17.96936443,0.481024234,0.481024234,54777.23685,205.7000457,1.173296754,99083.24646,0.55179712,0.002073953,1.38055E-05,0,0.020636581,313,134
D:1| T0: 0.10| T1: 515.00| I0: 350.00| I1: 125.00| WTP: 0,1,0.096153846,515,0,0,0,350,125,-4051603282,1439048174,11099.71948,3496617309,349661730.9,12,81967,3599,1474,1844,370,1474,81967,370,1844,48.2489083,1.418122271,1.810043668,33816.14738,379.3646288,3.420305677,98533.87336,0.340366196,0.00383946,3.66524E-05,0.200650759,0.022496858,131,39
D:1| T0: 0.10| T1: 515.00| I0: 350.00| I1: 125.00| WTP: 0,1,0.096153846,515,0,0,0,350,125,-1335401807,865227006,11176.59618,776571997.5,77657199.75,2,83612,3494,647,1857,1210,647,83612,1210,1857,115.4037433,1.529411765,4.743315508,33558.27807,600.7433155,6.529411765,98567.06684,0.285799847,0.006532813,7.28688E-05,0.651588584,0.022210262,50,8
D:1| T0: 0.10| T1: 515.00| I0: 350.00| I1: 125.00| WTP: 0,1,0.096153846,515,0,0,0,350,125,-7495851974,890479738,9927.620993,6999470924,699947092.4,18,78734,3437,1627,1649,22,1627,78734,22,1649,29.40331492,0.928867403,0.94198895,40206.00622,389.4792818,2.067679558,98755.33287,0.406388389,0.003926699,2.27966E-05,0.013341419,0.020944204,207,79
D:1| T0: 0.10| T1: 515.00| I0: 350.00| I1: 125.00| WTP: 0,1,0.096153846,515,0,0,0,350,125,-4034960052,1017049163,7663.936399,3651763232,365176323.2,26,60861,2679,1273,1273,0,1273,60861,0,1273,23.88945087,0.713872832,0.713872832,61829.43714,156.0419075,1.64017341,99207.87572,0.622492899,0.001571789,1.85003E-05,0,0.020916858,198,41
D:1| T0: 0.10| T1: 515.00| I0: 350.00| I1: 125.00| WTP: 0,1,0.096153846,515,0,0,0,350,125,-5369724553,1707305064,6483.942063,5045527450,504552745,26,52386,2311,1077,1077,0,1077,52386,0,1077,16.18311466,0.419851683,0.419851683,68374.30804,157.7187678,1.035938391,99359.86651,0.685765173,0.001596272,1.24177E-05,0,0.020558928,249,57
D:1| T0: 0.10| T1: 515.00| I0: 350.00| I1: 125.00| WTP: 0,1,0.096153846,515,0,0,0,350,125,-1345482937,400145663,11303.97131,780284371.7,78028437.17,2,83824,3616,714,1878,1164,714,83824,1164,1878,132.8621701,1.935483871,5.328445748,29338.54252,658.4252199,7.416422287,98471.60411,0.297454985,0.006624804,7.65575E-05,0.619808307,0.022404085,49,8
D:1| T0: 0.10| T1: 515.00| I0: 350.00| I1: 125.00| WTP: 0,1,0.096153846,515,0,0,0,350,125,-5190795489,1662654181,7958.696115,4792860683,479286068.3,34,62803,2812,1322,1322,0,1322,62803,0,1322,20.16054502,0.585900474,0.585900474,61411.04799,152.8447867,1.366706161,99212.4378,0.618125572,0.001539868,1.57583E-05,0,0.02104995,242,54
D:1| T0: 0.10| T1: 515.00| I0: 350.00| I1: 125.00| WTP: 0,1,0.096153846,515,0,0,0,350,125,-4776293151,182136456,9838.173287,4284384487,428438448.7,20,81858,3621,1438,1634,196,1438,81858,196,1634,40.59704251,1.12754159,1.302218115,36350.31516,262.0120148,2.647874307,98740.70333,0.364568211,0.002653819,2.87405E-05,0.11995104,0.01996164,154,48
D:1| T0: 0.10| T1: 515.00| I0: 350.00| I1: 125.00| WTP: 0,1,0.096153846,515,0,0,0,350,125,-6487672392,979575387,6128.341286,6181255328,618125532.8,28,49069,2188,1018,1018,0,1018,49069,0,1018,10.51939224,0.25309876,0.25309876,67340.21951,131.9832067,0.656137545,99323.31587,0.67749215,0.001328545,8.17909E-06,0,0.020746296,358,70
D:1| T0: 0.10| T1: 515.00| I0: 350.00| I1: 125.00| WTP: 0,1,0.096153846,515,0,0,0,350,125,-5008937294,2142525414,10961.71644,4460851472,446085147.2,12,80781,3543,1738,1821,83,1738,80781,83,1821,47.06517094,1.633547009,1.716880342,41892.18697,338.2510684,3.598290598,98708.49466,0.415273472,0.003460058,3.88738E-05,0.045579352,0.02254243,132,50
D:1| T0: 0.10| T1: 515.00| I0: 350.00| I1: 125.00| WTP: 0,1,0.096153846,515,0,0,0,350,125,-5183857272,1464057597,9337.958781,4716959333,471695933.3,12,73777,3211,1540,1551,11,1540,73777,11,1551,40.7334004,1.326961771,1.334004024,48892.74748,278.1921529,2.902414487,98955.75755,0.492725293,0.002805601,3.13397E-05,0.007092199,0.021023097,142,53
D:1| T0: 0.10| T1: 515.00| I0: 350.00| I1: 125.00| WTP: 0,1,0.096153846,515,0,0,0,350,125,-4086618067,364562610,10131.54918,3580040608,358004060.8,10,75942,3351,1580,1683,103,1580,75942,103,1683,46.74215247,1.581838565,1.691704036,42450.24103,287.7634529,3.460762332,98752.5796,0.425840831,0.002916847,3.70605E-05,0.061200238,0.02216165,127,40
D:1| T0: 0.10| T1: 515.00| I0: 350.00| I1: 125.00| WTP: 0,1,0.096153846,515,0,0,0,350,125,-4700765648,40350784,10184.88631,4191521332,419152133.2,12,76503,3289,1600,1692,92,1600,76503,92,1692,41.50461538,1.422564103,1.512820513,42304.30154,301.1876923,3.165128205,98741.96205,0.427652239,0.003036649,3.40194E-05,0.054373522,0.02211678,140,47
D:1| T0: 0.10| T1: 515.00| I0: 350.00| I1: 125.00| WTP: 0,1,0.096153846,515,0,0,0,350,125,-5230557451,804064356,8467.9443,4807160236,480716023.6,24,76338,3419,1396,1406,10,1396,76338,10,1406,42.4488978,1.189378758,1.201402806,52161.87976,219.6763527,2.596192385,99129.94088,0.518944865,0.002241718,2.86191E-05,0.007112376,0.018418571,141,54
D:1| T0: 0.10| T1: 515.00| I0: 350.00| I1: 125.00| WTP: 0,1,0.096153846,515,0,0,0,350,125,-4723647130,2125493986,9094.524103,4268920925,426892092.5,30,66637,2768,1511,1511,0,1511,66637,0,1511,29.727897,1.07639485,1.07639485,60352.33133,181.87897,2.369957082,99135.87468,0.607506815,0.001834717,2.61373E-05,0,0.02267509,167,48
D:1| T0: 0.10| T1: 515.00| I0: 350.00| I1: 125.00| WTP: 0,1,0.096153846,515,0,0,0,350,125,-4504202007,23154253,8028.504777,4102776768,410277676.8,14,71136,3278,1329,1333,4,1329,71136,4,1333,45.92978482,1.285390713,1.289920725,53558.7214,214.7519819,2.807474519,99139.14609,0.53475203,0.002184119,3.06267E-05,0.00300075,0.018739544,125,46
D:1| T0: 0.10| T1: 515.00| I0: 350.00| I1: 125.00| WTP: 0,1,0.096153846,515,0,0,0,350,125,-3568428146,1391367689,7182.167192,3209319786,320931978.6,20,54182,2392,1193,1193,0,1193,54182,0,1193,23.41405653,0.721161192,0.721161192,65662.64171,139.2200153,1.633307869,99235.26127,0.658433966,0.001412962,1.84638E-05,0,0.022019602,186,36
D:1| T0: 0.10| T1: 515.00| I0: 350.00| I1: 125.00| WTP: 0,1,0.096153846,515,0,0,0,350,125,-7253677629,574142276,8801.077354,6813623761,681362376.1,30,68195,3028,1462,1462,0,1462,68195,0,1462,23.20925808,0.723525682,0.723525682,57631.5409,197.862397,1.651236525,99098.76157,0.579555089,0.001999518,1.87136E-05,0,0.021438522,225,77
D:1| T0: 0.10| T1: 515.00| I0: 350.00| I1: 125.00| WTP: 0,1,0.096153846,515,0,0,0,350,125,-6618185748,898736779,6945.714877,6270900004,627090000.4,30,52624,2248,1154,1154,0,1154,52624,0,1154,10.75078616,0.274764151,0.274764151,68654.78774,153.5283019,0.735455975,99313.52948,0.688740913,0.001555913,9.1791E-06,0,0.021929158,362,71
D:1| T0: 0.10| T1: 515.00| I0: 350.00| I1: 125.00| WTP: 0,1,0.096153846,515,0,0,0,350,125,-11535674313,346473503,8288.650812,11121241772,1112124177,34,77120,3630,1376,1376,0,1376,77120,0,1376,22.74720812,0.501015228,0.501015228,52895.78223,222.5431472,1.208121827,99178.74619,0.514560596,0.002326444,1.45922E-05,0,0.017842324,272,126
D:1| T0: 0.10| T1: 515.00| I0: 350.00| I1: 125.00| WTP: 0,1,0.096153846,515,0,0,0,350,125,-10367639396,445552282,9607.691027,9887254845,988725484.5,34,73988,3261,1596,1596,0,1596,73988,0,1596,21.32694356,0.637380192,0.637380192,58007.67252,224.9275825,1.486155485,99093.90469,0.57219687,0.002334403,1.76215E-05,0,0.021558424,260,112
D:1| T0: 0.10| T1: 515.00| I0: 350.00| I1: 125.00| WTP: 0,1,0.096153846,515,0,0,0,350,125,-1642291793,911758476,10146.27111,1134978237,113497823.7,4,83127,3793,782,1685,903,782,83127,903,1685,90.01498127,1.31835206,2.992509363,30586.8839,435.7284644,4.47752809,98625.06554,0.272524803,0.004618782,4.9E-05,0.535905045,0.020270189,73,12
D:1| T0: 0.10| T1: 515.00| I0: 350.00| I1: 125.00| WTP: 0,1,0.096153846,515,0,0,0,350,125,-4589652523,1464197940,9574.56553,4110924247,411092424.7,12,81400,3598,1404,1590,186,1404,81400,186,1590,42.59056604,1.14245283,1.311320755,33545.31981,447.8811321,2.649056604,98700.93208,0.339298531,0.004513807,2.84477E-05,0.116981132,0.01953317,152,46
D:1| T0: 0.10| T1: 515.00| I0: 350.00| I1: 125.00| WTP: 0,1,0.096153846,515,0,0,0,350,125,-5585254393,500405854,8823.76559,5144066113,514406611.3,28,64004,2727,1466,1466,0,1466,64004,0,1466,23.32556546,0.789581905,0.789581905,60461.54147,177.3193968,1.800548321,99112.66484,0.605884928,0.001802157,2.03981E-05,0,0.022905176,207,58
D:1| T0: 0.10| T1: 515.00| I0: 350.00| I1: 125.00| WTP: 0,1,0.096153846,515,0,0,0,350,125,-5931023213,772037341,10262.71863,5417887281,541788728.1,30,76884,3256,1700,1705,5,1700,76884,5,1705,31.74662431,1.146147736,1.149324861,47341.62907,199.9245433,2.502779984,98846.6942,0.477809221,0.002017348,2.72562E-05,0.002932551,0.022176842,180,61
D:1| T0: 0.10| T1: 515.00| I0: 350.00| I1: 125.00| WTP: 0,1,0.096153846,515,0,0,0,350,125,-3603306868,1543158763,6302.418146,3288185960,328818596,22,49642,2141,1047,1047,0,1047,49642,0,1047,19.15022422,0.576980568,0.576980568,73918.04036,179.9663677,1.357249626,99452.23393,0.74039855,0.001826691,1.58629E-05,0,0.021091437,190,37
D:1| T0: 0.10| T1: 515.00| I0: 350.00| I1: 125.00| WTP: 0,1,0.096153846,515,0,0,0,350,125,-3463145499,1604932531,11598.24788,2883233105,288323310.5,14,83661,3506,1415,1927,512,1415,83661,512,1927,55.68891688,1.603274559,2.23929471,35261.58564,309.9559194,4.025188917,98532.1927,0.343792835,0.003191953,4.335E-05,0.265697976,0.023033433,112,32
D:1| T0: 0.10| T1: 515.00| I0: 350.00| I1: 125.00| WTP: 0,1,0.096153846,515,0,0,0,350,125,-7177171772,539051477,10475.61323,6653391110,665339111,18,80641,3567,1692,1740,48,1692,80641,48,1740,31.99363057,0.995046001,1.024769993,40627.68153,325.5138004,2.224345364,98723.46426,0.39740484,0.003357672,2.50345E-05,0.027586207,0.021577113,198,75
D:1| T0: 0.10| T1: 515.00| I0: 350.00| I1: 125.00| WTP: 0,1,0.096153846,515,0,0,0,350,125,-3094728527,1743124675,6538.49001,2767804027,276780402.7,24,51268,2305,1086,1086,0,1086,51268,0,1086,21.86590909,0.64469697,0.64469697,67632.96061,131.3954545,1.470454545,99314.99242,0.679189901,0.001327729,1.65945E-05,0,0.021183217,188,31
D:1| T0: 0.10| T1: 515.00| I0: 350.00| I1: 125.00| WTP: 0,1,0.096153846,515,0,0,0,350,125,-10585074139,1965983789,8878.042554,10141172012,1014117201,28,65961,2817,1475,1475,0,1475,65961,0,1475,16.19972132,0.487691593,0.487691593,58545.41245,178.2359498,1.176033442,99082.03251,0.588749227,0.001802268,1.38358E-05,0,0.022362038,307,115
D:1| T0: 0.10| T1: 515.00| I0: 350.00| I1: 125.00| WTP: 0,1,0.096153846,515,0,0,0,350,125,-8848857178,516774280,7584.804457,8469616955,846961695.5,44,60078,2596,1260,1260,0,1260,60078,0,1260,15.97163121,0.438703141,0.438703141,65570.14691,195.1094225,1.071428571,99266.91489,0.659488099,0.001967474,1.28534E-05,0,0.020973085,281,96
D:1| T0: 0.10| T1: 515.00| I0: 350.00| I1: 125.00| WTP: 0,1,0.096153846,515,0,0,0,350,125,-1218850705,86603142,10493.7124,694165085.1,69416508.51,2,83367,3597,515,1743,1228,515,83367,1228,1743,223.1100478,2.373205742,8.220095694,36463.64115,1034.569378,10.67942584,98740.36842,0.333074595,0.010954924,0.000114472,0.704532415,0.020907553,29,7
D:1| T0: 0.10| T1: 515.00| I0: 350.00| I1: 125.00| WTP: 0,1,0.096153846,515,0,0,0,350,125,-7513343636,1431870609,7211.706612,7152758305,715275830.5,42,57180,2522,1198,1198,0,1198,57180,0,1198,11.28597854,0.277099519,0.277099519,62772.19719,146.7584166,0.71809101,99235.00888,0.631865058,0.001478253,8.91434E-06,0,0.020951382,387,81
D:1| T0: 0.10| T1: 515.00| I0: 350.00| I1: 125.00| WTP: 0,1,0.096153846,515,0,0,0,350,125,-4260441634,1592383984,8406.975575,3840092855,384009285.5,14,69738,3146,1392,1396,4,1392,69738,4,1396,39.375,1.150193798,1.156007752,51244.74322,197.875,2.503875969,99041.51066,0.515263689,0.001998814,2.7258E-05,0.00286533,0.020017781,147,43
D:1| T0: 0.10| T1: 515.00| I0: 350.00| I1: 125.00| WTP: 0,1,0.096153846,515,0,0,0,350,125,-7314631562,1440183867,8201.547675,6904554179,690455417.9,28,68870,3107,1362,1362,0,1362,68870,0,1362,25.32488629,0.655620533,0.655620533,59712.1527,215.8622482,1.556855101,99222.25276,0.600982642,0.002174335,1.78096E-05,0,0.01977639,220,78
D:1| T0: 0.10| T1: 515.00| I0: 350.00| I1: 125.00| WTP: 0,1,0.096153846,515,0,0,0,350,125,-7407186227,1696510588,8463.162866,6984028084,698402808.4,34,65283,2783,1406,1406,0,1406,65283,0,1406,21.37935402,0.682710576,0.682710576,60406.1197,194.2134262,1.576314123,99155.83407,0.608065648,0.001958372,1.79348E-05,0,0.021537,226,79
D:1| T0: 0.10| T1: 515.00| I0: 350.00| I1: 125.00| WTP: 0,1,0.096153846,515,0,0,0,350,125,-10431787782,895039877,10792.46677,9892164443,989216444.3,30,79496,3436,1793,1793,0,1793,79496,0,1793,23.04880694,0.775488069,0.775488069,45409.69035,226.5097614,1.74186551,98784.87581,0.454403337,0.002304187,1.97622E-05,0,0.022554878,262,112
D:1| T0: 0.10| T1: 515.00| I0: 350.00| I1: 125.00| WTP: 0,1,0.096153846,515,0,0,0,350,125,-11678020651,129565953,9688.934889,11193573907,1119357391,40,69927,2851,1610,1610,0,1610,69927,0,1610,13.92222222,0.436111111,0.436111111,57798.74563,195.4349206,1.077777778,99037.93056,0.582226687,0.001973425,1.28867E-05,0,0.023024011,359,127
D:1| T0: 0.10| T1: 515.00| I0: 350.00| I1: 125.00| WTP: 0,1,0.096153846,515,0,0,0,350,125,-5544764929,1902565669,7989.368744,5145296491,514529649.1,30,64882,2899,1327,1327,0,1327,64882,0,1327,27.2614786,0.814007782,0.814007782,63306.607,193.2007782,1.847470817,99285.26693,0.635365971,0.001952949,2.08565E-05,0,0.020453144,183,58
D:1| T0: 0.10| T1: 515.00| I0: 350.00| I1: 125.00| WTP: 0,1,0.096153846,515,0,0,0,350,125,-9222060102,1984179288,8082.460744,8817937064,881793706.4,48,58498,2462,1343,1343,0,1343,58498,0,1343,11.21362114,0.317826572,0.317826572,63954.9185,164.869371,0.823595087,99191.18794,0.641014995,0.001675104,1.01432E-05,0,0.022958442,381,100
D:1| T0: 0.10| T1: 515.00| I0: 350.00| I1: 125.00| WTP: 0,1,0.096153846,515,0,0,0,350,125,-10123530535,677377223,9956.524669,9625704301,962570430.1,24,74509,3229,1654,1654,0,1654,74509,0,1654,19.49425837,0.61291866,0.61291866,44261.511,287.4009569,1.399521531,98789.66699,0.447296477,0.002898308,1.5952E-05,0,0.022198661,298,109
D:1| T0: 0.10| T1: 515.00| I0: 350.00| I1: 125.00| WTP: 0,1,0.096153846,515,0,0,0,350,125,-13413884647,973583301,9116.172419,12958076026,1295807603,30,74387,3376,1514,1514,0,1514,74387,0,1514,17.87605753,0.452199662,0.452199662,49292.24746,255.679357,1.085448393,98964.71701,0.496855576,0.00258035,1.2912E-05,0,0.020353019,338,147
D:1| T0: 0.10| T1: 515.00| I0: 350.00| I1: 125.00| WTP: 0,1,0.096153846,515,0,0,0,350,125,-7182055168,781062938,7324.362392,6815837049,681583704.9,34,68337,3150,1216,1216,0,1216,68337,0,1216,20.15979112,0.463707572,0.463707572,53995.96762,163.6093995,1.091383812,99191.9765,0.54356824,0.001647535,1.27707E-05,0,0.017794167,274,77
D:1| T0: 0.10| T1: 515.00| I0: 350.00| I1: 125.00| WTP: 0,1,0.096153846,515,0,0,0,350,125,-16211029480,338783425,9007.244727,15760667244,1576066724,40,73192,3302,1496,1496,0,1496,73192,0,1496,13.50492126,0.310367454,0.310367454,53418.68537,195.8963255,0.802821522,99057.72966,0.537032331,0.001980583,9.91308E-06,0,0.020439392,435,179
D:1| T0: 0.10| T1: 515.00| I0: 400.00| I1: 75.00| WTP: 0,1,0.096153846,515,0,0,0,400,75,-6226765703,1178568022,7758.558113,5838837798,583883779.8,26,56470,2493,1289,1289,0,1289,56470,0,1289,12.94772344,0.372681282,0.372681282,63235.09275,121.7238617,0.922006745,99177.97428,0.636894587,0.001226888,1.09343E-05,0,0.022826684,338,66
D:1| T0: 0.10| T1: 515.00| I0: 400.00| I1: 75.00| WTP: 0,1,0.096153846,515,0,0,0,400,75,-6354118541,2029998696,9779.20173,5865158455,586515845.5,16,81193,3616,1616,1624,8,1616,81193,8,1624,43.53904762,1.30952381,1.317142857,45895.75524,261.3390476,2.865714286,98937.96476,0.457821235,0.002659935,3.13785E-05,0.004926108,0.020001724,149,66
D:1| T0: 0.10| T1: 515.00| I0: 400.00| I1: 75.00| WTP: 0,1,0.096153846,515,0,0,0,400,75,-4589596390,776062361,11387.28853,4020231964,402023196.4,6,80341,3416,1632,1892,260,1632,80341,260,1892,37.26486014,1.245629371,1.465909091,36807.9764,433.8653846,2.907342657,98533.71503,0.35844254,0.004475415,3.17687E-05,0.137420719,0.02354962,159,45
D:1| T0: 0.10| T1: 515.00| I0: 400.00| I1: 75.00| WTP: 0,1,0.096153846,515,0,0,0,400,75,-8243866707,1813046880,7735.27763,7857102826,785710282.6,28,58640,2511,1285,1285,0,1285,58640,0,1285,14.97166744,0.396655829,0.396655829,67302.07106,172.2642824,0.995355318,99272.45007,0.677240651,0.0017358,1.20084E-05,0,0.021914117,308,89
D:1| T0: 0.10| T1: 515.00| I0: 400.00| I1: 75.00| WTP: 0,1,0.096153846,515,0,0,0,400,75,-5522983294,2032407216,7509.631064,5147501740,514750174,24,63205,2926,1247,1247,0,1247,63205,0,1247,25.58379888,0.670391061,0.670391061,61985.51606,153.997905,1.527234637,99268.51746,0.62017646,0.001564829,1.76734E-05,0,0.019729764,203,58
D:1| T0: 0.10| T1: 515.00| I0: 400.00| I1: 75.00| WTP: 0,1,0.096153846,515,0,0,0,400,75,-5873062925,1507873352,6198.952121,5563115319,556311531.9,24,46682,1914,1030,1030,0,1030,46682,0,1030,9.019238169,0.255098115,0.255098115,71382.27703,130.0811851,0.649095806,99361.11466,0.71590197,0.001318838,8.01958E-06,0,0.022065124,368,63
D:1| T0: 0.10| T1: 515.00| I0: 400.00| I1: 75.00| WTP: 0,1,0.096153846,515,0,0,0,400,75,-3540621699,1855899401,6676.852699,3206779064,320677906.4,14,54030,2354,1109,1109,0,1109,54030,0,1109,22.97486253,0.684996072,0.684996072,68919.72584,158.8279654,1.55145326,99368.97879,0.692710173,0.001599615,1.75204E-05,0,0.020525634,182,36
D:1| T0: 0.10| T1: 515.00| I0: 400.00| I1: 75.00| WTP: 0,1,0.096153846,515,0,0,0,400,75,-6567991965,1819459251,9024.760471,6116753941,611675394.1,18,70116,3057,1497,1499,2,1497,70116,2,1499,26.26894702,0.8101945,0.811535882,50380.89604,168.7404427,1.822937626,98967.76593,0.508139309,0.001701032,2.0232E-05,0.001334223,0.021378858,213,69
D:1| T0: 0.10| T1: 515.00| I0: 400.00| I1: 75.00| WTP: 0,1,0.096153846,515,0,0,0,400,75,-3191595794,909791748,6760.043144,2853593637,285359363.7,18,51995,2241,1123,1123,0,1123,51995,0,1123,17.97666883,0.539209332,0.539209332,65936.60596,108.9727803,1.268956578,99274.31367,0.663629445,0.001097773,1.46286E-05,0,0.021598646,221,32
D:1| T0: 0.10| T1: 515.00| I0: 400.00| I1: 75.00| WTP: 0,1,0.096153846,515,0,0,0,400,75,-6220968100,1339092841,9203.235015,5760806349,576080634.9,16,66559,2822,1529,1529,0,1529,66559,0,1529,29.34182416,1.050944947,1.050944947,59359.00904,197.6910435,2.292522597,99083.39934,0.598216404,0.001992779,2.53E-05,0,0.02297279,174,65
D:1| T0: 0.10| T1: 515.00| I0: 400.00| I1: 75.00| WTP: 0,1,0.096153846,515,0,0,0,400,75,-6413017912,1365866345,10914.97373,5867269226,586726922.6,18,84563,3714,1795,1813,18,1795,84563,18,1813,41.88748875,1.397839784,1.414041404,47506.05851,238.3834383,3.04230423,98880.0108,0.454531446,0.002518982,3.42851E-05,0.009928296,0.021440144,152,66
D:1| T0: 0.10| T1: 515.00| I0: 400.00| I1: 75.00| WTP: 0,1,0.096153846,515,0,0,0,400,75,-10487965020,825453433,8555.943577,10060167841,1006016784,22,69453,3040,1421,1421,0,1421,69453,0,1421,18.31238274,0.487335835,0.487335835,52484.55675,166.4840525,1.157598499,99041.85366,0.529017435,0.00167827,1.34193E-05,0,0.020459879,305,114
D:1| T0: 0.10| T1: 515.00| I0: 400.00| I1: 75.00| WTP: 0,1,0.096153846,515,0,0,0,400,75,-6463066068,939711378,10205.58466,5952786835,595278683.5,16,81814,3663,1641,1695,54,1641,81814,54,1695,40.80107527,1.261648746,1.311827957,40969.4991,287.2831541,2.782258065,98799.88262,0.413864591,0.002896921,3.01231E-05,0.031858407,0.020717726,160,67
D:1| T0: 0.10| T1: 515.00| I0: 400.00| I1: 75.00| WTP: 0,1,0.096153846,515,0,0,0,400,75,-11904565985,638950699,8808.591192,11464136425,1146413643,28,72136,3260,1463,1463,0,1463,72136,0,1463,17.49365982,0.439003061,0.439003061,57596.51552,199.7144731,1.07783122,99159.06996,0.579895879,0.002013222,1.28827E-05,0,0.020281136,327,130
D:1| T0: 0.10| T1: 515.00| I0: 400.00| I1: 75.00| WTP: 0,1,0.096153846,515,0,0,0,400,75,-4663433054,938699148,7899.202368,4268472936,426847293.6,20,64596,2861,1312,1312,0,1312,64596,0,1312,28.86164043,0.871582436,0.871582436,62629.02983,179.7075394,1.957746479,99248.02734,0.623073681,0.001844852,2.22895E-05,0,0.020310855,170,48
D:1| T0: 0.10| T1: 515.00| I0: 400.00| I1: 75.00| WTP: 0,1,0.096153846,515,0,0,0,400,75,-8354363759,121790188,6497.116826,8029507917,802950791.7,28,54997,2473,1079,1079,0,1079,54997,0,1079,12.30182685,0.252581414,0.252581414,66942.33042,158.1707705,0.688244639,99369.62708,0.67309851,0.001591933,8.61334E-06,0,0.019619252,359,91
D:1| T0: 0.10| T1: 515.00| I0: 400.00| I1: 75.00| WTP: 0,1,0.096153846,515,0,0,0,400,75,-5929644955,1331335240,10132.24637,5423032636,542303263.6,10,79861,3422,1572,1683,111,1572,79861,111,1683,32.61069277,1.00376506,1.085090361,37218.37123,397.0903614,2.270331325,98690.23268,0.370162266,0.004043008,2.49456E-05,0.065953654,0.021074116,188,61
D:1| T0: 0.10| T1: 515.00| I0: 400.00| I1: 75.00| WTP: 0,1,0.096153846,515,0,0,0,400,75,-1692567502,470935411,11267.42086,1129196459,112919645.9,2,81933,3478,809,1872,1063,809,81933,1063,1872,93.52219873,1.553911205,3.77167019,32056.34672,448.94926,5.477801268,98496.28118,0.293070121,0.004731398,5.97695E-05,0.56784188,0.022848773,65,12
D:1| T0: 0.10| T1: 515.00| I0: 400.00| I1: 75.00| WTP: 0,1,0.096153846,515,0,0,0,400,75,-8507321082,823434397,9329.618786,8040840143,804084014.3,26,68258,2900,1550,1550,0,1550,68258,0,1550,21.08823529,0.689734717,0.689734717,58758.80161,200.4469435,1.58189158,99071.33737,0.592170419,0.0020215,1.8007E-05,0,0.022708294,248,91
D:1| T0: 0.10| T1: 515.00| I0: 400.00| I1: 75.00| WTP: 0,1,0.096153846,515,0,0,0,400,75,-2776114311,493045351,7080.603091,2422084157,242208415.7,14,57390,2557,1176,1176,0,1176,57390,0,1176,29.630394,0.897748593,0.897748593,65204.88555,136.6444653,1.994371482,99304.05441,0.655280849,0.001378168,2.22148E-05,0,0.020491375,152,27
D:1| T0: 0.10| T1: 515.00| I0: 400.00| I1: 75.00| WTP: 0,1,0.096153846,515,0,0,0,400,75,-9462422913,1700216563,7443.0221,9090271808,909027180.8,20,65636,2930,1236,1236,0,1236,65636,0,1236,19.89450305,0.499167129,0.499167129,61337.05664,197.388673,1.178789561,99271.88673,0.617116433,0.00198779,1.38034E-05,0,0.018831129,258,103
D:1| T0: 0.10| T1: 515.00| I0: 400.00| I1: 75.00| WTP: 0,1,0.096153846,515,0,0,0,400,75,-4369022597,1744119059,7274.545634,4005295315,400529531.5,18,62278,2845,1208,1208,0,1208,62278,0,1208,30.71855761,0.849604222,0.849604222,60399.69481,151.7897977,1.918205805,99235.97625,0.607977811,0.001528489,2.1359E-05,0,0.019397521,163,45
D:1| T0: 0.10| T1: 515.00| I0: 400.00| I1: 75.00| WTP: 0,1,0.096153846,515,0,0,0,400,75,-9740360577,2036906360,7944.126862,9343154234,934315423.4,28,58966,2508,1320,1320,0,1320,58966,0,1320,11.73022152,0.34414557,0.34414557,64340.49565,162.0150316,0.869066456,99214.12104,0.645229294,0.001644222,1.05836E-05,0,0.022385782,358,106
D:1| T0: 0.10| T1: 515.00| I0: 400.00| I1: 75.00| WTP: 0,1,0.096153846,515,0,0,0,400,75,-9828076615,809704121,7695.993957,9443276917,944327691.7,24,67140,3063,1278,1278,0,1278,67140,0,1278,19.54874214,0.467505241,0.467505241,59836.35639,180.6740042,1.139412998,99248.27621,0.601688701,0.001821805,1.34894E-05,0,0.019034853,272,107
D:1| T0: 0.10| T1: 515.00| I0: 400.00| I1: 75.00| WTP: 0,1,0.096153846,515,0,0,0,400,75,-12072347112,1219866412,10276.26857,11558533683,1155853368,24,80274,3509,1704,1707,3,1704,80274,3,1707,21.30436917,0.64604811,0.647520864,42821.70839,322.2385862,1.488463427,98784.61807,0.43277308,0.003251544,1.68811E-05,0.001757469,0.021264669,291,131
D:1| T0: 0.10| T1: 515.00| I0: 400.00| I1: 75.00| WTP: 0,1,0.096153846,515,0,0,0,400,75,-4818493213,843498920,7662.208053,4435382811,443538281.1,24,56672,2438,1273,1273,0,1273,56672,0,1273,18.64049844,0.595015576,0.595015576,70647.52025,169.4623053,1.390031153,99358.8,0.710325331,0.001706685,1.59545E-05,0,0.022462592,230,50
D:1| T0: 0.10| T1: 515.00| I0: 400.00| I1: 75.00| WTP: 0,1,0.096153846,515,0,0,0,400,75,-12319230881,107351963,10188.33686,11809814038,1180981404,36,71810,2942,1693,1693,0,1693,71810,0,1693,15.89616056,0.535776614,0.535776614,60233.37216,219.3132635,1.279232112,99068.80454,0.606791142,0.002214482,1.48994E-05,0,0.023576104,328,134
D:1| T0: 0.10| T1: 515.00| I0: 400.00| I1: 75.00| WTP: 0,1,0.096153846,515,0,0,0,400,75,-11750055792,773789021,9264.399976,11286835793,1128683579,30,71788,3111,1539,1539,0,1539,71788,0,1539,16.73373807,0.471379011,0.471379011,58246.94102,212.385516,1.146140503,99130.26106,0.586278918,0.002143353,1.34572E-05,0,0.021438123,330,128
D:1| T0: 0.10| T1: 515.00| I0: 400.00| I1: 75.00| WTP: 0,1,0.096153846,515,0,0,0,400,75,-9624254323,850936611,8902.776675,9179115489,917911548.9,28,67881,2946,1479,1479,0,1479,67881,0,1479,19.07724868,0.578835979,0.578835979,59439.70212,189.8703704,1.373544974,99115.63122,0.595768599,0.001928758,1.58766E-05,0,0.021788129,268,104
D:1| T0: 0.10| T1: 515.00| I0: 400.00| I1: 75.00| WTP: 0,1,0.096153846,515,0,0,0,400,75,-7457470982,1701318364,9324.380981,6991251933,699125193.3,24,69816,2962,1549,1549,0,1549,69816,0,1549,24.00126823,0.785668992,0.785668992,57318.81484,186.544071,1.753329106,99059.50729,0.574423763,0.001895727,1.99373E-05,0,0.022186891,224,79
D:1| T0: 0.10| T1: 515.00| I0: 400.00| I1: 75.00| WTP: 0,1,0.096153846,515,0,0,0,400,75,-8453764760,778708269,6790.463114,8114241604,811424160.4,24,54164,2350,1128,1128,0,1128,54164,0,1128,12.36158433,0.296848382,0.296848382,69952.70997,176.1277683,0.77427598,99384.87138,0.702873475,0.001775173,9.6709E-06,0,0.020825641,335,92
D:1| T0: 0.10| T1: 515.00| I0: 400.00| I1: 75.00| WTP: 0,1,0.096153846,515,0,0,0,400,75,-4579519086,1391938506,8136.78506,4172679833,417267983.3,22,58036,2383,1352,1352,0,1352,58036,0,1352,19.80743692,0.705179283,0.705179283,61075.61355,137.5763612,1.610889774,99108.97543,0.615530875,0.001386511,1.80649E-05,0,0.023295885,216,47
D:1| T0: 0.10| T1: 515.00| I0: 400.00| I1: 75.00| WTP: 0,1,0.096153846,515,0,0,0,400,75,-4735924694,43418681,6164.256797,4427711854,442771185.4,18,48640,2094,1024,1024,0,1024,48640,0,1024,14.76168757,0.389395667,0.389395667,72377.66762,156.668187,0.970923603,99431.9236,0.727422939,0.001576163,1.17295E-05,0,0.021052632,251,50
D:1| T0: 0.10| T1: 515.00| I0: 400.00| I1: 75.00| WTP: 0,1,0.096153846,515,0,0,0,400,75,-4043538409,817384966,11020.35889,3492520464,349252046.4,16,78511,3322,1546,1831,285,1546,78511,285,1831,44.42110874,1.447761194,1.744136461,39764.39765,228.1449893,3.402985075,98621.81023,0.40059223,0.00230908,3.64295E-05,0.155652649,0.023322167,134,39
D:1| T0: 0.10| T1: 515.00| I0: 400.00| I1: 75.00| WTP: 0,1,0.096153846,515,0,0,0,400,75,-6162238886,762053968,9513.864621,5686545655,568654565.5,22,79485,3453,1555,1580,25,1555,79485,25,1580,38.40753725,1.148992112,1.170026293,48448.73532,216.7537248,2.539000876,98988.83874,0.487646473,0.002189129,2.77202E-05,0.015822785,0.019878715,163,64
D:1| T0: 0.10| T1: 515.00| I0: 400.00| I1: 75.00| WTP: 0,1,0.096153846,515,0,0,0,400,75,-10560582227,1692506311,8279.240584,10146620198,1014662020,30,68397,3047,1375,1375,0,1375,68397,0,1375,17.28064661,0.42882802,0.42882802,61338.66771,204.1198922,1.044454423,99245.8855,0.614641606,0.002070392,1.25126E-05,0,0.020103221,315,115
D:1| T0: 0.10| T1: 515.00| I0: 400.00| I1: 75.00| WTP: 0,1,0.096153846,515,0,0,0,400,75,-4225149906,1037620300,6482.365585,3901031627,390103162.7,16,50519,2117,1077,1077,0,1077,50519,0,1077,17.18972603,0.552739726,0.552739726,72259.61027,145.7335616,1.285616438,99425.33014,0.716028801,0.001520265,1.53701E-05,0,0.021318712,202,44
D:1| T0: 0.10| T1: 515.00| I0: 400.00| I1: 75.00| WTP: 0,1,0.096153846,515,0,0,0,400,75,-5241271190,301400999,7308.58709,4875841836,487584183.6,22,58851,2585,1214,1214,0,1214,58851,0,1214,20.12828736,0.583707505,0.583707505,63705.89031,156.6228352,1.361128929,99255.6966,0.641212293,0.001577324,1.56591E-05,0,0.020628367,223,55
D:1| T0: 0.10| T1: 515.00| I0: 400.00| I1: 75.00| WTP: 0,1,0.096153846,515,0,0,0,400,75,-6614127775,1868336855,9902.324759,6119011537,611901153.7,16,75690,3319,1620,1645,25,1620,75690,25,1645,29.61936438,1.006651885,1.025868441,43863.81301,218.1093865,2.2172949,98793.64523,0.44322341,0.002199812,2.43145E-05,0.015197568,0.021733386,194,69
D:1| T0: 0.10| T1: 515.00| I0: 400.00| I1: 75.00| WTP: 0,1,0.096153846,515,0,0,0,400,75,-8547249101,1868498144,9980.627894,8048217706,804821770.6,18,77407,3410,1658,1658,0,1658,77407,0,1658,28.14453665,0.921161826,0.921161826,51465.3769,221.9488243,2.072614108,98963.83057,0.519023973,0.002239261,2.31079E-05,0,0.021406333,207,91
D:1| T0: 0.10| T1: 515.00| I0: 400.00| I1: 75.00| WTP: 0,1,0.096153846,515,0,0,0,400,75,-6899982271,2101566889,7194.150296,6540274756,654027475.6,22,57728,2546,1195,1195,0,1195,57728,0,1195,17.1045354,0.476769912,0.476769912,67652.75387,180.5038717,1.139933628,99335.71958,0.680404524,0.001817381,1.32911E-05,0,0.020683204,259,74
D:1| T0: 0.10| T1: 515.00| I0: 400.00| I1: 75.00| WTP: 0,1,0.096153846,515,0,0,0,400,75,-2601844806,1665097450,10245.31546,2089579033,208957903.3,6,80455,3404,1000,1702,702,1000,80455,702,1702,57.63324176,1.228021978,2.171703297,34397.8228,378.6744505,3.541208791,98618.49313,0.315002484,0.004008614,3.92897E-05,0.412455934,0.021154683,99,23
D:1| T0: 0.10| T1: 515.00| I0: 400.00| I1: 75.00| WTP: 0,1,0.096153846,515,0,0,0,400,75,-3606619627,1716179948,9172.57146,3147991054,314799105.4,8,81051,3740,1248,1523,275,1248,81051,275,1523,47.29599178,1.144912641,1.414182939,30153.64954,285.9280576,2.701952724,98708.49126,0.305048204,0.002880153,2.86728E-05,0.180564675,0.018790638,139,35
D:1| T0: 0.10| T1: 515.00| I0: 400.00| I1: 75.00| WTP: 0,1,0.096153846,515,0,0,0,400,75,-3655114774,1560278715,7365.08554,3286860497,328686049.7,16,48736,1948,1224,1224,0,1224,48736,0,1224,21.64973262,0.890374332,0.890374332,70554.61586,148.3868093,1.960784314,99269.9902,0.705116578,0.001519822,2.23102E-05,0,0.025114905,157,37
D:1| T0: 0.10| T1: 515.00| I0: 400.00| I1: 75.00| WTP: 0,1,0.096153846,515,0,0,0,400,75,-11016295805,991019385,10292.69881,10501660865,1050166086,24,76710,3285,1709,1710,1,1709,76710,1,1710,23.39883382,0.806413994,0.806997085,47303.55977,264.290379,1.805247813,98841.47289,0.47768428,0.002666555,2.0096E-05,0.000584795,0.022291748,245,119
D:1| T0: 0.10| T1: 515.00| I0: 400.00| I1: 75.00| WTP: 0,1,0.096153846,515,0,0,0,400,75,-6784734463,118052103,9806.279589,6294420484,629442048.4,12,74915,3216,1591,1629,38,1591,74915,38,1629,31.0632716,1.026234568,1.054012346,45775.89429,291.7106481,2.287037037,98843.24923,0.453843018,0.002986758,2.54232E-05,0.023327195,0.021744934,183,71
D:1| T0: 0.10| T1: 515.00| I0: 400.00| I1: 75.00| WTP: 0,1,0.096153846,515,0,0,0,400,75,-4776590681,1209758844,10039.33565,4274623899,427462389.9,10,73683,3055,1638,1668,30,1638,73683,30,1668,38.39938713,1.48927477,1.517875383,46928.3667,220.1940756,3.186925434,98800.09499,0.459694264,0.002281228,3.49459E-05,0.017985612,0.022637515,137,48
D:1| T0: 0.10| T1: 515.00| I0: 400.00| I1: 75.00| WTP: 0,1,0.096153846,515,0,0,0,400,75,-6495617337,70671723,7884.567203,6101388977,610138897.7,26,58473,2501,1310,1310,0,1310,58473,0,1310,15.95636172,0.488433228,0.488433228,69126.46845,188.9342797,1.178759201,99315.8775,0.694659397,0.001907343,1.38877E-05,0,0.022403502,272,69
D:1| T0: 0.10| T1: 515.00| I0: 400.00| I1: 75.00| WTP: 0,1,0.096153846,515,0,0,0,400,75,-6276608514,1722612191,5407.80102,6006218463,600621846.3,20,47035,2149,898,898,0,898,47035,0,898,14.2224,0.306133333,0.306133333,71009.8832,138.3109333,0.792,99458.13813,0.713212451,0.001392528,9.62693E-06,0,0.019092165,267,68
D:1| T0: 0.10| T1: 515.00| I0: 400.00| I1: 75.00| WTP: 0,1,0.096153846,515,0,0,0,400,75,-3945043603,1968291596,6039.565267,3643065340,364306534,14,52523,2354,1003,1003,0,1003,52523,0,1003,21.40740741,0.563869992,0.563869992,71146.83296,157.8049887,1.326530612,99454.7619,0.712430929,0.001600514,1.53549E-05,0,0.019096396,188,41
D:1| T0: 0.10| T1: 515.00| I0: 400.00| I1: 75.00| WTP: 0,1,0.096153846,515,0,0,0,400,75,-3972552271,1877569084,11315.22146,3406791198,340679119.8,10,82685,3441,1454,1880,426,1454,82685,426,1880,49.45496536,1.490762125,1.969976905,34569.54503,304.6258661,3.655889145,98542.94111,0.342479703,0.003109131,3.9293E-05,0.226595745,0.022736893,123,38
D:1| T0: 0.10| T1: 515.00| I0: 400.00| I1: 75.00| WTP: 0,1,0.096153846,515,0,0,0,400,75,-2700233557,1726322189,10402.51018,2180108048,218010804.8,4,80276,3473,1266,1728,462,1266,80276,462,1728,64.877429,1.729446936,2.397608371,34691.33782,406.7249626,4.289985052,98626.52466,0.34516223,0.004134407,4.54979E-05,0.267361111,0.021526004,95,24
D:1| T0: 0.10| T1: 515.00| I0: 400.00| I1: 75.00| WTP: 0,1,0.096153846,515,0,0,0,400,75,-6013336824,307848836,10160.55958,5505308845,550530884.5,12,79085,3279,1685,1688,3,1685,79085,3,1688,35.67383513,1.297491039,1.300179211,44391.71237,247.9775986,2.811827957,98842.21147,0.448204392,0.002500473,3.04537E-05,0.001777251,0.021344393,160,62
D:1| T0: 0.10| T1: 515.00| I0: 400.00| I1: 75.00| WTP: 0,1,0.096153846,515,0,0,0,400,75,-1723337374,1154000220,10067.32995,1219970877,121997087.7,4,82380,3756,813,1672,859,813,82380,859,1672,92.60279441,1.453093812,3.155688623,28445.01198,428.2714571,4.77245509,98578.1976,0.288243228,0.004309976,4.99475E-05,0.513755981,0.020297174,72,13
D:1| T0: 0.10| T1: 515.00| I0: 400.00| I1: 75.00| WTP: 0,1,0.096153846,515,0,0,0,400,75,-4864271722,2028661055,6910.080597,4518767692,451876769.2,20,53973,2323,1148,1148,0,1148,53973,0,1148,16.18651026,0.483870968,0.483870968,69317.18299,164.8721408,1.145454545,99337.05689,0.697260298,0.001660086,1.3536E-05,0,0.021269894,244,51
D:1| T0: 0.10| T1: 515.00| I0: 400.00| I1: 75.00| WTP: 0,1,0.096153846,515,0,0,0,400,75,-13397375743,1629114640,8886.362595,12953057613,1295305761,32,70940,3113,1476,1476,0,1476,70940,0,1476,18.87867116,0.512277323,0.512277323,58545.53683,211.8651902,1.230621088,99150.77179,0.589532378,0.00213574,1.43116E-05,0,0.020806608,297,147
D:1| T0: 0.10| T1: 515.00| I0: 400.00| I1: 75.00| WTP: 0,1,0.096153846,515,0,0,0,400,75,-4312063114,1439048174,11051.65699,3759480264,375948026.4,10,81408,3572,1466,1836,370,1466,81408,370,1836,47.32475884,1.392282958,1.777063237,34304.17256,370.2068596,3.34619507,98538.17899,0.345381737,0.003746555,3.5808E-05,0.201525054,0.022553343,133,42
D:1| T0: 0.10| T1: 515.00| I0: 400.00| I1: 75.00| WTP: 0,1,0.096153846,515,0,0,0,400,75,-1416272826,865227006,11044.42522,864051565,86405156.5,2,82841,3471,625,1835,1210,625,82841,1210,1835,84.50784314,1.096078431,3.452941176,30336.21373,435.7568627,4.682352941,98486.00784,0.266874595,0.00464258,5.14228E-05,0.659400545,0.022150867,69,9
D:1| T0: 0.10| T1: 515.00| I0: 400.00| I1: 75.00| WTP: 0,1,0.096153846,515,0,0,0,400,75,-6789926101,890479738,9878.834331,6295984384,629598438.4,12,77835,3340,1584,1641,57,1584,77835,57,1641,29.4853257,0.94488189,0.983536149,38797.14746,399.4509664,2.13027917,98733.78597,0.392335699,0.004026372,2.326E-05,0.034734918,0.02108306,200,71
D:1| T0: 0.10| T1: 515.00| I0: 400.00| I1: 75.00| WTP: 0,1,0.096153846,515,0,0,0,400,75,-4304352681,1017049163,7790.110077,3914847177,391484717.7,22,63074,2738,1294,1294,0,1294,63074,0,1294,26.31394422,0.820717131,0.820717131,65968.38486,179.6780876,1.84940239,99299.71793,0.663609552,0.001809694,2.07391E-05,0,0.020515585,180,44
D:1| T0: 0.10| T1: 515.00| I0: 400.00| I1: 75.00| WTP: 0,1,0.096153846,515,0,0,0,400,75,-5873585307,1707305064,6086.83858,5569243378,556924337.8,20,50975,2242,1011,1011,0,1011,50975,0,1011,13.46485149,0.328217822,0.328217822,68534.69158,132.0232673,0.83019802,99374.21683,0.687589406,0.001335443,1.01057E-05,0,0.019833252,288,63
D:1| T0: 0.10| T1: 515.00| I0: 400.00| I1: 75.00| WTP: 0,1,0.096153846,515,0,0,0,400,75,-1345482937,400145663,11303.97131,780284371.7,78028437.17,2,83824,3616,714,1878,1164,714,83824,1164,1878,132.8621701,1.935483871,5.328445748,29338.54252,658.4252199,7.416422287,98471.60411,0.297454985,0.006624804,7.65575E-05,0.619808307,0.022404085,49,8
D:1| T0: 0.10| T1: 515.00| I0: 400.00| I1: 75.00| WTP: 0,1,0.096153846,515,0,0,0,400,75,-5096354843,1662654181,7879.732162,4702368235,470236823.5,24,63156,2690,1309,1309,0,1309,63156,0,1309,19.70171149,0.619193154,0.619193154,61206.9187,158.8704156,1.417481663,99217.45782,0.616112883,0.00160053,1.60979E-05,0,0.020726783,234,53
D:1| T0: 0.10| T1: 515.00| I0: 400.00| I1: 75.00| WTP: 0,1,0.096153846,515,0,0,0,400,75,-4712384021,182136456,10277.2169,4198523176,419852317.6,14,83819,3677,1510,1707,197,1510,83819,197,1707,47.16965227,1.401475237,1.602739726,38250.21602,306.3435195,3.186512118,98764.34773,0.38330051,0.00310493,3.43459E-05,0.115407147,0.020365311,135,47
D:1| T0: 0.10| T1: 515.00| I0: 400.00| I1: 75.00| WTP: 0,1,0.096153846,515,0,0,0,400,75,-7083462796,979575387,5791.752161,6793875188,679387518.8,22,48247,2080,962,962,0,962,48247,0,962,11.22492401,0.261398176,0.261398176,70925.87625,140.887538,0.680851064,99431.16153,0.712844707,0.001417405,8.39102E-06,0,0.019939064,329,77
D:1| T0: 0.10| T1: 515.00| I0: 400.00| I1: 75.00| WTP: 0,1,0.096153846,515,0,0,0,400,75,-5156296127,2142525414,10456.36193,4633478030,463347803,10,77910,3423,1654,1737,83,1654,77910,83,1737,38.92876712,1.318721461,1.389954338,39806.60091,278.9479452,2.905022831,98677.70502,0.39535791,0.002847267,3.15872E-05,0.047783535,0.022294956,155,52
D:1| T0: 0.10| T1: 515.00| I0: 400.00| I1: 75.00| WTP: 0,1,0.096153846,515,0,0,0,400,75,-5494829628,1464057597,8675.208409,5061069208,506106920.8,10,68614,2998,1430,1441,11,1430,68614,11,1441,33.17886179,1.100271003,1.106594399,48862.78771,231.195122,2.420957543,98959.07046,0.492606504,0.002330508,2.61231E-05,0.007633588,0.021001545,158,57
D:1| T0: 0.10| T1: 515.00| I0: 400.00| I1: 75.00| WTP: 0,1,0.096153846,515,0,0,0,400,75,-4567866032,364562610,9325.363168,4101597874,410159787.4,10,71653,3176,1446,1549,103,1446,71653,103,1549,40.11518858,1.30479103,1.404689093,43278.17635,245.3751274,2.874617737,98788.85933,0.434585346,0.002485138,3.08964E-05,0.066494513,0.021618679,140,46
D:1| T0: 0.10| T1: 515.00| I0: 400.00| I1: 75.00| WTP: 0,1,0.096153846,515,0,0,0,400,75,-4525640497,40350784,10167.24607,4017278193,401727819.3,8,77310,3309,1597,1689,92,1597,77310,92,1689,42.78125,1.472916667,1.564583333,42095.92813,309.35,3.226041667,98745.58854,0.425503164,0.003118994,3.44869E-05,0.054470101,0.021847109,138,45
D:1| T0: 0.10| T1: 515.00| I0: 400.00| I1: 75.00| WTP: 0,1,0.096153846,515,0,0,0,400,75,-5396350194,804064356,8263.944713,4983152958,498315295.8,20,75112,3421,1352,1372,20,1352,75112,20,1372,36.01760268,0.933780386,0.948868399,47617.90193,181.9723386,2.080469405,99061.53646,0.474201578,0.001852992,2.32251E-05,0.014577259,0.018266299,169,56
D:1| T0: 0.10| T1: 515.00| I0: 400.00| I1: 75.00| WTP: 0,1,0.096153846,515,0,0,0,400,75,-4836873933,2125493986,9616.855109,4356031178,435603117.8,24,67112,2746,1598,1598,0,1598,67112,0,1598,28.17700579,1.112489661,1.112489661,60258.22911,175.3416046,2.416873449,99066.3598,0.60693368,0.001769898,2.66478E-05,0,0.023810943,173,49
D:1| T0: 0.10| T1: 515.00| I0: 400.00| I1: 75.00| WTP: 0,1,0.096153846,515,0,0,0,400,75,-4924997403,23154253,7745.160962,4537739355,453773935.5,12,67945,3130,1282,1286,4,1282,67945,4,1286,38.54935194,1.079760718,1.083748754,52765.35095,180.8983051,2.380857428,99115.29212,0.527444839,0.001837647,2.59758E-05,0.00311042,0.018927073,142,51
D:1| T0: 0.10| T1: 515.00| I0: 400.00| I1: 75.00| WTP: 0,1,0.096153846,515,0,0,0,400,75,-3748420581,1391367689,7254.572126,3385691975,338569197.5,16,54787,2445,1205,1205,0,1205,54787,0,1205,26.77673225,0.807527802,0.807527802,68453.24636,157.8417451,1.851154833,99314.56116,0.68592451,0.001602787,2.09016E-05,0,0.021976016,166,38
D:1| T0: 0.10| T1: 515.00| I0: 400.00| I1: 75.00| WTP: 0,1,0.096153846,515,0,0,0,400,75,-7775760313,574142276,8717.138167,7339903405,733990340.5,24,69436,2975,1448,1448,0,1448,69436,0,1448,23.55427842,0.722860792,0.722860792,60072.63538,203.7126437,1.643039591,99172.32375,0.60385253,0.002058585,1.86635E-05,0,0.020853736,224,83
D:1| T0: 0.10| T1: 515.00| I0: 400.00| I1: 75.00| WTP: 0,1,0.096153846,515,0,0,0,400,75,-7199462800,898736779,6338.508981,6882537351,688253735.1,24,49190,2142,1053,1053,0,1053,49190,0,1053,9.782544379,0.219304734,0.219304734,69875.92382,134.1087278,0.61760355,99361.62019,0.700977319,0.001358083,7.87334E-06,0,0.02140679,384,78
D:1| T0: 0.10| T1: 515.00| I0: 400.00| I1: 75.00| WTP: 0,1,0.096153846,515,0,0,0,400,75,-12325934807,346473503,8271.342067,11912367704,1191236770,26,78862,3812,1373,1373,0,1373,78862,0,1373,22.12494016,0.464337003,0.464337003,52758.48923,215.1139301,1.128291048,99185.90378,0.514153284,0.00224423,1.37016E-05,0,0.01741016,289,135
D:1| T0: 0.10| T1: 515.00| I0: 400.00| I1: 75.00| WTP: 0,1,0.096153846,515,0,0,0,400,75,-11422558493,445552282,9655.947181,10939761134,1093976113,30,74514,3272,1604,1604,0,1604,74514,0,1604,18.77026401,0.547012506,0.547012506,56345.16165,197.1579435,1.290875405,99063.195,0.556748563,0.002038883,1.53486E-05,0,0.021526156,300,124
D:1| T0: 0.10| T1: 515.00| I0: 400.00| I1: 75.00| WTP: 0,1,0.096153846,515,0,0,0,400,75,-1572043464,911758476,10470.97022,1048494953,104849495.3,2,85251,3861,836,1739,903,836,85251,903,1739,114.3858824,1.811764706,3.915294118,33042.18353,562.0352941,5.884705882,98678.33412,0.288599904,0.006037398,6.51397E-05,0.519263945,0.020400023,57,11
D:1| T0: 0.10| T1: 515.00| I0: 400.00| I1: 75.00| WTP: 0,1,0.096153846,515,0,0,0,400,75,-4844378358,1464197940,9430.115486,4372872584,437287258.4,10,79703,3521,1380,1566,186,1380,79703,186,1566,35.52669323,0.952191235,1.094820717,32370.41833,370.038247,2.19123506,98671.05578,0.327578814,0.003729585,2.36428E-05,0.118773946,0.019647943,180,49
D:1| T0: 0.10| T1: 515.00| I0: 400.00| I1: 75.00| WTP: 0,1,0.096153846,515,0,0,0,400,75,-6028275675,500405854,8931.646326,5581693358,558169335.8,24,64731,2778,1484,1484,0,1484,64731,0,1484,19.51307379,0.676932016,0.676932016,58555.2394,152.6380012,1.540383498,99061.51714,0.587325018,0.001550163,1.74864E-05,0,0.022925646,245,63
D:1| T0: 0.10| T1: 515.00| I0: 400.00| I1: 75.00| WTP: 0,1,0.096153846,515,0,0,0,400,75,-6373466207,772037341,10370.42214,5854945101,585494510.1,22,75318,3241,1715,1723,8,1715,75318,8,1723,28.54115076,1.057538237,1.064821559,47776.17334,180.182083,2.32629279,98818.05098,0.482274353,0.001818562,2.52392E-05,0.004643064,0.022876338,197,66
D:1| T0: 0.10| T1: 515.00| I0: 400.00| I1: 75.00| WTP: 0,1,0.096153846,515,0,0,0,400,75,-4072209819,1543158763,5249.970394,3809711299,380971129.9,18,44264,1947,872,872,0,872,44264,0,872,12.70591427,0.31524688,0.31524688,71372.69669,116.3890396,0.793814433,99434.46934,0.715551646,0.001178481,9.56126E-06,0,0.019700427,262,43
D:1| T0: 0.10| T1: 515.00| I0: 400.00| I1: 75.00| WTP: 0,1,0.096153846,515,0,0,0,400,75,-3728848732,1604932531,11675.93625,3145051920,314505192,12,84561,3504,1428,1940,512,1428,84561,512,1940,59.33151432,1.740791269,2.429740791,37832.00955,340.4802183,4.366984993,98589.17462,0.369127365,0.003512139,4.74022E-05,0.264053636,0.022930192,103,35
D:1| T0: 0.10| T1: 515.00| I0: 400.00| I1: 75.00| WTP: 0,1,0.096153846,515,0,0,0,400,75,-7559414911,539051477,11088.55187,7004987317,700498731.7,14,81539,3605,1794,1842,48,1794,81539,48,1842,32.04295775,1.08028169,1.109859155,41092.42817,328.2992958,2.362676056,98702.55845,0.402295918,0.00338677,2.64028E-05,0.026058632,0.022590417,199,79
D:1| T0: 0.10| T1: 515.00| I0: 400.00| I1: 75.00| WTP: 0,1,0.096153846,515,0,0,0,400,75,-3163061022,1743124675,6207.285195,2852696763,285269676.3,18,49848,2164,1031,1031,0,1031,49848,0,1031,18.11811546,0.531519575,0.531519575,66008.32382,112.1718646,1.221632382,99306.92966,0.66305441,0.001132996,1.37901E-05,0,0.020683291,215,32
D:1| T0: 0.10| T1: 515.00| I0: 400.00| I1: 75.00| WTP: 0,1,0.096153846,515,0,0,0,400,75,-9921048571,1965983789,7898.664418,9526115351,952611535.1,20,63717,2750,1312,1312,0,1312,63717,0,1312,17.26310484,0.475302419,0.475302419,59031.2873,186.9314516,1.131552419,99157.53629,0.593357034,0.00188903,1.33467E-05,0,0.020591051,283,108
D:1| T0: 0.10| T1: 515.00| I0: 400.00| I1: 75.00| WTP: 0,1,0.096153846,515,0,0,0,400,75,-9041588972,516774280,7862.174192,8648480263,864848026.3,32,62387,2732,1306,1306,0,1306,62387,0,1306,13.79035554,0.347772783,0.347772783,61907.40785,163.1332244,0.884348181,99208.06253,0.622959779,0.001645197,1.07488E-05,0,0.020933848,349,98
D:1| T0: 0.10| T1: 515.00| I0: 400.00| I1: 75.00| WTP: 0,1,0.096153846,515,0,0,0,400,75,-1306194288,86603142,10493.61535,781513521,78151352.1,2,83064,3579,515,1743,1228,515,83064,1228,1743,229.9306931,2.455445545,8.504950495,37292.29208,1066.920792,11.04950495,98757.9604,0.340566859,0.011316743,0.000118645,0.704936854,0.020971781,28,8
D:1| T0: 0.10| T1: 515.00| I0: 400.00| I1: 75.00| WTP: 0,1,0.096153846,515,0,0,0,400,75,-7534880934,1431870609,7608.655012,7154448183,715444818.3,32,59044,2545,1264,1264,0,1264,59044,0,1264,12.57635271,0.329859719,0.329859719,64660.81764,163.6893788,0.83246493,99246.39599,0.650815009,0.001649216,1.01926E-05,0,0.021407764,357,81
D:1| T0: 0.10| T1: 515.00| I0: 400.00| I1: 75.00| WTP: 0,1,0.096153846,515,0,0,0,400,75,-4689701286,1592383984,8262.272383,4276587667,427658766.7,12,69576,3044,1368,1372,4,1368,69576,4,1372,37.8443171,1.111747851,1.11747851,52253.38491,194.30468,2.40974212,99074.05922,0.52536147,0.001962503,2.64009E-05,0.002915452,0.019719443,150,48
D:1| T0: 0.10| T1: 515.00| I0: 400.00| I1: 75.00| WTP: 0,1,0.096153846,515,0,0,0,400,75,-8087620226,1440183867,7912.807967,7691979828,769197982.8,24,67557,3090,1314,1314,0,1314,67557,0,1314,21.50929577,0.547605634,0.547605634,58265.57803,183.9233803,1.286760563,99199.76225,0.586574358,0.001852698,1.48951E-05,0,0.019450242,254,87
D:1| T0: 0.10| T1: 515.00| I0: 400.00| I1: 75.00| WTP: 0,1,0.096153846,515,0,0,0,400,75,-8468587817,1696510588,8548.944152,8041140609,804114060.9,30,67238,2973,1420,1420,0,1420,67238,0,1420,19.11597938,0.544845361,0.544845361,58334.84845,163.3989691,1.264948454,99140.25,0.587320422,0.001647903,1.47438E-05,0,0.02111901,277,91
D:1| T0: 0.10| T1: 515.00| I0: 400.00| I1: 75.00| WTP: 0,1,0.096153846,515,0,0,0,400,75,-10179736021,895039877,10931.90592,9633140725,963314072.5,20,81798,3541,1816,1816,0,1816,81798,0,1816,28.09962406,0.921679198,0.921679198,48915.99436,270.3327068,2.065162907,98888.43985,0.489050593,0.0027527,2.31541E-05,0,0.022201032,226,109
D:1| T0: 0.10| T1: 515.00| I0: 400.00| I1: 75.00| WTP: 0,1,0.096153846,515,0,0,0,400,75,-12193764477,129565953,9455.248261,11721002064,1172100206,30,69853,2962,1571,1571,0,1571,69853,0,1571,14.82166392,0.4592257,0.4592257,59316.58937,203.0378913,1.100082372,99099.94728,0.597294186,0.002049746,1.30486E-05,0,0.022490408,346,133
D:1| T0: 0.10| T1: 515.00| I0: 400.00| I1: 75.00| WTP: 0,1,0.096153846,515,0,0,0,400,75,-5964102573,1902565669,7605.093482,5583847899,558384789.9,26,63892,2861,1263,1263,0,1263,63892,0,1263,24.36863824,0.665749656,0.665749656,62454.3597,167.3218707,1.535075653,99281.73934,0.626981874,0.001690673,1.75313E-05,0,0.019767733,207,63
D:1| T0: 0.10| T1: 515.00| I0: 400.00| I1: 75.00| WTP: 0,1,0.096153846,515,0,0,0,400,75,-9633399923,1984179288,7536.115704,9256594137,925659413.7,36,58083,2405,1252,1252,0,1252,58083,0,1252,10.47498286,0.273817683,0.273817683,63777.10932,150.4509938,0.705962988,99219.4085,0.639364039,0.001527424,8.69787E-06,0,0.021555732,414,105
D:1| T0: 0.10| T1: 515.00| I0: 400.00| I1: 75.00| WTP: 0,1,0.096153846,515,0,0,0,400,75,-10917792811,677377223,10052.77786,10415153918,1041515392,18,74694,3308,1670,1670,0,1670,74694,0,1670,17.24077181,0.53397651,0.53397651,43382.30327,253.3271812,1.223154362,98747.03523,0.438634476,0.002555586,1.4122E-05,0,0.022357887,340,118
D:1| T0: 0.10| T1: 515.00| I0: 400.00| I1: 75.00| WTP: 0,1,0.096153846,515,0,0,0,400,75,-14631609169,973583301,8947.690227,14184224658,1418422466,24,72615,3315,1486,1486,0,1486,72615,0,1486,15.31671554,0.376099707,0.376099707,48312.18512,215.5197947,0.919354839,98945.56598,0.487140072,0.002174867,1.098E-05,0,0.020464091,390,161
D:1| T0: 0.10| T1: 515.00| I0: 400.00| I1: 75.00| WTP: 0,1,0.096153846,515,0,0,0,400,75,-7466668286,781062938,7733.157402,7080010416,708001041.6,26,69239,3171,1284,1284,0,1284,69239,0,1284,24.57680251,0.598119122,0.598119122,59201.69655,198.538558,1.39184953,99240.40125,0.595805154,0.001999725,1.61941E-05,0,0.01854473,228,80
D:1| T0: 0.10| T1: 515.00| I0: 400.00| I1: 75.00| WTP: 0,1,0.096153846,515,0,0,0,400,75,-17875148469,338783425,8995.047353,17425396102,1742539610,32,70514,3231,1494,1494,0,1494,70514,0,1494,13.07470343,0.30554665,0.30554665,55107.49631,184.9156781,0.786149407,99060.94261,0.554111734,0.001869677,9.67386E-06,0,0.0211731,445,198
D:1| T0: 0.10| T1: 515.00| I0: 400.00| I1: 100.00| WTP: 0,1,0.096153846,515,0,0,0,400,100,-5493673200,1178568022,7169.239934,5135211203,513521120.3,26,56411,2414,1191,1191,0,1191,56411,0,1191,14.71192385,0.415831663,0.415831663,63612.4018,144.5946894,1.01503006,99235.36423,0.640335092,0.001456403,1.19993E-05,0,0.021112904,285,58
D:1| T0: 0.10| T1: 515.00| I0: 400.00| I1: 100.00| WTP: 0,1,0.096153846,515,0,0,0,400,100,-5993847001,2029998696,9675.669609,5510063521,551006352.1,16,77849,3448,1596,1607,11,1596,77849,11,1607,42.908,1.39,1.401,45689.188,263.718,3.007,98903.271,0.455570667,0.00268492,3.25824E-05,0.006845053,0.020642791,142,62
D:1| T0: 0.10| T1: 515.00| I0: 400.00| I1: 100.00| WTP: 0,1,0.096153846,515,0,0,0,400,100,-4329274662,776062361,11441.33848,3757207738,375720773.8,6,80993,3403,1641,1901,260,1641,80993,260,1901,43.88028896,1.501547988,1.761609907,38740.6677,516.5696594,3.471620227,98589.44788,0.375611284,0.005349123,3.78459E-05,0.136770121,0.023471164,134,42
D:1| T0: 0.10| T1: 515.00| I0: 400.00| I1: 100.00| WTP: 0,1,0.096153846,515,0,0,0,400,100,-7532230102,1813046880,7536.993979,7155380403,715538040.3,30,55217,2429,1252,1252,0,1252,55217,0,1252,15.4643377,0.431344008,0.431344008,66070.78263,169.496361,1.038330907,99243.54779,0.665050534,0.001707225,1.222E-05,0,0.022674587,295,81
D:1| T0: 0.10| T1: 515.00| I0: 400.00| I1: 100.00| WTP: 0,1,0.096153846,515,0,0,0,400,100,-4658055344,2032407216,7678.830547,4274113816,427411381.6,22,65782,3065,1273,1275,2,1273,65782,2,1275,31.93599335,0.843724023,0.845386534,61235.10723,191.1379884,1.896924356,99246.16874,0.611992531,0.001945589,2.15309E-05,0.001568627,0.019382202,170,48
D:1| T0: 0.10| T1: 515.00| I0: 400.00| I1: 100.00| WTP: 0,1,0.096153846,515,0,0,0,400,100,-5121629217,1507873352,6855.069765,4778875729,477887572.9,24,51366,2127,1139,1139,0,1139,51366,0,1139,12.47123682,0.365771812,0.365771812,73247.75168,178.0043145,0.902684564,99401.07622,0.733979911,0.001807709,1.10732E-05,0,0.022174201,295,54
D:1| T0: 0.10| T1: 515.00| I0: 400.00| I1: 100.00| WTP: 0,1,0.096153846,515,0,0,0,400,100,-3235435895,1855899401,5889.167133,2940977538,294097753.8,16,49179,2203,978,978,0,978,49179,0,978,21.6121024,0.568657874,0.568657874,67754.54849,142.2179984,1.329712956,99366.47013,0.681143437,0.001431789,1.52489E-05,0,0.019886537,184,33
D:1| T0: 0.10| T1: 515.00| I0: 400.00| I1: 100.00| WTP: 0,1,0.096153846,515,0,0,0,400,100,-7188789231,1819459251,9227.998542,6727389304,672738930.4,20,69836,3021,1533,1533,0,1533,69836,0,1533,27.97145004,0.939894816,0.939894816,55197.04207,189.4718257,2.099173554,99046.05034,0.556301779,0.001909937,2.31957E-05,0,0.021951429,191,76
D:1| T0: 0.10| T1: 515.00| I0: 400.00| I1: 100.00| WTP: 0,1,0.096153846,515,0,0,0,400,100,-2871517247,909791748,7224.906035,2510271945,251027194.5,18,56279,2539,1200,1200,0,1200,56279,0,1200,29.33363971,0.883272059,0.883272059,68743.23713,167.5652574,2.002757353,99353.63971,0.691203734,0.001686695,2.21714E-05,0,0.021322719,156,28
D:1| T0: 0.10| T1: 515.00| I0: 400.00| I1: 100.00| WTP: 0,1,0.096153846,515,0,0,0,400,100,-5776232483,1339092841,9165.71885,5317946540,531794654,18,63500,2595,1523,1523,0,1523,63500,0,1523,30.1025641,1.175824176,1.175824176,60278.8141,210.1987179,2.578754579,99075.04945,0.607590898,0.002118256,2.80819E-05,0,0.023984252,156,60
D:1| T0: 0.10| T1: 515.00| I0: 400.00| I1: 100.00| WTP: 0,1,0.096153846,515,0,0,0,400,100,-5951331587,1365866345,10499.72314,5426345430,542634543,18,82713,3595,1726,1744,18,1726,82713,18,1744,42.20524836,1.406747891,1.423617619,47199.72071,242.7956888,3.042174321,98876.41237,0.450270546,0.002569953,3.43868E-05,0.010321101,0.021084956,146,61
D:1| T0: 0.10| T1: 515.00| I0: 400.00| I1: 100.00| WTP: 0,1,0.096153846,515,0,0,0,400,100,-9534419785,825453433,8695.265113,9099656529,909965652.9,22,71521,3245,1444,1444,0,1444,71521,0,1444,22.57236842,0.591008772,0.591008772,53951.88158,199.5635965,1.374451754,99072.55099,0.543631097,0.002011607,1.59397E-05,0,0.020189874,261,103
D:1| T0: 0.10| T1: 515.00| I0: 400.00| I1: 100.00| WTP: 0,1,0.096153846,515,0,0,0,400,100,-6287313737,939711378,10229.09522,5775858976,577585897.6,18,81188,3550,1645,1699,54,1645,81188,54,1699,39.64381122,1.264470169,1.314336598,40191.87088,284.3294746,2.787177204,98766.93678,0.406094937,0.002867228,3.00079E-05,0.031783402,0.020926738,161,65
D:1| T0: 0.10| T1: 515.00| I0: 400.00| I1: 100.00| WTP: 0,1,0.096153846,515,0,0,0,400,100,-11385522461,638950699,8923.114414,10939366740,1093936674,30,72093,3284,1482,1482,0,1482,72093,0,1482,20.09460129,0.527984151,0.527984151,59371.37692,227.1357107,1.250619118,99188.06241,0.597645015,0.002289383,1.47829E-05,0,0.020556781,289,124
D:1| T0: 0.10| T1: 515.00| I0: 400.00| I1: 100.00| WTP: 0,1,0.096153846,515,0,0,0,400,100,-4731858845,938699148,7544.364647,4354640613,435464061.3,22,63252,2833,1253,1253,0,1253,63252,0,1253,25.85660091,0.747344461,0.747344461,60469.4302,161.5546282,1.719271624,99213.59939,0.601768122,0.001656081,1.94581E-05,0,0.01980965,185,49
D:1| T0: 0.10| T1: 515.00| I0: 400.00| I1: 100.00| WTP: 0,1,0.096153846,515,0,0,0,400,100,-7568281645,121790188,6586.6594,7238948675,723894867.5,28,57378,2528,1094,1094,0,1094,57378,0,1094,13.54735883,0.31420765,0.31420765,67606.42213,189.5218579,0.801457195,99399.98816,0.679551058,0.001907097,1.00138E-05,0,0.019066873,313,82
D:1| T0: 0.10| T1: 515.00| I0: 400.00| I1: 100.00| WTP: 0,1,0.096153846,515,0,0,0,400,100,-5840591090,1331335240,10149.54768,5333113706,533311370.6,12,77587,3322,1575,1686,111,1575,77587,111,1686,31.58792453,1.02490566,1.106415094,37216.5366,386.7516981,2.292075472,98665.99472,0.370218036,0.00393708,2.5049E-05,0.065836299,0.021730445,188,60
D:1| T0: 0.10| T1: 515.00| I0: 400.00| I1: 100.00| WTP: 0,1,0.096153846,515,0,0,0,400,100,-1600416408,470935411,11189.15966,1040958425,104095842.5,2,81563,3470,796,1859,1063,796,81563,1063,1859,96.23026316,1.603070175,3.903508772,32477.86623,463.2214912,5.649122807,98505.36184,0.296268851,0.00488949,6.14923E-05,0.571812803,0.022792197,63,11
D:1| T0: 0.10| T1: 515.00| I0: 400.00| I1: 100.00| WTP: 0,1,0.096153846,515,0,0,0,400,100,-8102054353,823434397,9960.707105,7604018998,760401899.8,26,69098,2945,1655,1655,0,1655,69098,0,1655,22.87684729,0.809729064,0.809729064,58437.60961,216.2413793,1.825738916,99020.9218,0.589129606,0.002181501,2.05392E-05,0,0.023951489,232,86
D:1| T0: 0.10| T1: 515.00| I0: 400.00| I1: 100.00| WTP: 0,1,0.096153846,515,0,0,0,400,100,-2515586338,493045351,7158.223242,2157675176,215767517.6,14,56518,2508,1189,1189,0,1189,56518,0,1189,31.97283177,1.037617555,1.037617555,65317.61338,149.7345873,2.280041797,99289.63427,0.656442629,0.001510117,2.50229E-05,0,0.021037918,137,24
D:1| T0: 0.10| T1: 515.00| I0: 400.00| I1: 100.00| WTP: 0,1,0.096153846,515,0,0,0,400,100,-9111859627,1700216563,7413.48223,8741185515,874118551.5,22,65279,2983,1231,1231,0,1231,65279,0,1231,21.26820809,0.513294798,0.513294798,62011.09595,203.916763,1.216763006,99285.54624,0.623824298,0.002053213,1.4311E-05,0,0.018857519,248,99
D:1| T0: 0.10| T1: 515.00| I0: 400.00| I1: 100.00| WTP: 0,1,0.096153846,515,0,0,0,400,100,-3588423197,1744119059,7413.144933,3217765950,321776595,16,64376,2904,1229,1231,2,1229,64376,2,1231,37.1954023,1.073145246,1.07523511,60173.66249,185.6854754,2.349007315,99241.66876,0.605609731,0.001869115,2.58372E-05,0.001624695,0.01912233,137,36
D:1| T0: 0.10| T1: 515.00| I0: 400.00| I1: 100.00| WTP: 0,1,0.096153846,515,0,0,0,400,100,-9067125667,2036906360,8372.706523,8648490340,864849034,28,61445,2668,1391,1391,0,1391,61445,0,1391,13.55685957,0.389316066,0.389316066,62890.586,173.1942533,0.946580332,99172.43302,0.630599987,0.001758527,1.1416E-05,0,0.022638132,350,98
D:1| T0: 0.10| T1: 515.00| I0: 400.00| I1: 100.00| WTP: 0,1,0.096153846,515,0,0,0,400,100,-9063439094,809704121,8123.350419,8657271573,865727157.3,24,69214,3171,1349,1349,0,1349,69214,0,1349,20.84433709,0.527106817,0.527106817,58089.10521,191.3848631,1.264090177,99173.02523,0.584357322,0.00193079,1.45882E-05,0,0.019490277,265,98
D:1| T0: 0.10| T1: 515.00| I0: 400.00| I1: 100.00| WTP: 0,1,0.096153846,515,0,0,0,400,100,-11038438555,1219866412,10583.413,10509267905,1050926791,24,81148,3606,1755,1758,3,1755,81148,3,1758,23.68059228,0.735589635,0.737176097,42553.60973,350.3818086,1.665256478,98750.92914,0.430144879,0.003536063,1.87323E-05,0.001706485,0.02166412,271,119
D:1| T0: 0.10| T1: 515.00| I0: 400.00| I1: 100.00| WTP: 0,1,0.096153846,515,0,0,0,400,100,-4372521155,843498920,7517.884718,3996626919,399662691.9,26,56132,2457,1249,1249,0,1249,56132,0,1249,17.80563887,0.550689862,0.550689862,67096.12058,162.1271746,1.300539892,99288.25015,0.675041798,0.00163268,1.50701E-05,0,0.022251122,239,45
D:1| T0: 0.10| T1: 515.00| I0: 400.00| I1: 100.00| WTP: 0,1,0.096153846,515,0,0,0,400,100,-11847370338,107351963,9515.66275,11371587201,1137158720,40,70778,3006,1581,1581,0,1581,70778,0,1581,14.10782809,0.419416731,0.419416731,55637.0353,190.6895625,1.019186493,99006.35802,0.560744603,0.001924877,1.22303E-05,0,0.022337449,373,129
D:1| T0: 0.10| T1: 515.00| I0: 400.00| I1: 100.00| WTP: 0,1,0.096153846,515,0,0,0,400,100,-11200286475,773789021,8837.228255,10758425062,1075842506,36,68119,2987,1468,1468,0,1468,68119,0,1468,14.75079491,0.425278219,0.425278219,55013.12083,183.2674881,1.001192369,99050.3287,0.5540952,0.00184912,1.17603E-05,0,0.021550522,360,122
D:1| T0: 0.10| T1: 515.00| I0: 400.00| I1: 100.00| WTP: 0,1,0.096153846,515,0,0,0,400,100,-8693411118,850936611,9587.189722,8214051632,821405163.2,28,68334,2781,1593,1593,0,1593,68334,0,1593,20.60362998,0.722482436,0.722482436,59029.30855,212.0234192,1.659250585,99060.13817,0.591513647,0.002155809,1.89474E-05,0,0.023311968,242,93
D:1| T0: 0.10| T1: 515.00| I0: 400.00| I1: 100.00| WTP: 0,1,0.096153846,515,0,0,0,400,100,-7284138842,1701318364,9378.196857,6815228999,681522899.9,26,68988,2933,1558,1558,0,1558,68988,0,1558,26.47521246,0.883144476,0.883144476,59338.35411,205.8562323,1.985127479,99101.34773,0.594338767,0.00209318,2.24158E-05,0,0.022583638,200,77
D:1| T0: 0.10| T1: 515.00| I0: 400.00| I1: 100.00| WTP: 0,1,0.096153846,515,0,0,0,400,100,-8039721411,778708269,7265.047241,7676469049,767646904.9,26,55762,2416,1207,1207,0,1207,55762,0,1207,12.91755319,0.335106383,0.335106383,69602.43927,189.3696809,0.870124113,99363.44681,0.699422287,0.00190902,1.07749E-05,0,0.021645565,322,87
D:1| T0: 0.10| T1: 515.00| I0: 400.00| I1: 100.00| WTP: 0,1,0.096153846,515,0,0,0,400,100,-4086858006,1391938506,8726.603882,3650527812,365052781.2,22,61892,2559,1450,1450,0,1450,61892,0,1450,26.71848739,1.007563025,1.007563025,63261.58151,185.2445378,2.223529412,99160.66134,0.637138911,0.00186669,2.45269E-05,0,0.023427907,170,41
D:1| T0: 0.10| T1: 515.00| I0: 400.00| I1: 100.00| WTP: 0,1,0.096153846,515,0,0,0,400,100,-4024317205,43418681,5960.037891,3726315310,372631531,18,47150,2070,990,990,0,990,47150,0,990,16.81539465,0.449445532,0.449445532,73956.29746,172.3926941,1.097195042,99447.38421,0.743215694,0.00173396,1.29716E-05,0,0.020996819,219,42
D:1| T0: 0.10| T1: 515.00| I0: 400.00| I1: 100.00| WTP: 0,1,0.096153846,515,0,0,0,400,100,-3803833673,817384966,11453.33628,3231166859,323116685.9,16,82220,3363,1624,1903,279,1624,82220,279,1903,54.1366539,1.879948914,2.227330779,41360.69349,286.734355,4.305236271,98678.92082,0.416051821,0.00290368,4.56157E-05,0.146610615,0.02314522,112,36
D:1| T0: 0.10| T1: 515.00| I0: 400.00| I1: 100.00| WTP: 0,1,0.096153846,515,0,0,0,400,100,-5709725487,762053968,9308.391501,5244305912,524430591.2,24,76203,3273,1521,1546,25,1521,76203,25,1546,41.08630952,1.285714286,1.30952381,49780.23909,235.202381,2.829365079,99006.62004,0.500891774,0.00237472,3.06953E-05,0.016170763,0.020289513,144,59
D:1| T0: 0.10| T1: 515.00| I0: 400.00| I1: 100.00| WTP: 0,1,0.096153846,515,0,0,0,400,100,-10027811587,1692506311,8093.841922,9623119490,962311949,32,68516,3153,1344,1344,0,1344,68516,0,1344,17.74036331,0.409836066,0.409836066,58991.23527,202.0513957,1.00886132,99223.36774,0.59093104,0.002048788,1.2065E-05,0,0.019615856,320,109
D:1| T0: 0.10| T1: 515.00| I0: 400.00| I1: 100.00| WTP: 0,1,0.096153846,515,0,0,0,400,100,-4039310615,1037620300,6283.990989,3725111065,372511106.5,18,47109,2059,1044,1044,0,1044,47109,0,1044,17.24843424,0.54697286,0.54697286,72210.4572,137.4864301,1.270006959,99404.24148,0.715553479,0.001434894,1.51438E-05,0,0.022161841,198,42
D:1| T0: 0.10| T1: 515.00| I0: 400.00| I1: 100.00| WTP: 0,1,0.096153846,515,0,0,0,400,100,-4751220952,301400999,7952.40925,4353600490,435360049,22,60652,2673,1321,1321,0,1321,60652,0,1321,22.97660014,0.699931177,0.699931177,62936.70131,172.8038541,1.61871989,99208.24845,0.633619979,0.001740566,1.82913E-05,0,0.021779991,208,49
D:1| T0: 0.10| T1: 515.00| I0: 400.00| I1: 100.00| WTP: 0,1,0.096153846,515,0,0,0,400,100,-5555257543,1868336855,9693.266054,5070594240,507059424,14,76907,3395,1585,1610,25,1585,76907,25,1610,37.55338078,1.208185053,1.231316726,44207.60854,267.4875445,2.637010676,98835.83185,0.446482186,0.002696873,2.86313E-05,0.01552795,0.020934647,161,57
D:1| T0: 0.10| T1: 515.00| I0: 400.00| I1: 100.00| WTP: 0,1,0.096153846,515,0,0,0,400,100,-7778444157,1868498144,10329.87602,7261950356,726195035.6,18,77408,3372,1716,1716,0,1716,77408,0,1716,32.68478261,1.114130435,1.114130435,51618.01398,249.6296584,2.440217391,98938.02484,0.520609538,0.002518443,2.68556E-05,0,0.022168251,184,82
D:1| T0: 0.10| T1: 515.00| I0: 400.00| I1: 100.00| WTP: 0,1,0.096153846,515,0,0,0,400,100,-6451886090,2101566889,7043.245942,6099723793,609972379.3,24,54031,2434,1170,1170,0,1170,54031,0,1170,13.30921348,0.368988764,0.368988764,63037.85258,137.0170787,0.891235955,99188.26652,0.634939376,0.001380399,1.05739E-05,0,0.021654236,318,69
D:1| T0: 0.10| T1: 515.00| I0: 400.00| I1: 100.00| WTP: 0,1,0.096153846,515,0,0,0,400,100,-2433554302,1665097450,10383.48082,1914380261,191438026.1,6,80576,3444,1023,1725,702,1023,80576,702,1725,53.41528662,1.177070064,2.052229299,32625.11975,351.4968153,3.357961783,98575.48662,0.298857118,0.003707964,3.69309E-05,0.406956522,0.02140836,108,21
D:1| T0: 0.10| T1: 515.00| I0: 400.00| I1: 100.00| WTP: 0,1,0.096153846,515,0,0,0,400,100,-3115598973,1716179948,9774.722238,2626862861,262686286.1,6,84929,3914,1348,1623,275,1348,84929,275,1623,71.69072165,1.811487482,2.197349043,32820.33284,429.9248895,4.187039764,98749.02504,0.331699216,0.004329226,4.40576E-05,0.16943931,0.01911008,97,29
D:1| T0: 0.10| T1: 515.00| I0: 400.00| I1: 100.00| WTP: 0,1,0.096153846,515,0,0,0,400,100,-3370568220,1560278715,8550.390289,2943048706,294304870.6,16,54884,2205,1420,1421,1,1420,54884,1,1421,21.26343679,0.8667676,0.867524603,65389.00379,141.9121877,1.943981832,99120.06207,0.653926956,0.001451441,2.19594E-05,0.00070373,0.02589097,185,33
D:1| T0: 0.10| T1: 515.00| I0: 400.00| I1: 100.00| WTP: 0,1,0.096153846,515,0,0,0,400,100,-10325348214,991019385,10408.26197,9804935115,980493511.5,24,79629,3433,1728,1729,1,1728,79629,1,1729,25.0754386,0.813450292,0.814035088,45672.31988,276.7327485,1.825146199,98832.73567,0.46118155,0.002792443,2.03808E-05,0.000578369,0.021713195,245,111
D:1| T0: 0.10| T1: 515.00| I0: 400.00| I1: 100.00| WTP: 0,1,0.096153846,515,0,0,0,400,100,-6257419767,118052103,9776.267109,5768606412,576860641.2,12,75579,3246,1586,1624,38,1586,75579,38,1624,28.56232295,0.933427762,0.958923513,43546.6983,269.2570822,2.086402266,98805.26133,0.4318522,0.002753715,2.32331E-05,0.023399015,0.02148745,199,65
D:1| T0: 0.10| T1: 515.00| I0: 400.00| I1: 100.00| WTP: 0,1,0.096153846,515,0,0,0,400,100,-4460726284,1209758844,10641.45428,3928653570,392865357,10,76477,3130,1738,1768,30,1738,76477,30,1768,50.57987421,1.973584906,2.008805031,49744.4956,281.0779874,4.187421384,98861.00629,0.485255241,0.002930011,4.59393E-05,0.016968326,0.023118969,110,44
D:1| T0: 0.10| T1: 515.00| I0: 400.00| I1: 100.00| WTP: 0,1,0.096153846,515,0,0,0,400,100,-6366125577,70671723,7173.864052,6007432374,600743237.4,28,51167,2178,1192,1192,0,1192,51167,0,1192,13.22145329,0.41028176,0.41028176,68377.84775,156.2689076,1.004943154,99273.64755,0.687561873,0.001576904,1.18727E-05,0,0.02329672,289,68
D:1| T0: 0.10| T1: 515.00| I0: 400.00| I1: 100.00| WTP: 0,1,0.096153846,515,0,0,0,400,100,-5187652114,1722612191,6304.490387,4872427595,487242759.5,18,53340,2401,1047,1047,0,1047,53340,0,1047,17.31028472,0.413712958,0.413712958,69201.21267,170.3957002,1.019174898,99403.25044,0.695221169,0.001716354,1.22384E-05,0,0.019628796,245,55
D:1| T0: 0.10| T1: 515.00| I0: 400.00| I1: 100.00| WTP: 0,1,0.096153846,515,0,0,0,400,100,-3893776139,1968291596,6707.191317,3558416574,355841657.4,14,53986,2430,1114,1114,0,1114,53986,0,1114,23.0957529,0.66023166,0.66023166,69472.88494,167.1706564,1.538223938,99384.30734,0.69579107,0.001696393,1.74355E-05,0,0.020635744,184,40
D:1| T0: 0.10| T1: 515.00| I0: 400.00| I1: 100.00| WTP: 0,1,0.096153846,515,0,0,0,400,100,-3652785670,1877569084,11874.72299,3059049520,305904952,10,83759,3491,1547,1973,426,1547,83759,426,1973,62.35021097,1.976090014,2.559774965,36324.49648,377.0661041,4.727144866,98544.19269,0.35867788,0.003857972,5.06702E-05,0.21591485,0.023555678,101,34
D:1| T0: 0.10| T1: 515.00| I0: 400.00| I1: 100.00| WTP: 0,1,0.096153846,515,0,0,0,400,100,-2617690104,1726322189,10510.51748,2092164230,209216423,4,80847,3467,1284,1746,462,1284,80847,462,1746,75.34554974,2.05061082,2.830715532,36775.30192,478.0401396,5.09947644,98675.57243,0.365249609,0.004865378,5.38327E-05,0.264604811,0.021596349,81,23
D:1| T0: 0.10| T1: 515.00| I0: 400.00| I1: 100.00| WTP: 0,1,0.096153846,515,0,0,0,400,100,-5734035041,307848836,9853.942933,5241337894,524133789.4,14,76770,3266,1634,1637,3,1634,76770,3,1637,35.27942498,1.270440252,1.273135669,43877.54088,241.6316262,2.734052111,98831.34771,0.443087489,0.002435931,2.96047E-05,0.001832621,0.021323434,159,59
D:1| T0: 0.10| T1: 515.00| I0: 400.00| I1: 100.00| WTP: 0,1,0.096153846,515,0,0,0,400,100,-1723337374,1154000220,10067.32995,1219970877,121997087.7,4,82380,3756,813,1672,859,813,82380,859,1672,92.60279441,1.453093812,3.155688623,28445.01198,428.2714571,4.77245509,98578.1976,0.288243228,0.004309976,4.99475E-05,0.513755981,0.020297174,72,13
D:1| T0: 0.10| T1: 515.00| I0: 400.00| I1: 100.00| WTP: 0,1,0.096153846,515,0,0,0,400,100,-4668434684,2028661055,6495.776293,4343645870,434364587,22,50436,2230,1079,1079,0,1079,50436,0,1079,15.35682819,0.425660793,0.425660793,66826.53744,144.6057269,1.017070485,99287.18282,0.672537827,0.001455786,1.19411E-05,0,0.021393449,260,49
D:1| T0: 0.10| T1: 515.00| I0: 400.00| I1: 100.00| WTP: 0,1,0.096153846,515,0,0,0,400,100,-11837284080,1629114640,9228.781811,11375844990,1137584499,30,73890,3214,1533,1533,0,1533,73890,0,1533,17.16441931,0.462809917,0.462809917,52374.37451,200.0343628,1.140060896,99039.52066,0.527764001,0.002016991,1.34334E-05,0,0.020747056,329,129
D:1| T0: 0.10| T1: 515.00| I0: 400.00| I1: 100.00| WTP: 0,1,0.096153846,515,0,0,0,400,100,-4041412432,1439048174,10907.36256,3496044304,349604430.4,10,80921,3569,1442,1812,370,1442,80921,370,1812,49.15677492,1.434490482,1.836506159,34149.16125,384.5879059,3.469204927,98537.3841,0.343691397,0.003892166,3.68668E-05,0.20419426,0.02239221,128,39
D:1| T0: 0.10| T1: 515.00| I0: 400.00| I1: 100.00| WTP: 0,1,0.096153846,515,0,0,0,400,100,-1335401807,865227006,11176.59618,776571997.5,77657199.75,2,83612,3494,647,1857,1210,647,83612,1210,1857,115.4037433,1.529411765,4.743315508,33558.27807,600.7433155,6.529411765,98567.06684,0.285799847,0.006532813,7.28688E-05,0.651588584,0.022210262,50,8
D:1| T0: 0.10| T1: 515.00| I0: 400.00| I1: 100.00| WTP: 0,1,0.096153846,515,0,0,0,400,100,-6257635793,890479738,9734.952414,5770888172,577088817.2,12,77968,3403,1560,1617,57,1560,77968,57,1617,29.91827957,0.929749104,0.968458781,38006.72186,401.1046595,2.093189964,98730.4638,0.384333516,0.004042963,2.29438E-05,0.035250464,0.020739278,200,65
D:1| T0: 0.10| T1: 515.00| I0: 400.00| I1: 100.00| WTP: 0,1,0.096153846,515,0,0,0,400,100,-3693829982,1017049163,7879.739327,3299843015,329984301.5,20,60882,2641,1309,1309,0,1309,60882,0,1309,27.58899398,0.905417025,0.905417025,63962.68014,186.1530525,2.0361135,99231.23646,0.643825174,0.001874676,2.26394E-05,0,0.021500608,167,37
D:1| T0: 0.10| T1: 515.00| I0: 400.00| I1: 100.00| WTP: 0,1,0.096153846,515,0,0,0,400,100,-5427622235,1707305064,5913.020501,5131971210,513197121,22,49874,2241,982,982,0,982,49874,0,982,13.35940499,0.315738964,0.315738964,66382.69818,125.4592131,0.792706334,99340.67514,0.666142959,0.001268713,9.5117E-06,0,0.019689618,297,58
D:1| T0: 0.10| T1: 515.00| I0: 400.00| I1: 100.00| WTP: 0,1,0.096153846,515,0,0,0,400,100,-1345482937,400145663,11303.97131,780284371.7,78028437.17,2,83824,3616,714,1878,1164,714,83824,1164,1878,132.8621701,1.935483871,5.328445748,29338.54252,658.4252199,7.416422287,98471.60411,0.297454985,0.006624804,7.65575E-05,0.619808307,0.022404085,49,8
D:1| T0: 0.10| T1: 515.00| I0: 400.00| I1: 100.00| WTP: 0,1,0.096153846,515,0,0,0,400,100,-4656919048,1662654181,7849.836648,4264427215,426442721.5,26,59884,2622,1304,1304,0,1304,59884,0,1304,22.28865979,0.704467354,0.704467354,62171.53471,168.0006873,1.610996564,99198.6543,0.625974356,0.001692053,1.80295E-05,0,0.021776523,208,48
D:1| T0: 0.10| T1: 515.00| I0: 400.00| I1: 100.00| WTP: 0,1,0.096153846,515,0,0,0,400,100,-4623754933,182136456,10235.52296,4111978786,411197878.6,16,83593,3764,1504,1700,196,1504,83593,196,1700,49.73632385,1.443107221,1.649890591,38860.84683,316.2592998,3.287746171,98786.40919,0.38930314,0.003205492,3.55215E-05,0.115294118,0.020337361,130,46
D:1| T0: 0.10| T1: 515.00| I0: 400.00| I1: 100.00| WTP: 0,1,0.096153846,515,0,0,0,400,100,-6134055200,979575387,6015.123152,5833299043,583329904.3,22,50236,2287,999,999,0,999,50236,0,999,12.60722348,0.291196388,0.291196388,68384.87178,152,0.741760722,99383.02889,0.687590465,0.001529243,9.06147E-06,0,0.019886137,317,66
D:1| T0: 0.10| T1: 515.00| I0: 400.00| I1: 100.00| WTP: 0,1,0.096153846,515,0,0,0,400,100,-4827838681,2142525414,10841.68315,4285754524,428575452.4,10,81143,3551,1718,1801,83,1718,81143,83,1801,49.48824188,1.708846585,1.796192609,42395.28891,355.6539754,3.734602464,98733.58567,0.419909936,0.003640178,4.03087E-05,0.046085508,0.022196204,126,48
D:1| T0: 0.10| T1: 515.00| I0: 400.00| I1: 100.00| WTP: 0,1,0.096153846,515,0,0,0,400,100,-5348974793,1464057597,9127.85168,4892582209,489258220.9,10,73772,3230,1505,1516,11,1505,73772,11,1516,40.35212661,1.261127596,1.268051434,49314.83482,273.5796241,2.767556874,98980.79822,0.496917962,0.002758996,3.01096E-05,0.007255937,0.020549802,145,55
D:1| T0: 0.10| T1: 515.00| I0: 400.00| I1: 100.00| WTP: 0,1,0.096153846,515,0,0,0,400,100,-4000154053,364562610,10167.3963,3491784238,349178423.8,8,76053,3325,1586,1689,103,1586,76053,103,1689,51.09282178,1.766089109,1.887376238,44169.85644,316.134901,3.839108911,98791.05569,0.442836482,0.003205696,4.10843E-05,0.06098283,0.022209365,115,39
D:1| T0: 0.10| T1: 515.00| I0: 400.00| I1: 100.00| WTP: 0,1,0.096153846,515,0,0,0,400,100,-4518762878,40350784,10070.49241,4015238258,401523825.8,10,76085,3245,1581,1673,92,1581,76085,92,1673,44.5027933,1.569832402,1.668156425,43352.95978,326.8826816,3.429050279,98774.13631,0.438122508,0.003294997,3.66255E-05,0.054991034,0.021989143,128,45
D:1| T0: 0.10| T1: 515.00| I0: 400.00| I1: 100.00| WTP: 0,1,0.096153846,515,0,0,0,400,100,-4778393162,804064356,8167.993691,4369993477,436999347.7,20,76459,3545,1336,1356,20,1336,76459,20,1356,43.3002008,1.140562249,1.158634538,48580.23795,221.7008032,2.495983936,99108.30221,0.482647269,0.002261383,2.75451E-05,0.014749263,0.017735227,141,49
D:1| T0: 0.10| T1: 515.00| I0: 400.00| I1: 100.00| WTP: 0,1,0.096153846,515,0,0,0,400,100,-4137410921,2125493986,9581.961522,3658312845,365831284.5,22,68804,2920,1579,1592,13,1579,68804,13,1592,31.68914186,1.178633975,1.19089317,57222.25569,190.3782837,2.570928196,99030.64011,0.576435452,0.001921175,2.79903E-05,0.008165829,0.02313819,163,41
D:1| T0: 0.10| T1: 515.00| I0: 400.00| I1: 100.00| WTP: 0,1,0.096153846,515,0,0,0,400,100,-4582896186,23154253,7978.326829,4183979844,418397984.4,12,68456,3025,1320,1325,5,1320,68456,5,1325,30.659699,0.913879599,0.918060201,49086.93645,152.4707358,2.025083612,99030.90552,0.491199292,0.001547201,2.24126E-05,0.003773585,0.019355498,170,47
D:1| T0: 0.10| T1: 515.00| I0: 400.00| I1: 100.00| WTP: 0,1,0.096153846,515,0,0,0,400,100,-3476488139,1391367689,7098.054497,3121585414,312158541.4,16,53390,2408,1178,1179,1,1178,53390,1,1179,22.27418182,0.675636364,0.676363636,64366.02255,130.7374545,1.538909091,99219.12873,0.645534145,0.001326358,1.73569E-05,0.000848176,0.022082787,195,35
D:1| T0: 0.10| T1: 515.00| I0: 400.00| I1: 100.00| WTP: 0,1,0.096153846,515,0,0,0,400,100,-7161807648,574142276,8687.488439,6727433226,672743322.6,26,69013,2978,1443,1443,0,1443,69013,0,1443,27.62178072,0.844002943,0.844002943,61013.69169,233.2950699,1.916850625,99191.95806,0.613088461,0.002357754,2.14378E-05,0,0.020909407,194,76
D:1| T0: 0.10| T1: 515.00| I0: 400.00| I1: 100.00| WTP: 0,1,0.096153846,515,0,0,0,400,100,-6522645336,898736779,6742.326581,6185529007,618552900.7,24,52803,2334,1120,1120,0,1120,52803,0,1120,13.18704044,0.337316176,0.337316176,70291.28355,179.1424632,0.846047794,99380.55836,0.704502836,0.001816286,1.04239E-05,0,0.021210916,309,70
D:1| T0: 0.10| T1: 515.00| I0: 400.00| I1: 100.00| WTP: 0,1,0.096153846,515,0,0,0,400,100,-12243651477,346473503,8426.739721,11822314491,1182231449,30,76704,3644,1399,1399,0,1399,76704,0,1399,22.61316456,0.512405063,0.512405063,54528.09722,220.4440506,1.22278481,99185.07595,0.531649492,0.002304667,1.47989E-05,0,0.018238945,272,134
D:1| T0: 0.10| T1: 515.00| I0: 400.00| I1: 100.00| WTP: 0,1,0.096153846,515,0,0,0,400,100,-10446726305,445552282,9468.98514,9973277048,997327704.8,30,73304,3258,1573,1573,0,1573,73304,0,1573,17.08246073,0.498254799,0.498254799,53284.31283,182.2561082,1.176265271,99009.09075,0.526104843,0.001881789,1.4156E-05,0,0.021458583,319,113
D:1| T0: 0.10| T1: 515.00| I0: 400.00| I1: 100.00| WTP: 0,1,0.096153846,515,0,0,0,400,100,-1572043464,911758476,10470.97022,1048494953,104849495.3,2,85251,3861,836,1739,903,836,85251,903,1739,114.3858824,1.811764706,3.915294118,33042.18353,562.0352941,5.884705882,98678.33412,0.288599904,0.006037398,6.51397E-05,0.519263945,0.020400023,57,11
D:1| T0: 0.10| T1: 515.00| I0: 400.00| I1: 100.00| WTP: 0,1,0.096153846,515,0,0,0,400,100,-4857365087,1464197940,9694.316876,4372649243,437264924.3,12,79435,3531,1424,1610,186,1424,79435,186,1610,38.83508772,1.10877193,1.265789474,33149.36842,406.0526316,2.496491228,98660.10175,0.335446953,0.004092148,2.68094E-05,0.11552795,0.020268144,163,49
D:1| T0: 0.10| T1: 515.00| I0: 400.00| I1: 100.00| WTP: 0,1,0.096153846,515,0,0,0,400,100,-5531766498,500405854,7819.782316,5140777382,514077738.2,26,59521,2618,1299,1299,0,1299,59521,0,1299,24.51860289,0.794229309,0.794229309,62949.53683,183.3917995,1.778283979,99196.33409,0.630472885,0.001864054,2.00227E-05,0,0.02182423,187,58
D:1| T0: 0.10| T1: 515.00| I0: 400.00| I1: 100.00| WTP: 0,1,0.096153846,515,0,0,0,400,100,-6186294692,772037341,10165.71233,5678009076,567800907.6,26,75064,3119,1683,1689,6,1683,75064,6,1689,28.60089686,1.068011958,1.071748879,47180.21076,184.1352765,2.335575486,98821.81166,0.47634129,0.001858108,2.53974E-05,0.003552398,0.022500799,192,64
D:1| T0: 0.10| T1: 515.00| I0: 400.00| I1: 100.00| WTP: 0,1,0.096153846,515,0,0,0,400,100,-3583049882,1543158763,5905.910685,3287754348,328775434.8,18,47145,2038,981,981,0,981,47145,0,981,16.47358247,0.452963918,0.452963918,71418.97552,147.8679124,1.079896907,99403.10825,0.715801627,0.001499055,1.27947E-05,0,0.020808145,220,37
D:1| T0: 0.10| T1: 515.00| I0: 400.00| I1: 100.00| WTP: 0,1,0.096153846,515,0,0,0,400,100,-3460101706,1604932531,11567.71372,2881716019,288171601.9,12,83776,3473,1410,1922,512,1410,83776,512,1922,57.95983936,1.689424364,2.365461847,36431.53414,329.7536814,4.255689424,98555.44712,0.354974392,0.003399882,4.59941E-05,0.266389178,0.022942405,105,32
D:1| T0: 0.10| T1: 515.00| I0: 400.00| I1: 100.00| WTP: 0,1,0.096153846,515,0,0,0,400,100,-6931067606,539051477,10794.23026,6391356093,639135609.3,14,82353,3635,1745,1793,48,1745,82353,48,1793,31.34731774,1.017193948,1.04607978,39052.76272,324.4910591,2.238651994,98692.28611,0.381530523,0.003345582,2.50715E-05,0.026770775,0.021772127,204,72
D:1| T0: 0.10| T1: 515.00| I0: 400.00| I1: 100.00| WTP: 0,1,0.096153846,515,0,0,0,400,100,-2904989119,1743124675,6332.935203,2588342358,258834235.8,18,51442,2183,1052,1052,0,1052,51442,0,1052,21.16626506,0.661044177,0.661044177,67734.18795,140.0208835,1.502008032,99335.19357,0.68004143,0.001414726,1.70435E-05,0,0.020450216,178,29
D:1| T0: 0.10| T1: 515.00| I0: 400.00| I1: 100.00| WTP: 0,1,0.096153846,515,0,0,0,400,100,-8981953278,1965983789,8367.656806,8563570438,856357043.8,20,64885,2837,1390,1390,0,1390,64885,0,1390,16.98009709,0.507281553,0.507281553,56006.44903,182.7601942,1.176213592,99068.84854,0.563224041,0.001847225,1.36226E-05,0,0.021422517,294,97
D:1| T0: 0.10| T1: 515.00| I0: 400.00| I1: 100.00| WTP: 0,1,0.096153846,515,0,0,0,400,100,-8689682121,516774280,7826.328896,8298365676,829836567.6,36,63410,2789,1300,1300,0,1300,63410,0,1300,15.35081374,0.400542495,0.400542495,62875.62432,183.9186257,0.971518987,99235.60714,0.63251819,0.0018548,1.18363E-05,0,0.020501498,315,94
D:1| T0: 0.10| T1: 515.00| I0: 400.00| I1: 100.00| WTP: 0,1,0.096153846,515,0,0,0,400,100,-1306194288,86603142,10493.61535,781513521,78151352.1,2,83064,3579,515,1743,1228,515,83064,1228,1743,229.9306931,2.455445545,8.504950495,37292.29208,1066.920792,11.04950495,98757.9604,0.340566859,0.011316743,0.000118645,0.704936854,0.020971781,28,8
D:1| T0: 0.10| T1: 515.00| I0: 400.00| I1: 100.00| WTP: 0,1,0.096153846,515,0,0,0,400,100,-7252041142,1431870609,7247.699854,6889656149,688965614.9,34,56621,2519,1204,1204,0,1204,56621,0,1204,10.9148401,0.274523895,0.274523895,62357.74991,139.5242544,0.70822853,99214.55013,0.627840766,0.001405499,8.70179E-06,0,0.021264195,398,78
D:1| T0: 0.10| T1: 515.00| I0: 400.00| I1: 100.00| WTP: 0,1,0.096153846,515,0,0,0,400,100,-4503658447,1592383984,8140.645538,4096626170,409662617,14,66752,2956,1348,1352,4,1348,66752,4,1352,40.46085998,1.292171996,1.298787211,54587.85226,214.5071665,2.77508269,99089.87431,0.548692208,0.002166953,3.00369E-05,0.00295858,0.020254075,130,46
D:1| T0: 0.10| T1: 515.00| I0: 400.00| I1: 100.00| WTP: 0,1,0.096153846,515,0,0,0,400,100,-7489564927,1440183867,8177.809598,7080674447,708067444.7,24,67930,3162,1358,1358,0,1358,67930,0,1358,24.53640324,0.640323584,0.640323584,58914.14499,203.6253889,1.488487866,99179.70068,0.593144752,0.002051616,1.7006E-05,0,0.019991167,230,80
D:1| T0: 0.10| T1: 515.00| I0: 400.00| I1: 100.00| WTP: 0,1,0.096153846,515,0,0,0,400,100,-6836305612,1696510588,9203.712806,6376119971,637611997.1,26,68942,3002,1529,1529,0,1529,68942,0,1529,22.12462552,0.71959257,0.71959257,56100.46794,194.4913122,1.633912522,99044.01498,0.565150715,0.001962119,1.84635E-05,0,0.022178063,239,72
D:1| T0: 0.10| T1: 515.00| I0: 400.00| I1: 100.00| WTP: 0,1,0.096153846,515,0,0,0,400,100,-9729552621,895039877,10756.69128,9191718057,919171805.7,24,79513,3443,1787,1787,0,1787,79513,0,1787,25.38275251,0.846426462,0.846426462,46197.38275,246.474306,1.898405198,98810.52983,0.461947426,0.002508505,2.14657E-05,0,0.022462301,240,104
D:1| T0: 0.10| T1: 515.00| I0: 400.00| I1: 100.00| WTP: 0,1,0.096153846,515,0,0,0,400,100,-11460054361,129565953,8842.063642,11017951179,1101795118,34,66408,2881,1469,1469,0,1469,66408,0,1469,13.5100077,0.392224788,0.392224788,56432.0077,179.2551963,0.961893764,99038.45612,0.56856797,0.001809058,1.13968E-05,0,0.022120829,370,125
D:1| T0: 0.10| T1: 515.00| I0: 400.00| I1: 100.00| WTP: 0,1,0.096153846,515,0,0,0,400,100,-5094163984,1902565669,7719.494429,4708189263,470818926.3,24,64862,2930,1282,1282,0,1282,64862,0,1282,28.89919355,0.816129032,0.816129032,62010.90403,200.3266129,1.854032258,99282.4379,0.622280301,0.002024646,2.0878E-05,0,0.01976504,177,53
D:1| T0: 0.10| T1: 515.00| I0: 400.00| I1: 100.00| WTP: 0,1,0.096153846,515,0,0,0,400,100,-8724687378,1984179288,8540.74438,8297650159,829765015.9,38,62738,2681,1419,1419,0,1419,62738,0,1419,13.69183422,0.388182191,0.388182191,64715.4604,194.4981535,0.972917522,99212.17891,0.648247329,0.001978312,1.18307E-05,0,0.022617871,345,94
D:1| T0: 0.10| T1: 515.00| I0: 400.00| I1: 100.00| WTP: 0,1,0.096153846,515,0,0,0,400,100,-10540151298,677377223,9518.210244,10064240786,1006424079,20,73399,3247,1581,1581,0,1581,73399,0,1581,20.33069307,0.606435644,0.606435644,45059.93663,294.579703,1.382673267,98827.45198,0.455254805,0.002970138,1.57703E-05,0,0.021539803,288,114
D:1| T0: 0.10| T1: 515.00| I0: 400.00| I1: 100.00| WTP: 0,1,0.096153846,515,0,0,0,400,100,-13424305089,973583301,9314.521152,12958579031,1295857903,24,76259,3383,1547,1547,0,1547,76259,0,1547,19.0196868,0.489038031,0.489038031,50851.95436,277.5583893,1.191946309,98997.70246,0.51240594,0.002801492,1.39576E-05,0,0.02028613,319,147
D:1| T0: 0.10| T1: 515.00| I0: 400.00| I1: 100.00| WTP: 0,1,0.096153846,515,0,0,0,400,100,-6584674155,781062938,7613.2296,6204012675,620401267.5,26,68442,3159,1264,1264,0,1264,68442,0,1264,25.73958333,0.619791667,0.619791667,56877.32096,204.5117188,1.4453125,99206.70964,0.572586728,0.002059324,1.65521E-05,0,0.018468192,220,70
D:1| T0: 0.10| T1: 515.00| I0: 400.00| I1: 100.00| WTP: 0,1,0.096153846,515,0,0,0,400,100,-17257080885,338783425,8934.543716,16810353699,1681035370,34,71288,3130,1484,1484,0,1484,71288,0,1484,14.48854129,0.355038196,0.355038196,57906.30666,211.5591124,0.900327392,99133.88869,0.581850458,0.002139264,1.09052E-05,0,0.020816968,392,191
D:1| T0: 0.10| T1: 515.00| I0: 400.00| I1: 125.00| WTP: 0,1,0.096153846,515,0,0,0,400,125,-5330647383,1178568022,7356.425419,4962826112,496282611.2,28,56334,2459,1222,1222,0,1222,56334,0,1222,18.80715585,0.549423893,0.549423893,65880.56458,176.0891449,1.2801698,99273.15403,0.662901495,0.001773093,1.49031E-05,0,0.021692051,235,56
D:1| T0: 0.10| T1: 515.00| I0: 400.00| I1: 125.00| WTP: 0,1,0.096153846,515,0,0,0,400,125,-5840264097,2029998696,10066.74383,5336926906,533692690.6,18,81332,3566,1664,1672,8,1664,81332,8,1672,46.28361345,1.530462185,1.538865546,46479.76155,288.3823529,3.274159664,98924.57353,0.463213,0.002937951,3.56745E-05,0.004784689,0.020557967,135,60
D:1| T0: 0.10| T1: 515.00| I0: 400.00| I1: 125.00| WTP: 0,1,0.096153846,515,0,0,0,400,125,-4378014913,776062361,10731.56,3841436913,384143691.3,8,77179,3254,1523,1783,260,1523,77179,260,1783,37.84465116,1.258604651,1.493023256,37897.77209,442.615814,2.92,98580.65674,0.368694448,0.004569833,3.17413E-05,0.145821649,0.023102139,149,43
D:1| T0: 0.10| T1: 515.00| I0: 400.00| I1: 125.00| WTP: 0,1,0.096153846,515,0,0,0,400,125,-6840337698,1813046880,7711.329954,6454771200,645477120,30,59730,2532,1281,1281,0,1281,59730,0,1281,16.05994006,0.454045954,0.454045954,64040.35964,189.3626374,1.085414585,99240.4021,0.644540542,0.00190737,1.28733E-05,0,0.021446509,286,73
D:1| T0: 0.10| T1: 515.00| I0: 400.00| I1: 125.00| WTP: 0,1,0.096153846,515,0,0,0,400,125,-4476391550,2032407216,7564.525974,4098165252,409816525.2,24,65077,2973,1254,1256,2,1254,65077,2,1256,31.16775777,0.817512275,0.819148936,59960.75777,186.3747954,1.845335516,99232.40835,0.599191518,0.00189677,2.08748E-05,0.001592357,0.019300807,173,46
D:1| T0: 0.10| T1: 515.00| I0: 400.00| I1: 125.00| WTP: 0,1,0.096153846,515,0,0,0,400,125,-4926644975,1507873352,6523.757356,4600457107,460045710.7,26,47863,1914,1084,1084,0,1084,47863,0,1084,10.27530707,0.301143583,0.301143583,70592.9335,146.5853452,0.759000424,99333.26599,0.70786858,0.001487051,9.29952E-06,0,0.022647974,334,52
D:1| T0: 0.10| T1: 515.00| I0: 400.00| I1: 125.00| WTP: 0,1,0.096153846,515,0,0,0,400,125,-3151670281,1855899401,5961.326721,2853603945,285360394.5,16,49822,2218,990,990,0,990,49822,0,990,22.1998414,0.591593973,0.591593973,67778.94052,147.22046,1.378271213,99368.11102,0.68135605,0.001481971,1.57798E-05,0,0.01987074,180,32
D:1| T0: 0.10| T1: 515.00| I0: 400.00| I1: 125.00| WTP: 0,1,0.096153846,515,0,0,0,400,125,-6365011290,1819459251,8549.048624,5937558859,593755885.9,22,68997,2916,1420,1420,0,1420,68997,0,1420,28.3812452,0.881629516,0.881629516,53459.44043,190.3066872,1.976172175,99063.40738,0.538735636,0.00191739,2.19684E-05,0,0.020581202,186,67
D:1| T0: 0.10| T1: 515.00| I0: 400.00| I1: 125.00| WTP: 0,1,0.096153846,515,0,0,0,400,125,-2717295176,909791748,7580.35868,2338277242,233827724.2,18,57207,2628,1259,1259,0,1259,57207,0,1259,31.84716981,0.988679245,0.988679245,67679.96604,175.2009434,2.186792453,99311.66415,0.680728898,0.001763782,2.38824E-05,0,0.022007796,152,26
D:1| T0: 0.10| T1: 515.00| I0: 400.00| I1: 125.00| WTP: 0,1,0.096153846,515,0,0,0,400,125,-4977095565,1339092841,8896.503348,4532270398,453227039.8,16,64296,2721,1478,1478,0,1478,64296,0,1478,35.52899288,1.271617497,1.271617497,59445.28789,235.5513733,2.782299084,99085.99288,0.599103958,0.002372931,3.0264E-05,0,0.022987791,141,51
D:1| T0: 0.10| T1: 515.00| I0: 400.00| I1: 125.00| WTP: 0,1,0.096153846,515,0,0,0,400,125,-5770529359,1365866345,10444.78368,5248290175,524829017.5,20,81109,3503,1719,1735,16,1719,81109,16,1735,34.96206618,1.215496368,1.230024213,42322.22195,205.2631154,2.607748184,98770.60613,0.403100793,0.002158255,2.92797E-05,0.009221902,0.021390968,170,59
D:1| T0: 0.10| T1: 515.00| I0: 400.00| I1: 125.00| WTP: 0,1,0.096153846,515,0,0,0,400,125,-9451489941,825453433,8809.066401,9011036621,901103662.1,24,71689,3222,1463,1463,0,1463,71689,0,1463,24.45289855,0.669082126,0.669082126,55591.71014,221.4855072,1.55615942,99102.51268,0.559970173,0.002232207,1.77885E-05,0,0.020407594,237,102
D:1| T0: 0.10| T1: 515.00| I0: 400.00| I1: 125.00| WTP: 0,1,0.096153846,515,0,0,0,400,125,-6122799584,939711378,10398.00687,5602899241,560289924.1,20,84267,3695,1673,1727,54,1673,84267,54,1727,41.74431301,1.315741583,1.366696997,39911.36488,301.8698817,2.901728844,98779.30937,0.403143262,0.003044494,3.11806E-05,0.031268095,0.020494381,157,63
D:1| T0: 0.10| T1: 515.00| I0: 400.00| I1: 125.00| WTP: 0,1,0.096153846,515,0,0,0,400,125,-10032296120,638950699,8248.927883,9619849726,961984972.6,30,69436,3058,1370,1370,0,1370,69436,0,1370,17.78752345,0.449812383,0.449812383,54997.25,206.1374296,1.091932458,99117.20591,0.553991544,0.002077119,1.29344E-05,0,0.019730399,305,109
D:1| T0: 0.10| T1: 515.00| I0: 400.00| I1: 125.00| WTP: 0,1,0.096153846,515,0,0,0,400,125,-4279325266,938699148,7279.788472,3915335842,391533584.2,22,61422,2807,1209,1209,0,1209,61422,0,1209,26.01320901,0.751359751,0.751359751,60055.88811,160.6977467,1.682983683,99214.18026,0.597402003,0.001647339,1.92307E-05,0,0.019683501,181,44
D:1| T0: 0.10| T1: 515.00| I0: 400.00| I1: 125.00| WTP: 0,1,0.096153846,515,0,0,0,400,125,-7045494367,121790188,6593.548617,6715816936,671581693.6,30,57981,2613,1095,1095,0,1095,57981,0,1095,13.99112295,0.295605859,0.295605859,65446.47226,185.4651576,0.786950732,99366.4585,0.65798645,0.001866243,9.76953E-06,0,0.018885823,321,76
D:1| T0: 0.10| T1: 515.00| I0: 400.00| I1: 125.00| WTP: 0,1,0.096153846,515,0,0,0,400,125,-5579306875,1331335240,10150.07415,5071803167,507180316.7,12,78551,3383,1575,1686,111,1575,78551,111,1686,27.83127839,0.875405581,0.945489942,34403.66061,336.8500973,1.966904607,98613.34783,0.342578739,0.003425365,2.15104E-05,0.065875371,0.021451305,219,57
D:1| T0: 0.10| T1: 515.00| I0: 400.00| I1: 125.00| WTP: 0,1,0.096153846,515,0,0,0,400,125,-1600416408,470935411,11189.15966,1040958425,104095842.5,2,81563,3470,796,1859,1063,796,81563,1063,1859,96.23026316,1.603070175,3.903508772,32477.86623,463.2214912,5.649122807,98505.36184,0.296268851,0.00488949,6.14923E-05,0.571812803,0.022792197,63,11
D:1| T0: 0.10| T1: 515.00| I0: 400.00| I1: 125.00| WTP: 0,1,0.096153846,515,0,0,0,400,125,-7565628912,823434397,9744.584875,7078399668,707839966.8,28,69006,3004,1619,1619,0,1619,69006,0,1619,23.21042831,0.796399752,0.796399752,57385.85661,219.4400993,1.808193669,99019.8113,0.578533954,0.002213228,2.02508E-05,0,0.023461728,231,80
D:1| T0: 0.10| T1: 515.00| I0: 400.00| I1: 125.00| WTP: 0,1,0.096153846,515,0,0,0,400,125,-2482302971,493045351,6592.055134,2152700214,215270021.4,16,54768,2319,1095,1095,0,1095,54768,0,1095,27.12207031,0.875,0.875,63985.3584,135.6220703,1.936523438,99297.81641,0.643070916,0.001367369,2.15251E-05,0,0.019993427,146,24
D:1| T0: 0.10| T1: 515.00| I0: 400.00| I1: 125.00| WTP: 0,1,0.096153846,515,0,0,0,400,125,-8149108200,1700216563,7425.762774,7777820061,777782006.1,22,65858,3054,1233,1233,0,1233,65858,0,1233,22.75902141,0.557798165,0.557798165,60445.3841,217.8195719,1.296636086,99264.34618,0.608180144,0.00219282,1.51668E-05,0,0.018707199,234,88
D:1| T0: 0.10| T1: 515.00| I0: 400.00| I1: 125.00| WTP: 0,1,0.096153846,515,0,0,0,400,125,-3636857194,1744119059,6732.811444,3300216621,330021662.1,20,59629,2684,1118,1118,0,1118,59629,0,1118,35.53754081,1.007616975,1.007616975,61529.61153,178.8531012,2.226332971,99288.76714,0.619088727,0.001799069,2.44406E-05,0,0.018749895,132,37
D:1| T0: 0.10| T1: 515.00| I0: 400.00| I1: 125.00| WTP: 0,1,0.096153846,515,0,0,0,400,125,-8500042846,2036906360,7721.269904,8113979351,811397935.1,30,58705,2456,1283,1283,0,1283,58705,0,1283,12.7567446,0.392535971,0.392535971,64132.21088,183.2360612,0.967176259,99230.43525,0.642640598,0.001860727,1.17017E-05,0,0.021838004,315,92
D:1| T0: 0.10| T1: 515.00| I0: 400.00| I1: 125.00| WTP: 0,1,0.096153846,515,0,0,0,400,125,-8358980013,809704121,8092.789192,7954340553,795434055.3,24,68585,3067,1344,1344,0,1344,68585,0,1344,20.78028634,0.551762115,0.551762115,57011.663,194.3799559,1.295154185,99158.51707,0.573580239,0.00196064,1.49101E-05,0,0.019596122,259,90
D:1| T0: 0.10| T1: 515.00| I0: 400.00| I1: 125.00| WTP: 0,1,0.096153846,515,0,0,0,400,125,-11289320035,1219866412,10360.88071,10771276000,1077127600,28,79738,3583,1718,1721,3,1718,79738,3,1721,20.99905213,0.637440758,0.638862559,40345.18436,309.0890995,1.448815166,98706.31754,0.407962924,0.003119314,1.64322E-05,0.001743173,0.021583185,302,122
D:1| T0: 0.10| T1: 515.00| I0: 400.00| I1: 125.00| WTP: 0,1,0.096153846,515,0,0,0,400,125,-4091675285,843498920,7151.689349,3734090818,373409081.8,26,55077,2378,1188,1188,0,1188,55077,0,1188,20.15117057,0.575250836,0.575250836,68580.33779,177.5591973,1.384615385,99343.96856,0.689665028,0.00178725,1.59772E-05,0,0.021552037,214,42
D:1| T0: 0.10| T1: 515.00| I0: 400.00| I1: 125.00| WTP: 0,1,0.096153846,515,0,0,0,400,125,-11203182362,107351963,10650.86546,10670639089,1067063909,40,72304,2974,1770,1770,0,1770,72304,0,1770,16.1512866,0.577639752,0.577639752,58361.77507,223.8970719,1.371783496,98994.33762,0.5882167,0.002261363,1.58458E-05,0,0.024479973,322,121
D:1| T0: 0.10| T1: 515.00| I0: 400.00| I1: 125.00| WTP: 0,1,0.096153846,515,0,0,0,400,125,-10206685971,773789021,8254.55465,9793958239,979395823.9,36,68157,3026,1371,1371,0,1371,68157,0,1371,18.06906615,0.473249027,0.473249027,57597.91099,225.0452335,1.13618677,99154.7714,0.57962608,0.002269551,1.34352E-05,0,0.020115322,294,111
D:1| T0: 0.10| T1: 515.00| I0: 400.00| I1: 125.00| WTP: 0,1,0.096153846,515,0,0,0,400,125,-8143988908,850936611,9183.719732,7684802922,768480292.2,30,66420,2709,1526,1526,0,1526,66420,0,1526,18.62556054,0.665919283,0.665919283,57013.04204,196.8632287,1.515695067,99025.18161,0.571390005,0.002000668,1.73657E-05,0,0.022959952,253,87
D:1| T0: 0.10| T1: 515.00| I0: 400.00| I1: 125.00| WTP: 0,1,0.096153846,515,0,0,0,400,125,-6470940798,1701318364,8856.278719,6028126862,602812686.2,26,69434,3031,1471,1471,0,1471,69434,0,1471,29.24224073,0.894776684,0.894776684,57555.41559,222.6903861,2.011355034,99106.12945,0.575981753,0.002264915,2.26243E-05,0,0.021185586,187,68
D:1| T0: 0.10| T1: 515.00| I0: 400.00| I1: 125.00| WTP: 0,1,0.096153846,515,0,0,0,400,125,-7586264111,778708269,6946.993382,7238914442,723891444.2,26,55899,2373,1154,1154,0,1154,55899,0,1154,13.71019843,0.329949239,0.329949239,68862.96447,198.3484079,0.872173512,99378.83941,0.691864272,0.001999076,1.07224E-05,0,0.020644376,310,82
D:1| T0: 0.10| T1: 515.00| I0: 400.00| I1: 125.00| WTP: 0,1,0.096153846,515,0,0,0,400,125,-4040551250,1391938506,7860.782148,3647512143,364751214.3,24,58950,2456,1306,1306,0,1306,58950,0,1306,25.25666667,0.875833333,0.875833333,63012.28583,174.7666667,1.96,99184.225,0.634602089,0.001760278,2.18913E-05,0,0.022154744,172,41
D:1| T0: 0.10| T1: 515.00| I0: 400.00| I1: 125.00| WTP: 0,1,0.096153846,515,0,0,0,400,125,-3692529444,43418681,6302.921964,3377383346,337738334.6,18,49981,2133,1047,1047,0,1047,49981,0,1047,16.37246466,0.46527351,0.46527351,70255.76152,171.302397,1.101413645,99378.41733,0.706391634,0.001723573,1.293E-05,0,0.020948379,233,38
D:1| T0: 0.10| T1: 515.00| I0: 400.00| I1: 125.00| WTP: 0,1,0.096153846,515,0,0,0,400,125,-3786119783,817384966,11152.16413,3228511577,322851157.7,18,79658,3283,1574,1853,279,1574,79658,279,1853,46.95752009,1.616532721,1.928817451,39393.55913,248.8817451,3.735935706,98624.11251,0.396572911,0.002519245,3.98237E-05,0.150566649,0.023261945,124,36
D:1| T0: 0.10| T1: 515.00| I0: 400.00| I1: 125.00| WTP: 0,1,0.096153846,515,0,0,0,400,125,-5464148820,762053968,9644.891802,4981904230,498190423,24,77611,3366,1577,1602,25,1577,77611,25,1602,41.84592145,1.374622356,1.398791541,48608.93756,243.7250755,2.994964753,98945.80363,0.489294315,0.002462084,3.23064E-05,0.015605493,0.020642468,142,56
D:1| T0: 0.10| T1: 515.00| I0: 400.00| I1: 125.00| WTP: 0,1,0.096153846,515,0,0,0,400,125,-9327228375,1692506311,8159.052678,8919275741,891927574.1,34,68953,3141,1355,1355,0,1355,68953,0,1355,19.24736048,0.484665661,0.484665661,60727.54047,231.1131222,1.16892911,99257.04977,0.607982401,0.002345268,1.38151E-05,0,0.019651067,281,101
D:1| T0: 0.10| T1: 515.00| I0: 400.00| I1: 125.00| WTP: 0,1,0.096153846,515,0,0,0,400,125,-3359091442,1037620300,6645.321004,3026825392,302682539.2,18,50169,2154,1104,1104,0,1104,50169,0,1104,23.15276558,0.769973661,0.769973661,73978.92888,184.0079017,1.737489025,99435.41879,0.731051473,0.001939147,2.04066E-05,0,0.021985688,156,34
D:1| T0: 0.10| T1: 515.00| I0: 400.00| I1: 125.00| WTP: 0,1,0.096153846,515,0,0,0,400,125,-4584615501,301400999,8126.582631,4178286370,417828637,24,61006,2692,1350,1350,0,1350,61006,0,1350,23.16225627,0.738857939,0.738857939,62384.64415,175.5772981,1.676183844,99183.90599,0.628207055,0.001768685,1.89168E-05,0,0.022128971,206,47
D:1| T0: 0.10| T1: 515.00| I0: 400.00| I1: 125.00| WTP: 0,1,0.096153846,515,0,0,0,400,125,-5556391822,1868336855,9752.727254,5068755459,506875545.9,16,75825,3286,1594,1620,26,1594,75825,26,1620,35.84205934,1.188481675,1.212041885,44075.5288,258.5279232,2.603839442,98821.43979,0.44521947,0.002606437,2.82505E-05,0.016049383,0.021364985,164,57
D:1| T0: 0.10| T1: 515.00| I0: 400.00| I1: 125.00| WTP: 0,1,0.096153846,515,0,0,0,400,125,-7834215985,1868498144,9752.326131,7346599679,734659967.9,22,75888,3270,1620,1620,0,1620,75888,0,1620,29.66325037,0.969253294,0.969253294,50733.82796,230.1412884,2.154465593,98960.26061,0.511603109,0.002321064,2.3895E-05,0,0.021347249,196,83
D:1| T0: 0.10| T1: 515.00| I0: 400.00| I1: 125.00| WTP: 0,1,0.096153846,515,0,0,0,400,125,-6025024440,2101566889,7259.677612,5662040559,566204055.9,24,55466,2406,1206,1206,0,1206,55466,0,1206,17.49208211,0.520234604,0.520234604,66269.32551,184.4087977,1.237536657,99261.93842,0.666938215,0.001856914,1.4224E-05,0,0.021743442,244,64
D:1| T0: 0.10| T1: 515.00| I0: 400.00| I1: 125.00| WTP: 0,1,0.096153846,515,0,0,0,400,125,-2349995335,1665097450,10437.98136,1828096267,182809626.7,6,80646,3476,1032,1734,702,1032,80646,702,1734,54.33545108,1.184243964,2.057179161,32406.17027,350.8208386,3.376111817,98569.56671,0.296632175,0.003700304,3.7076E-05,0.404844291,0.021501643,108,20
D:1| T0: 0.10| T1: 515.00| I0: 400.00| I1: 125.00| WTP: 0,1,0.096153846,515,0,0,0,400,125,-3181317170,1716179948,9395.389121,2711547714,271154771.4,8,81836,3775,1285,1560,275,1285,81836,275,1560,59.84223919,1.474554707,1.807888041,31550.55344,357.8282443,3.44783715,98725.37659,0.319044592,0.003603217,3.64407E-05,0.176282051,0.019062515,113,30
D:1| T0: 0.10| T1: 515.00| I0: 400.00| I1: 125.00| WTP: 0,1,0.096153846,515,0,0,0,400,125,-3195929028,1560278715,8568.374487,2767510304,276751030.4,16,56414,2244,1424,1424,0,1424,56414,0,1424,25.99532273,1.128157156,1.128157156,67541.22638,180.2413471,2.450888681,99193.60056,0.674238506,0.001848854,2.72921E-05,0,0.025241961,149,31
D:1| T0: 0.10| T1: 515.00| I0: 400.00| I1: 125.00| WTP: 0,1,0.096153846,515,0,0,0,400,125,-10055763510,991019385,10270.19475,9542253772,954225377.2,26,79775,3496,1705,1706,1,1705,79775,1,1706,26.28719512,0.826829268,0.827439024,46122.22378,288.3579268,1.875609756,98852.17134,0.465607144,0.002909373,2.09649E-05,0.000586166,0.021385146,235,108
D:1| T0: 0.10| T1: 515.00| I0: 400.00| I1: 125.00| WTP: 0,1,0.096153846,515,0,0,0,400,125,-5986516760,118052103,9637.836194,5504624950,550462495,12,73345,3182,1563,1601,38,1563,73345,38,1601,29.20161884,0.97866078,1.005150846,43620.1067,271.593819,2.158204562,98791.03753,0.432328301,0.002778621,2.38031E-05,0.023735166,0.021828345,192,62
D:1| T0: 0.10| T1: 515.00| I0: 400.00| I1: 125.00| WTP: 0,1,0.096153846,515,0,0,0,400,125,-4528991030,1209758844,10310.19624,4013481218,401348121.8,12,74351,3102,1683,1713,30,1683,74351,30,1713,42.68473451,1.670353982,1.701327434,47226.22124,240.7776549,3.555309735,98803.92035,0.461480887,0.002499738,3.89691E-05,0.017513135,0.023039677,126,45
D:1| T0: 0.10| T1: 515.00| I0: 400.00| I1: 125.00| WTP: 0,1,0.096153846,515,0,0,0,400,125,-5231977706,70671723,7181.456807,4872904866,487290486.6,26,55953,2434,1193,1193,0,1193,55953,0,1193,15.87046908,0.440298507,0.440298507,66430.38593,183.1444563,1.096481876,99291.7484,0.667673609,0.001847871,1.28153E-05,0,0.021321466,268,55
D:1| T0: 0.10| T1: 515.00| I0: 400.00| I1: 125.00| WTP: 0,1,0.096153846,515,0,0,0,400,125,-5085439126,1722612191,6051.642108,4782857021,478285702.1,20,51063,2329,1005,1005,0,1005,51063,0,1005,16.1852061,0.390739695,0.390739695,68368.07058,159.2981366,0.965556183,99398.8515,0.686914959,0.00160398,1.14132E-05,0,0.019642787,252,54
D:1| T0: 0.10| T1: 515.00| I0: 400.00| I1: 125.00| WTP: 0,1,0.096153846,515,0,0,0,400,125,-3760224981,1968291596,5912.43354,3464603304,346460330.4,16,48474,2171,982,982,0,982,48474,0,982,18.02796726,0.5,0.5,68108.06344,132.851296,1.164392906,99365.13097,0.682541489,0.001346585,1.35554E-05,0,0.020258283,208,39
D:1| T0: 0.10| T1: 515.00| I0: 400.00| I1: 125.00| WTP: 0,1,0.096153846,515,0,0,0,400,125,-3534052791,1877569084,11291.52611,2969476485,296947648.5,10,82453,3482,1449,1876,427,1449,82453,427,1876,56.67973856,1.71503268,2.25751634,34802.55294,345.5921569,4.14379085,98542.36732,0.343789874,0.003531825,4.44211E-05,0.22761194,0.02275346,108,33
D:1| T0: 0.10| T1: 515.00| I0: 400.00| I1: 125.00| WTP: 0,1,0.096153846,515,0,0,0,400,125,-2693311480,1726322189,10293.92685,2178615138,217861513.8,6,78870,3403,1248,1710,462,1248,78870,462,1710,61.35786436,1.650793651,2.295815296,34115.16883,386.7705628,4.105339105,98602.34055,0.339590573,0.003930156,4.33784E-05,0.270175439,0.021681248,99,24
D:1| T0: 0.10| T1: 515.00| I0: 400.00| I1: 125.00| WTP: 0,1,0.096153846,515,0,0,0,400,125,-5559371409,307848836,9830.533477,5067844735,506784473.5,14,77882,3321,1630,1633,3,1630,77882,3,1633,41.04577823,1.457782299,1.460834181,45539.49135,277.965412,3.108850458,98878.54323,0.459618776,0.00280177,3.34332E-05,0.00183711,0.020967618,141,57
D:1| T0: 0.10| T1: 515.00| I0: 400.00| I1: 125.00| WTP: 0,1,0.096153846,515,0,0,0,400,125,-1723337374,1154000220,10067.32995,1219970877,121997087.7,4,82380,3756,813,1672,859,813,82380,859,1672,92.60279441,1.453093812,3.155688623,28445.01198,428.2714571,4.77245509,98578.1976,0.288243228,0.004309976,4.99475E-05,0.513755981,0.020297174,72,13
D:1| T0: 0.10| T1: 515.00| I0: 400.00| I1: 125.00| WTP: 0,1,0.096153846,515,0,0,0,400,125,-4434581256,2028661055,7042.846975,4082438907,408243890.7,24,53243,2381,1170,1170,0,1170,53243,0,1170,17.07074911,0.509512485,0.509512485,66754.09334,165.6753864,1.20451843,99274.33888,0.671804652,0.001668055,1.39855E-05,0,0.02197472,241,46
D:1| T0: 0.10| T1: 515.00| I0: 400.00| I1: 125.00| WTP: 0,1,0.096153846,515,0,0,0,400,125,-11049169601,1629114640,9169.996564,10590669773,1059066977,32,74868,3241,1523,1523,0,1523,74868,0,1523,21.56440766,0.573202276,0.573202276,55336.68598,239.7842732,1.365752716,99117.15468,0.557223807,0.00241715,1.58706E-05,0,0.020342469,277,120
D:1| T0: 0.10| T1: 515.00| I0: 400.00| I1: 125.00| WTP: 0,1,0.096153846,515,0,0,0,400,125,-3962201692,1439048174,11069.63513,3408719935,340871993.5,10,82044,3545,1469,1839,370,1469,82044,370,1839,52.29928741,1.557007126,1.983372922,34587.99644,414.5961995,3.747030879,98546.1247,0.347946231,0.004196764,3.97599E-05,0.201196302,0.022414802,120,38
D:1| T0: 0.10| T1: 515.00| I0: 400.00| I1: 125.00| WTP: 0,1,0.096153846,515,0,0,0,400,125,-1335401807,865227006,11176.59618,776571997.5,77657199.75,2,83612,3494,647,1857,1210,647,83612,1210,1857,115.4037433,1.529411765,4.743315508,33558.27807,600.7433155,6.529411765,98567.06684,0.285799847,0.006532813,7.28688E-05,0.651588584,0.022210262,50,8
D:1| T0: 0.10| T1: 515.00| I0: 400.00| I1: 125.00| WTP: 0,1,0.096153846,515,0,0,0,400,125,-6080891554,890479738,9746.317326,5593575687,559357568.7,14,77814,3332,1562,1619,57,1562,77814,57,1619,31.58548009,1.022638564,1.06479313,38884.66979,435.5456674,2.298985168,98755.07104,0.393098637,0.004389256,2.50158E-05,0.035206918,0.020806025,183,63
D:1| T0: 0.10| T1: 515.00| I0: 400.00| I1: 125.00| WTP: 0,1,0.096153846,515,0,0,0,400,125,-3686169412,1017049163,7770.928597,3297622983,329762298.3,22,58241,2547,1291,1291,0,1291,58241,0,1291,24.62259615,0.842147436,0.842147436,62677.99519,165.5016026,1.873397436,99180.67708,0.631226637,0.00166688,2.08066E-05,0,0.022166515,179,37
D:1| T0: 0.10| T1: 515.00| I0: 400.00| I1: 125.00| WTP: 0,1,0.096153846,515,0,0,0,400,125,-5023512549,1707305064,6520.818843,4697471606,469747160.6,22,52518,2370,1083,1083,0,1083,52518,0,1083,17.20114943,0.429310345,0.429310345,67186.05057,158.666092,1.059195402,99345.36437,0.673810722,0.001605761,1.25811E-05,0,0.020621501,248,53
D:1| T0: 0.10| T1: 515.00| I0: 400.00| I1: 125.00| WTP: 0,1,0.096153846,515,0,0,0,400,125,-1345482937,400145663,11303.97131,780284371.7,78028437.17,2,83824,3616,714,1878,1164,714,83824,1164,1878,132.8621701,1.935483871,5.328445748,29338.54252,658.4252199,7.416422287,98471.60411,0.297454985,0.006624804,7.65575E-05,0.619808307,0.022404085,49,8
D:1| T0: 0.10| T1: 515.00| I0: 400.00| I1: 125.00| WTP: 0,1,0.096153846,515,0,0,0,400,125,-4376596800,1662654181,7501.492424,4001522179,400152217.9,26,61302,2685,1245,1246,1,1245,61302,1,1246,19.03736135,0.557501459,0.557501459,57933.33742,145.9095155,1.283129013,99144.32224,0.58362441,0.001469971,1.46243E-05,0.000802568,0.020325601,245,45
D:1| T0: 0.10| T1: 515.00| I0: 400.00| I1: 125.00| WTP: 0,1,0.096153846,515,0,0,0,400,125,-4684162862,182136456,9748.121367,4196756794,419675679.4,18,80673,3589,1423,1619,196,1423,80673,196,1619,43.29359606,1.208866995,1.395073892,37557.61182,275.1635468,2.801970443,98757.67389,0.376599464,0.002787484,3.03435E-05,0.121062384,0.020068672,145,47
D:1| T0: 0.10| T1: 515.00| I0: 400.00| I1: 125.00| WTP: 0,1,0.096153846,515,0,0,0,400,125,-5894373307,979575387,6442.176884,5572264463,557226446.3,22,52373,2324,1070,1070,0,1070,52373,0,1070,15.23340358,0.383561644,0.383561644,69648.74974,185.8066386,0.938883035,99392.6254,0.700156881,0.001869313,1.13297E-05,0,0.020430374,272,63
D:1| T0: 0.10| T1: 515.00| I0: 400.00| I1: 125.00| WTP: 0,1,0.096153846,515,0,0,0,400,125,-4648215015,2142525414,10787.11036,4108859497,410885949.7,10,80908,3495,1709,1792,83,1709,80908,83,1792,49.29190422,1.729760547,1.818700114,41813.6374,361.7457241,3.790193843,98726.68757,0.41378611,0.003703281,4.08424E-05,0.046316964,0.022148613,124,46
D:1| T0: 0.10| T1: 515.00| I0: 400.00| I1: 125.00| WTP: 0,1,0.096153846,515,0,0,0,400,125,-5195515562,1464057597,9566.260862,4717202518,471720251.8,12,73779,3242,1578,1589,11,1578,73779,11,1589,40.75955734,1.373239437,1.38028169,48716.48592,278.8370221,2.97082495,98939.7334,0.490989737,0.002812288,3.21164E-05,0.006922593,0.021537586,142,53
D:1| T0: 0.10| T1: 515.00| I0: 400.00| I1: 125.00| WTP: 0,1,0.096153846,515,0,0,0,400,125,-3896504893,364562610,9825.431565,3405233315,340523331.5,10,74469,3326,1529,1632,103,1529,74469,103,1632,45.01068376,1.461538462,1.566239316,41514.17308,267.8279915,3.193376068,98736.91774,0.416593169,0.002713866,3.4198E-05,0.063112745,0.021915159,133,38
D:1| T0: 0.10| T1: 515.00| I0: 400.00| I1: 125.00| WTP: 0,1,0.096153846,515,0,0,0,400,125,-4357747127,40350784,10341.01278,3840696488,384069648.8,10,77258,3243,1626,1718,92,1626,77258,92,1718,48.4668275,1.757539204,1.863691194,44038.81785,358.880579,3.821471653,98780.9421,0.444951225,0.003617418,4.06409E-05,0.05355064,0.022237179,119,43
D:1| T0: 0.10| T1: 515.00| I0: 400.00| I1: 125.00| WTP: 0,1,0.096153846,515,0,0,0,400,125,-4458666324,804064356,8810.219673,4018155340,401815534,20,76758,3486,1438,1463,25,1438,76758,25,1463,41.86268657,1.24278607,1.265671642,47107.08756,220.3751244,2.678606965,99012.83184,0.468016489,0.0022488,2.94305E-05,0.017088175,0.019060151,142,45
D:1| T0: 0.10| T1: 515.00| I0: 400.00| I1: 125.00| WTP: 0,1,0.096153846,515,0,0,0,400,125,-3782436115,2125493986,9515.568486,3306657691,330665769.1,22,68558,2861,1568,1581,13,1568,68558,13,1581,35.87184662,1.358224016,1.37235116,58268.51362,219.0161453,2.955600404,99047.21998,0.586857974,0.002210072,3.20296E-05,0.008222644,0.023060766,142,37
D:1| T0: 0.10| T1: 515.00| I0: 400.00| I1: 125.00| WTP: 0,1,0.096153846,515,0,0,0,400,125,-3892723439,23154253,8070.567307,3489195074,348919507.4,10,70920,3246,1334,1340,6,1334,70920,6,1340,49.41636142,1.426129426,1.433455433,52590.50305,230.8498168,3.074481074,99107.59707,0.524630452,0.002349539,3.31936E-05,0.004480956,0.018880961,116,39
D:1| T0: 0.10| T1: 515.00| I0: 400.00| I1: 125.00| WTP: 0,1,0.096153846,515,0,0,0,400,125,-3101122712,1391367689,6688.301897,2766707617,276670761.7,16,51016,2276,1111,1111,0,1111,51016,0,1111,25.5715588,0.824977211,0.824977211,67753.26892,156.8915223,1.827711942,99303.84412,0.678802176,0.00159313,2.05366E-05,0,0.021777908,156,31
D:1| T0: 0.10| T1: 515.00| I0: 400.00| I1: 125.00| WTP: 0,1,0.096153846,515,0,0,0,400,125,-7083970699,574142276,8909.253919,6638508003,663850800.3,28,68985,3021,1480,1480,0,1480,68985,0,1480,23.57041801,0.751768489,0.751768489,57437.1672,203.2752412,1.704180064,99094.95177,0.577555645,0.002054362,1.92143E-05,0,0.02145425,222,75
D:1| T0: 0.10| T1: 515.00| I0: 400.00| I1: 125.00| WTP: 0,1,0.096153846,515,0,0,0,400,125,-6572884420,898736779,6092.144803,6268277180,626827718,28,47733,2050,1012,1012,0,1012,47733,0,1012,11.4246696,0.285462555,0.285462555,70102.60617,155.338326,0.727312775,99376.20925,0.702805656,0.001574028,9.02122E-06,0,0.021201265,322,71
D:1| T0: 0.10| T1: 515.00| I0: 400.00| I1: 125.00| WTP: 0,1,0.096153846,515,0,0,0,400,125,-10929597281,346473503,8432.890245,10507952769,1050795277,30,78555,3654,1400,1400,0,1400,78555,0,1400,22.72796353,0.521783181,0.521783181,51285.70973,227.0425532,1.236575481,99142.77254,0.497858348,0.002373946,1.48173E-05,0,0.017809178,272,119
D:1| T0: 0.10| T1: 515.00| I0: 400.00| I1: 125.00| WTP: 0,1,0.096153846,515,0,0,0,400,125,-9400576491,445552282,9506.345228,8925259230,892525923,30,74480,3300,1579,1579,0,1579,74480,0,1579,22.96002221,0.679067185,0.679067185,56661.60133,235.9289284,1.550249861,99077.13715,0.557707575,0.002451378,1.81998E-05,0,0.021200322,249,101
D:1| T0: 0.10| T1: 515.00| I0: 400.00| I1: 125.00| WTP: 0,1,0.096153846,515,0,0,0,400,125,-1476240764,911758476,10273.34784,962573372.1,96257337.21,2,85799,3926,803,1706,903,803,85799,903,1706,133.3967828,1.989276139,4.386058981,34638.84718,644.0509383,6.55227882,98733.06434,0.298938999,0.006981876,7.29659E-05,0.529308324,0.019883913,50,10
D:1| T0: 0.10| T1: 515.00| I0: 400.00| I1: 125.00| WTP: 0,1,0.096153846,515,0,0,0,400,125,-4338492847,1464197940,9773.37934,3849823880,384982388,10,81601,3659,1437,1623,186,1437,81601,186,1623,48.8012685,1.335095137,1.524312896,34634.55497,503.8520085,3.035940803,98715.29175,0.350216302,0.005077225,3.25805E-05,0.114602588,0.019889462,136,43
D:1| T0: 0.10| T1: 515.00| I0: 400.00| I1: 125.00| WTP: 0,1,0.096153846,515,0,0,0,400,125,-5193410799,500405854,8107.376796,4788041959,478804195.9,28,59204,2495,1346,1347,1,1346,59204,1,1347,25.62624585,0.911960133,0.912790698,63420.52243,199.1536545,2.033222591,99171.31146,0.635134608,0.002026215,2.27262E-05,0.00074239,0.022751841,171,54
D:1| T0: 0.10| T1: 515.00| I0: 400.00| I1: 125.00| WTP: 0,1,0.096153846,515,0,0,0,400,125,-5781005082,772037341,10725.87056,5244711554,524471155.4,24,79435,3374,1777,1782,5,1777,79435,5,1782,38.76937618,1.458412098,1.462192817,50553.59357,246.4810964,3.130434783,98911.56522,0.509871125,0.002487101,3.39094E-05,0.002805836,0.022433436,152,59
D:1| T0: 0.10| T1: 515.00| I0: 400.00| I1: 125.00| WTP: 0,1,0.096153846,515,0,0,0,400,125,-3391756414,1543158763,5693.96931,3107057948,310705794.8,18,44341,1906,946,946,0,946,44341,0,946,15.91189112,0.505014327,0.505014327,72737.899,154.3051576,1.181948424,99420.24713,0.728833741,0.001565147,1.37254E-05,0,0.021335138,198,35
D:1| T0: 0.10| T1: 515.00| I0: 400.00| I1: 125.00| WTP: 0,1,0.096153846,515,0,0,0,400,125,-3283657994,1604932531,11543.73148,2706471420,270647142,12,83759,3424,1406,1918,512,1406,83759,512,1918,56.20233463,1.648508431,2.303501946,34915.10376,319.4682231,4.124513619,98529.02724,0.339790309,0.003291614,4.44261E-05,0.266944734,0.022899305,108,30
D:1| T0: 0.10| T1: 515.00| I0: 400.00| I1: 125.00| WTP: 0,1,0.096153846,515,0,0,0,400,125,-6733343765,539051477,10402.92656,6213197437,621319743.7,16,79914,3526,1680,1728,48,1680,79914,48,1728,32.11979547,1.035792549,1.066471877,40374.63331,333.4536158,2.300949598,98721.40833,0.394327512,0.003441504,2.56748E-05,0.027777778,0.021623245,192,70
D:1| T0: 0.10| T1: 515.00| I0: 400.00| I1: 125.00| WTP: 0,1,0.096153846,515,0,0,0,400,125,-2752485334,1743124675,6712.542139,2416858227,241685822.7,20,53458,2321,1115,1115,0,1115,53458,0,1115,26.0319052,0.804922516,0.804922516,68804.32179,165.0829535,1.83135825,99353.68733,0.690475449,0.001668815,2.05167E-05,0,0.020857496,156,27
D:1| T0: 0.10| T1: 515.00| I0: 400.00| I1: 125.00| WTP: 0,1,0.096153846,515,0,0,0,400,125,-8555107264,1965983789,8595.859849,8125314271,812531427.1,22,65206,2841,1428,1428,0,1428,65206,0,1428,17.61301715,0.538849647,0.538849647,56300.58073,190.7376387,1.259838547,99053.92987,0.566214856,0.001928325,1.455E-05,0,0.021884489,283,92
D:1| T0: 0.10| T1: 515.00| I0: 400.00| I1: 125.00| WTP: 0,1,0.096153846,515,0,0,0,400,125,-8072140396,516774280,7771.880514,7683546371,768354637.1,36,63523,2718,1291,1291,0,1291,63523,0,1291,16.82352941,0.451318458,0.451318458,63480.48022,206.8275862,1.110547667,99236.94016,0.638513827,0.002086018,1.31851E-05,0,0.020323347,281,87
D:1| T0: 0.10| T1: 515.00| I0: 400.00| I1: 125.00| WTP: 0,1,0.096153846,515,0,0,0,400,125,-1218850705,86603142,10493.7124,694165085.1,69416508.51,2,83367,3597,515,1743,1228,515,83367,1228,1743,223.1100478,2.373205742,8.220095694,36463.64115,1034.569378,10.67942584,98740.36842,0.333074595,0.010954924,0.000114472,0.704532415,0.020907553,29,7
D:1| T0: 0.10| T1: 515.00| I0: 400.00| I1: 125.00| WTP: 0,1,0.096153846,515,0,0,0,400,125,-6809494845,1431870609,7086.828495,6455153421,645515342.1,34,59455,2585,1177,1177,0,1177,59455,0,1177,13.88360238,0.334324554,0.334324554,63215.13636,174.7166525,0.829651657,99276.65463,0.63605608,0.001759302,1.00549E-05,0,0.019796485,337,73
D:1| T0: 0.10| T1: 515.00| I0: 400.00| I1: 125.00| WTP: 0,1,0.096153846,515,0,0,0,400,125,-4268398993,1592383984,8545.44744,3841126621,384112662.1,14,70197,3176,1415,1419,4,1415,70197,4,1419,39.78571429,1.167953668,1.173745174,50852.96815,198.6090734,2.537644788,99027.639,0.511342914,0.002006364,2.76037E-05,0.002820874,0.020200293,148,43
D:1| T0: 0.10| T1: 515.00| I0: 400.00| I1: 125.00| WTP: 0,1,0.096153846,515,0,0,0,400,125,-6868611656,1440183867,8098.656777,6463678818,646367881.8,24,67653,3009,1345,1345,0,1345,67653,0,1345,27.12964312,0.771303714,0.771303714,60676.23671,237.405681,1.736343773,99234.22651,0.610651945,0.002390691,1.97104E-05,0,0.019880863,197,73
D:1| T0: 0.10| T1: 515.00| I0: 400.00| I1: 125.00| WTP: 0,1,0.096153846,515,0,0,0,400,125,-6667658238,1696510588,9306.340462,6202341215,620234121.5,28,69964,3059,1545,1546,1,1545,69964,1,1546,26.28551532,0.871866295,0.873259053,58586.0571,230.25,1.951949861,99102.62744,0.589855819,0.002322644,2.16927E-05,0.000646831,0.022097078,205,70
D:1| T0: 0.10| T1: 515.00| I0: 400.00| I1: 125.00| WTP: 0,1,0.096153846,515,0,0,0,400,125,-9720582788,895039877,10552.89138,9192938219,919293821.9,26,80548,3518,1753,1753,0,1753,80548,0,1753,27.87587524,0.893698281,0.893698281,48195.62062,268.4589433,2.010821133,98867.42712,0.481706725,0.002733788,2.27023E-05,0,0.021751276,223,104
D:1| T0: 0.10| T1: 515.00| I0: 400.00| I1: 125.00| WTP: 0,1,0.096153846,515,0,0,0,400,125,-10717087474,129565953,9731.388689,10230518040,1023051804,34,69227,2841,1617,1617,0,1617,69227,0,1617,15.22544833,0.492741247,0.492741247,56725.05252,209.7459436,1.185311699,99002.32109,0.571575516,0.002117893,1.39273E-05,0,0.023357938,334,116
D:1| T0: 0.10| T1: 515.00| I0: 400.00| I1: 125.00| WTP: 0,1,0.096153846,515,0,0,0,400,125,-4828958345,1902565669,7689.222932,4444497198,444449719.8,24,64515,2897,1277,1277,0,1277,64515,0,1277,28.29416467,0.803357314,0.803357314,61357.95364,197.4100719,1.820943245,99272.39808,0.61576974,0.001995076,2.06126E-05,0,0.019793846,178,50
D:1| T0: 0.10| T1: 515.00| I0: 400.00| I1: 125.00| WTP: 0,1,0.096153846,515,0,0,0,400,125,-8007278434,1984179288,8234.164675,7595570200,759557020,38,62618,2701,1368,1368,0,1368,62618,0,1368,14.28255208,0.394097222,0.394097222,64655.64583,205.1831597,0.986979167,99244.92274,0.647274646,0.002087033,1.20668E-05,0,0.021846753,326,86
D:1| T0: 0.10| T1: 515.00| I0: 400.00| I1: 125.00| WTP: 0,1,0.096153846,515,0,0,0,400,125,-9323867940,677377223,9746.249573,8836555461,883655546.1,18,75695,3276,1619,1619,0,1619,75695,0,1619,22.97110482,0.727478754,0.727478754,45891.52578,347.3388102,1.635694051,98853.81076,0.463476423,0.003502105,1.84847E-05,0,0.021388467,252,100
D:1| T0: 0.10| T1: 515.00| I0: 400.00| I1: 125.00| WTP: 0,1,0.096153846,515,0,0,0,400,125,-13149516334,973583301,9115.732996,12693729684,1269372968,26,73755,3279,1514,1514,0,1514,73755,0,1514,15.55730928,0.404359263,0.404359263,46763.29087,225.1833897,0.968808719,98905.79143,0.471608429,0.002272643,1.14703E-05,0,0.0205277,380,144
D:1| T0: 0.10| T1: 515.00| I0: 400.00| I1: 125.00| WTP: 0,1,0.096153846,515,0,0,0,400,125,-6569949987,781062938,7354.436911,6202228141,620222814.1,28,66330,3036,1221,1221,0,1221,66330,0,1221,25.49933775,0.620529801,0.620529801,57003.03775,201.9304636,1.439735099,99212.63642,0.573832182,0.002032759,1.62606E-05,0,0.01840796,216,70
D:1| T0: 0.10| T1: 515.00| I0: 400.00| I1: 125.00| WTP: 0,1,0.096153846,515,0,0,0,400,125,-14824928371,338783425,9272.528418,14361301950,1436130195,32,74973,3403,1540,1540,0,1540,74973,0,1540,16.99008723,0.407613006,0.407613006,55900.86757,243.1149881,1.021808089,99097.41237,0.561596242,0.002459424,1.23416E-05,0,0.020540728,360,163
